Account name,Date,Transaction type,Transaction number,Name,Description,Full name,Account name,Amount line,Balance
PayPal Bank 3,11/27/2023,Deposit,91D50112T52088104,07 1000 DRONES RESTR,Subject: 1000DRONESTransaction ID: 91D50112T52088104https://www.paypal.com/activity/payment/91D50112T52088104,PayPal Bank 3,--,$100.00,$100.00
Donations directed by individuals,11/27/2023,Deposit,91D50112T52088104,07 1000 DRONES RESTR,1000 DRONES FOR UKRAINE - 1000 DRONES FOR UKRAINE,Contributed income:Donations directed by individuals,PayPal Bank 3,$102.53,$202.53
PayPal Fees,11/27/2023,Deposit,91D50112T52088104,07 1000 DRONES RESTR,PayPal fees,OFFICE/GENERAL ADMINISTRATIVE EXPENSES:PayPal Fees,PayPal Bank 3,$2.53,$205.06
PayPal Bank 3,11/27/2023,Deposit,8UM88794R53216747,04 PAYPAL GENERAL UNRESTR,Subject: GeneralPageTransaction ID: 8UM88794R53216747https://www.paypal.com/activity/payment/8UM88794R53216747,PayPal Bank 3,--,$98.46,$303.52
Donations directed by individuals,11/27/2023,Deposit,8UM88794R53216747,04 PAYPAL GENERAL UNRESTR,Support Ukraine - Support Ukraine,Contributed income:Donations directed by individuals,PayPal Bank 3,$102.53,$406.05
PayPal Fees,11/27/2023,Deposit,8UM88794R53216747,04 PAYPAL GENERAL UNRESTR,PayPal fees,OFFICE/GENERAL ADMINISTRATIVE EXPENSES:PayPal Fees,PayPal Bank 3,$4.07,$410.12
PayPal Bank 3,11/27/2023,Deposit,3LH984674H965421V,--,Subject: Support UkraineTransaction ID: 3LH984674H965421Vhttps://www.paypal.com/activity/payment/3LH984674H965421V,PayPal Bank 3,--,$25.24,$435.36
Donations directed by individuals,11/27/2023,Deposit,3LH984674H965421V,--,Money in to PayPal,Contributed income:Donations directed by individuals,PayPal Bank 3,$26.25,$461.61
PayPal Fees,11/27/2023,Deposit,3LH984674H965421V,--,PayPal fees,OFFICE/GENERAL ADMINISTRATIVE EXPENSES:PayPal Fees,PayPal Bank 3,$1.01,$462.62
PayPal Bank 3,11/27/2023,Deposit,11700335Y7511251E,10 Flight to Recovery RESTR,Subject: FlightToRecoveryTransaction ID: 11700335Y7511251Ehttps://www.paypal.com/activity/payment/11700335Y7511251E,PayPal Bank 3,--,$18.81,$481.43
Donations directed by individuals,11/27/2023,Deposit,11700335Y7511251E,10 Flight to Recovery RESTR,Flight to Recovery - Flight to Recovery,Contributed income:Donations directed by individuals,PayPal Bank 3,$20.00,$501.43
PayPal Fees,11/27/2023,Deposit,11700335Y7511251E,10 Flight to Recovery RESTR,PayPal fees,OFFICE/GENERAL ADMINISTRATIVE EXPENSES:PayPal Fees,PayPal Bank 3,$1.19,$502.62
PayPal Bank 3,11/27/2023,Deposit,5SC22996SP0747445,09 MSU RESTR,Subject: New 10 UnitsTransaction ID: 5SC22996SP0747445https://www.paypal.com/activity/payment/5SC22996SP0747445,PayPal Bank 3,--,$47.76,$550.38
Donations directed by individuals,11/27/2023,Deposit,5SC22996SP0747445,09 MSU RESTR,donation-form,Contributed income:Donations directed by individuals,PayPal Bank 3,$50.00,$600.38
PayPal Fees,11/27/2023,Deposit,5SC22996SP0747445,09 MSU RESTR,PayPal fees,OFFICE/GENERAL ADMINISTRATIVE EXPENSES:PayPal Fees,PayPal Bank 3,$2.24,$602.62
PayPal Bank 3,11/27/2023,Deposit,7HW10979F5348170E,04 PAYPAL GENERAL UNRESTR,Subject: GeneralPageNote: Thank you for your bravery.   We are 100% behind your effort.Transaction ID: 7HW10979F5348170Ehttps://www.paypal.com/activity/payment/7HW10979F5348170E,PayPal Bank 3,--,$100.00,$702.62
Donations directed by individuals,11/27/2023,Deposit,7HW10979F5348170E,04 PAYPAL GENERAL UNRESTR,Support Ukraine - Support Ukraine,Contributed income:Donations directed by individuals,PayPal Bank 3,$102.53,$805.15
PayPal Fees,11/27/2023,Deposit,7HW10979F5348170E,04 PAYPAL GENERAL UNRESTR,PayPal fees,OFFICE/GENERAL ADMINISTRATIVE EXPENSES:PayPal Fees,PayPal Bank 3,$2.53,$807.68
PayPal Bank 3,11/27/2023,Deposit,8S090093AM688972C,08 VICTORY DRONES RESTR,Subject: VICTORY DRONESTransaction ID: 8S090093AM688972Chttps://www.paypal.com/activity/payment/8S090093AM688972C,PayPal Bank 3,--,$100.93,$908.61
Donations directed by individuals,11/27/2023,Deposit,8S090093AM688972C,08 VICTORY DRONES RESTR,Money in to PayPal,Contributed income:Donations directed by individuals,PayPal Bank 3,$103.48,"$1,012.09"
PayPal Fees,11/27/2023,Deposit,8S090093AM688972C,08 VICTORY DRONES RESTR,PayPal fees,OFFICE/GENERAL ADMINISTRATIVE EXPENSES:PayPal Fees,PayPal Bank 3,$2.55,"$1,014.64"
PayPal Bank 3,11/27/2023,Deposit,0U362913815712404,04 PAYPAL GENERAL UNRESTR,Subject: GeneralPageTransaction ID: 0U362913815712404https://www.paypal.com/activity/payment/0U362913815712404,PayPal Bank 3,--,$49.23,"$1,063.87"
Donations directed by individuals,11/27/2023,Deposit,0U362913815712404,04 PAYPAL GENERAL UNRESTR,Support Ukraine - Support Ukraine,Contributed income:Donations directed by individuals,PayPal Bank 3,$51.52,"$1,115.39"
PayPal Fees,11/27/2023,Deposit,0U362913815712404,04 PAYPAL GENERAL UNRESTR,PayPal fees,OFFICE/GENERAL ADMINISTRATIVE EXPENSES:PayPal Fees,PayPal Bank 3,$2.29,"$1,117.68"
PayPal Bank 3,11/27/2023,Deposit,7K258496F7487793L,07 1000 DRONES RESTR,Subject: GeneralPageNote: for dronesTransaction ID: 7K258496F7487793Lhttps://www.paypal.com/activity/payment/7K258496F7487793L,PayPal Bank 3,--,$50.66,"$1,168.34"
Donations directed by individuals,11/27/2023,Deposit,7K258496F7487793L,07 1000 DRONES RESTR,Support Ukraine - Support Ukraine,Contributed income:Donations directed by individuals,PayPal Bank 3,$53.00,"$1,221.34"
PayPal Fees,11/27/2023,Deposit,7K258496F7487793L,07 1000 DRONES RESTR,PayPal fees,OFFICE/GENERAL ADMINISTRATIVE EXPENSES:PayPal Fees,PayPal Bank 3,$2.34,"$1,223.68"
PayPal Bank 3,11/27/2023,Deposit,3SS47357LG849521R,04 PAYPAL GENERAL UNRESTR,Subject: GeneralPageTransaction ID: 3SS47357LG849521Rhttps://www.paypal.com/activity/payment/3SS47357LG849521R,PayPal Bank 3,--,$984.68,"$2,208.36"
Donations directed by individuals,11/27/2023,Deposit,3SS47357LG849521R,04 PAYPAL GENERAL UNRESTR,Support Ukraine - Support Ukraine,Contributed income:Donations directed by individuals,PayPal Bank 3,"$1,020.80","$3,229.16"
PayPal Fees,11/27/2023,Deposit,3SS47357LG849521R,04 PAYPAL GENERAL UNRESTR,PayPal fees,OFFICE/GENERAL ADMINISTRATIVE EXPENSES:PayPal Fees,PayPal Bank 3,$36.12,"$3,265.28"
PayPal Bank 3,11/26/2023,Deposit,31N6868047777882E,09 MSU RESTR,Subject: New 10 UnitsTransaction ID: 31N6868047777882Ehttps://www.paypal.com/activity/payment/31N6868047777882E,PayPal Bank 3,--,$96.02,"$3,361.30"
Donations directed by individuals,11/26/2023,Deposit,31N6868047777882E,09 MSU RESTR,donation-form,Contributed income:Donations directed by individuals,PayPal Bank 3,$100.00,"$3,461.30"
PayPal Fees,11/26/2023,Deposit,31N6868047777882E,09 MSU RESTR,PayPal fees,OFFICE/GENERAL ADMINISTRATIVE EXPENSES:PayPal Fees,PayPal Bank 3,$3.98,"$3,465.28"
PayPal Bank 3,11/26/2023,Deposit,3FW60130UA040601L,04 PAYPAL GENERAL UNRESTR,Subject: GeneralPageTransaction ID: 3FW60130UA040601Lhttps://www.paypal.com/activity/payment/3FW60130UA040601L,PayPal Bank 3,--,$196.93,"$3,662.21"
Donations directed by individuals,11/26/2023,Deposit,3FW60130UA040601L,04 PAYPAL GENERAL UNRESTR,Support Ukraine - Support Ukraine,Contributed income:Donations directed by individuals,PayPal Bank 3,$204.56,"$3,866.77"
PayPal Fees,11/26/2023,Deposit,3FW60130UA040601L,04 PAYPAL GENERAL UNRESTR,PayPal fees,OFFICE/GENERAL ADMINISTRATIVE EXPENSES:PayPal Fees,PayPal Bank 3,$7.63,"$3,874.40"
PayPal Bank 3,11/26/2023,Deposit,6EF80245SG352483H,04 PAYPAL GENERAL UNRESTR,Subject: Support UkraineTransaction ID: 6EF80245SG352483Hhttps://www.paypal.com/activity/payment/6EF80245SG352483H,PayPal Bank 3,--,$28.91,"$3,903.31"
Donations directed by individuals,11/26/2023,Deposit,6EF80245SG352483H,04 PAYPAL GENERAL UNRESTR,Money in to PayPal,Contributed income:Donations directed by individuals,PayPal Bank 3,$30.00,"$3,933.31"
PayPal Fees,11/26/2023,Deposit,6EF80245SG352483H,04 PAYPAL GENERAL UNRESTR,PayPal fees,OFFICE/GENERAL ADMINISTRATIVE EXPENSES:PayPal Fees,PayPal Bank 3,$1.09,"$3,934.40"
PayPal Bank 3,11/25/2023,Deposit,0GX27528B5408582P,04 PAYPAL GENERAL UNRESTR,Subject: Support UkraineTransaction ID: 0GX27528B5408582Phttps://www.paypal.com/activity/payment/0GX27528B5408582P,PayPal Bank 3,--,$18.71,"$3,953.11"
Donations directed by individuals,11/25/2023,Deposit,0GX27528B5408582P,04 PAYPAL GENERAL UNRESTR,Money in to PayPal,Contributed income:Donations directed by individuals,PayPal Bank 3,$19.89,"$3,973.00"
PayPal Fees,11/25/2023,Deposit,0GX27528B5408582P,04 PAYPAL GENERAL UNRESTR,PayPal fees,OFFICE/GENERAL ADMINISTRATIVE EXPENSES:PayPal Fees,PayPal Bank 3,$1.18,"$3,974.18"
PayPal Bank 3,11/25/2023,Deposit,7KW29049S07432908,07 1000 DRONES RESTR,Subject: 1000DRONESTransaction ID: 7KW29049S07432908https://www.paypal.com/activity/payment/7KW29049S07432908,PayPal Bank 3,--,$49.23,"$4,023.41"
Donations directed by individuals,11/25/2023,Deposit,7KW29049S07432908,07 1000 DRONES RESTR,1000 DRONES FOR UKRAINE - 1000 DRONES FOR UKRAINE,Contributed income:Donations directed by individuals,PayPal Bank 3,$51.52,"$4,074.93"
PayPal Fees,11/25/2023,Deposit,7KW29049S07432908,07 1000 DRONES RESTR,PayPal fees,OFFICE/GENERAL ADMINISTRATIVE EXPENSES:PayPal Fees,PayPal Bank 3,$2.29,"$4,077.22"
PayPal Bank 3,11/25/2023,Deposit,4T684250T6132730G,07 1000 DRONES RESTR,Subject: GeneralPageNote: На люті пташкиTransaction ID: 4T684250T6132730Ghttps://www.paypal.com/activity/payment/4T684250T6132730G,PayPal Bank 3,--,$590.81,"$4,668.03"
Donations directed by individuals,11/25/2023,Deposit,4T684250T6132730G,07 1000 DRONES RESTR,Support Ukraine - Support Ukraine,Contributed income:Donations directed by individuals,PayPal Bank 3,$612.68,"$5,280.71"
PayPal Fees,11/25/2023,Deposit,4T684250T6132730G,07 1000 DRONES RESTR,PayPal fees,OFFICE/GENERAL ADMINISTRATIVE EXPENSES:PayPal Fees,PayPal Bank 3,$21.87,"$5,302.58"
PayPal Bank 3,11/25/2023,Deposit,5WA587425V526970D,07 1000 DRONES RESTR,Subject: 1000DRONESTransaction ID: 5WA587425V526970Dhttps://www.paypal.com/activity/payment/5WA587425V526970D,PayPal Bank 3,--,$196.93,"$5,499.51"
Donations directed by individuals,11/25/2023,Deposit,5WA587425V526970D,07 1000 DRONES RESTR,1000 DRONES FOR UKRAINE - 1000 DRONES FOR UKRAINE,Contributed income:Donations directed by individuals,PayPal Bank 3,$204.56,"$5,704.07"
PayPal Fees,11/25/2023,Deposit,5WA587425V526970D,07 1000 DRONES RESTR,PayPal fees,OFFICE/GENERAL ADMINISTRATIVE EXPENSES:PayPal Fees,PayPal Bank 3,$7.63,"$5,711.70"
PayPal Bank 3,11/25/2023,Deposit,051305330K786521L,04 PAYPAL GENERAL UNRESTR,Subject: GeneralPageTransaction ID: 051305330K786521Lhttps://www.paypal.com/activity/payment/051305330K786521L,PayPal Bank 3,--,$9.84,"$5,721.54"
Donations directed by individuals,11/25/2023,Deposit,051305330K786521L,04 PAYPAL GENERAL UNRESTR,Support Ukraine - Support Ukraine,Contributed income:Donations directed by individuals,PayPal Bank 3,$10.70,"$5,732.24"
PayPal Fees,11/25/2023,Deposit,051305330K786521L,04 PAYPAL GENERAL UNRESTR,PayPal fees,OFFICE/GENERAL ADMINISTRATIVE EXPENSES:PayPal Fees,PayPal Bank 3,$0.86,"$5,733.10"
PayPal Bank 3,11/25/2023,Deposit,9MW02123YE491364N,04 PAYPAL GENERAL UNRESTR,Subject: GeneralPageTransaction ID: 9MW02123YE491364Nhttps://www.paypal.com/activity/payment/9MW02123YE491364N,PayPal Bank 3,--,$29.53,"$5,762.63"
Donations directed by individuals,11/25/2023,Deposit,9MW02123YE491364N,04 PAYPAL GENERAL UNRESTR,Support Ukraine - Support Ukraine,Contributed income:Donations directed by individuals,PayPal Bank 3,$31.11,"$5,793.74"
PayPal Fees,11/25/2023,Deposit,9MW02123YE491364N,04 PAYPAL GENERAL UNRESTR,PayPal fees,OFFICE/GENERAL ADMINISTRATIVE EXPENSES:PayPal Fees,PayPal Bank 3,$1.58,"$5,795.32"
PayPal Bank 3,11/25/2023,Deposit,9WG817616W512203H,04 PAYPAL GENERAL UNRESTR,Subject: GeneralPageTransaction ID: 9WG817616W512203Hhttps://www.paypal.com/activity/payment/9WG817616W512203H,PayPal Bank 3,--,$100.00,"$5,895.32"
Donations directed by individuals,11/25/2023,Deposit,9WG817616W512203H,04 PAYPAL GENERAL UNRESTR,Support Ukraine - Support Ukraine,Contributed income:Donations directed by individuals,PayPal Bank 3,$102.53,"$5,997.85"
PayPal Fees,11/25/2023,Deposit,9WG817616W512203H,04 PAYPAL GENERAL UNRESTR,PayPal fees,OFFICE/GENERAL ADMINISTRATIVE EXPENSES:PayPal Fees,PayPal Bank 3,$2.53,"$6,000.38"
PayPal Bank 3,11/25/2023,Deposit,3LT71298P6952171J,04 PAYPAL GENERAL UNRESTR,Subject: GeneralPageTransaction ID: 3LT71298P6952171Jhttps://www.paypal.com/activity/payment/3LT71298P6952171J,PayPal Bank 3,--,$19.69,"$6,020.07"
Donations directed by individuals,11/25/2023,Deposit,3LT71298P6952171J,04 PAYPAL GENERAL UNRESTR,Support Ukraine - Support Ukraine,Contributed income:Donations directed by individuals,PayPal Bank 3,$20.91,"$6,040.98"
PayPal Fees,11/25/2023,Deposit,3LT71298P6952171J,04 PAYPAL GENERAL UNRESTR,PayPal fees,OFFICE/GENERAL ADMINISTRATIVE EXPENSES:PayPal Fees,PayPal Bank 3,$1.22,"$6,042.20"
PayPal Bank 3,11/24/2023,Deposit,23T29475VW450432F,10 Flight to Recovery RESTR,Subject: Flight to RecoveryTransaction ID: 23T29475VW450432Fhttps://www.paypal.com/activity/payment/23T29475VW450432F,PayPal Bank 3,--,$50.00,"$6,092.20"
Donations directed by individuals,11/24/2023,Deposit,23T29475VW450432F,10 Flight to Recovery RESTR,Money in to PayPal,Contributed income:Donations directed by individuals,PayPal Bank 3,$51.52,"$6,143.72"
PayPal Fees,11/24/2023,Deposit,23T29475VW450432F,10 Flight to Recovery RESTR,PayPal fees,OFFICE/GENERAL ADMINISTRATIVE EXPENSES:PayPal Fees,PayPal Bank 3,$1.52,"$6,145.24"
PayPal Bank 3,11/24/2023,Deposit,82400142N47206118,04 PAYPAL GENERAL UNRESTR,Subject: GeneralPageTransaction ID: 82400142N47206118https://www.paypal.com/activity/payment/82400142N47206118,PayPal Bank 3,--,"$10,000.00","$16,145.24"
Donations directed by individuals,11/24/2023,Deposit,82400142N47206118,04 PAYPAL GENERAL UNRESTR,Support Ukraine - Support Ukraine,Contributed income:Donations directed by individuals,PayPal Bank 3,"$10,203.54","$26,348.78"
PayPal Fees,11/24/2023,Deposit,82400142N47206118,04 PAYPAL GENERAL UNRESTR,PayPal fees,OFFICE/GENERAL ADMINISTRATIVE EXPENSES:PayPal Fees,PayPal Bank 3,$203.54,"$26,552.32"
PayPal Bank 3,11/24/2023,Deposit,5KF19005WF2695508,07 1000 DRONES RESTR,Subject: 1000DRONESTransaction ID: 5KF19005WF2695508https://www.paypal.com/activity/payment/5KF19005WF2695508,PayPal Bank 3,--,$25.00,"$26,577.32"
Donations directed by individuals,11/24/2023,Deposit,5KF19005WF2695508,07 1000 DRONES RESTR,1000 DRONES FOR UKRAINE - 1000 DRONES FOR UKRAINE,Contributed income:Donations directed by individuals,PayPal Bank 3,$26.01,"$26,603.33"
PayPal Fees,11/24/2023,Deposit,5KF19005WF2695508,07 1000 DRONES RESTR,PayPal fees,OFFICE/GENERAL ADMINISTRATIVE EXPENSES:PayPal Fees,PayPal Bank 3,$1.01,"$26,604.34"
PayPal Bank 3,11/23/2023,Deposit,23H353613M979391X,04 PAYPAL GENERAL UNRESTR,Subject: GeneralPageTransaction ID: 23H353613M979391Xhttps://www.paypal.com/activity/payment/23H353613M979391X,PayPal Bank 3,--,$78.76,"$26,683.10"
Donations directed by individuals,11/23/2023,Deposit,23H353613M979391X,04 PAYPAL GENERAL UNRESTR,Support Ukraine - Support Ukraine,Contributed income:Donations directed by individuals,PayPal Bank 3,$82.12,"$26,765.22"
PayPal Fees,11/23/2023,Deposit,23H353613M979391X,04 PAYPAL GENERAL UNRESTR,PayPal fees,OFFICE/GENERAL ADMINISTRATIVE EXPENSES:PayPal Fees,PayPal Bank 3,$3.36,"$26,768.58"
PayPal Bank 3,11/23/2023,Deposit,6F032898JR0993712,08 VICTORY DRONES RESTR,Subject: VICTORY DRONESTransaction ID: 6F032898JR0993712https://www.paypal.com/activity/payment/6F032898JR0993712,PayPal Bank 3,--,$2.97,"$26,771.55"
Donations directed by individuals,11/23/2023,Deposit,6F032898JR0993712,08 VICTORY DRONES RESTR,Money in to PayPal,Contributed income:Donations directed by individuals,PayPal Bank 3,$3.59,"$26,775.14"
PayPal Fees,11/23/2023,Deposit,6F032898JR0993712,08 VICTORY DRONES RESTR,PayPal fees,OFFICE/GENERAL ADMINISTRATIVE EXPENSES:PayPal Fees,PayPal Bank 3,$0.62,"$26,775.76"
PayPal Bank 3,11/23/2023,Deposit,2SE16079PR916784A,04 PAYPAL GENERAL UNRESTR,Subject: Support UkraineTransaction ID: 2SE16079PR916784Ahttps://www.paypal.com/activity/payment/2SE16079PR916784A,PayPal Bank 3,--,$50.47,"$26,826.23"
Donations directed by individuals,11/23/2023,Deposit,2SE16079PR916784A,04 PAYPAL GENERAL UNRESTR,Money in to PayPal,Contributed income:Donations directed by individuals,PayPal Bank 3,$51.99,"$26,878.22"
PayPal Fees,11/23/2023,Deposit,2SE16079PR916784A,04 PAYPAL GENERAL UNRESTR,PayPal fees,OFFICE/GENERAL ADMINISTRATIVE EXPENSES:PayPal Fees,PayPal Bank 3,$1.52,"$26,879.74"
PayPal Bank 3,11/23/2023,Deposit,4G737420JA1618043,04 PAYPAL GENERAL UNRESTR,Subject: GeneralPageTransaction ID: 4G737420JA1618043https://www.paypal.com/activity/payment/4G737420JA1618043,PayPal Bank 3,--,$500.00,"$27,379.74"
Donations directed by individuals,11/23/2023,Deposit,4G737420JA1618043,04 PAYPAL GENERAL UNRESTR,Support Ukraine - Support Ukraine,Contributed income:Donations directed by individuals,PayPal Bank 3,$510.65,"$27,890.39"
PayPal Fees,11/23/2023,Deposit,4G737420JA1618043,04 PAYPAL GENERAL UNRESTR,PayPal fees,OFFICE/GENERAL ADMINISTRATIVE EXPENSES:PayPal Fees,PayPal Bank 3,$10.65,"$27,901.04"
PayPal Bank 3,11/23/2023,Deposit,9XM84196GG2949641,04 PAYPAL GENERAL UNRESTR,Subject: GeneralPageTransaction ID: 9XM84196GG2949641https://www.paypal.com/activity/payment/9XM84196GG2949641,PayPal Bank 3,--,$50.00,"$27,951.04"
Donations directed by individuals,11/23/2023,Deposit,9XM84196GG2949641,04 PAYPAL GENERAL UNRESTR,Support Ukraine - Support Ukraine,Contributed income:Donations directed by individuals,PayPal Bank 3,$51.52,"$28,002.56"
PayPal Fees,11/23/2023,Deposit,9XM84196GG2949641,04 PAYPAL GENERAL UNRESTR,PayPal fees,OFFICE/GENERAL ADMINISTRATIVE EXPENSES:PayPal Fees,PayPal Bank 3,$1.52,"$28,004.08"
PayPal Bank 3,11/23/2023,Deposit,2SR895994M1188117,04 PAYPAL GENERAL UNRESTR,Subject: GeneralPageTransaction ID: 2SR895994M1188117https://www.paypal.com/activity/payment/2SR895994M1188117,PayPal Bank 3,--,$28.46,"$28,032.54"
Donations directed by individuals,11/23/2023,Deposit,2SR895994M1188117,04 PAYPAL GENERAL UNRESTR,Support Ukraine - Support Ukraine,Contributed income:Donations directed by individuals,PayPal Bank 3,$30.00,"$28,062.54"
PayPal Fees,11/23/2023,Deposit,2SR895994M1188117,04 PAYPAL GENERAL UNRESTR,PayPal fees,OFFICE/GENERAL ADMINISTRATIVE EXPENSES:PayPal Fees,PayPal Bank 3,$1.54,"$28,064.08"
PayPal Bank 3,11/23/2023,Deposit,2WY669761D916612N,08 VICTORY DRONES RESTR,Subject: VictoryDronesTransaction ID: 2WY669761D916612Nhttps://www.paypal.com/activity/payment/2WY669761D916612N,PayPal Bank 3,--,$97.52,"$28,161.60"
Donations directed by individuals,11/23/2023,Deposit,2WY669761D916612N,08 VICTORY DRONES RESTR,VICTORY DRONES - VICTORY DRONES,Contributed income:Donations directed by individuals,PayPal Bank 3,$100.00,"$28,261.60"
PayPal Fees,11/23/2023,Deposit,2WY669761D916612N,08 VICTORY DRONES RESTR,PayPal fees,OFFICE/GENERAL ADMINISTRATIVE EXPENSES:PayPal Fees,PayPal Bank 3,$2.48,"$28,264.08"
Donations directed by individuals,11/23/2023,Journal Entry,19,--,--,Contributed income:Donations directed by individuals,--,$309.43,"$28,573.51"
PayPal Bank 3,11/23/2023,Journal Entry,19,--,--,PayPal Bank 3,--,$298.14,"$28,871.65"
PayPal Fees,11/23/2023,Journal Entry,19,--,--,OFFICE/GENERAL ADMINISTRATIVE EXPENSES:PayPal Fees,--,$11.29,"$28,882.94"
PayPal Bank 3,11/22/2023,Deposit,1U426201N7447882M,07 1000 DRONES RESTR,Subject: 1000DRONESTransaction ID: 1U426201N7447882Mhttps://www.paypal.com/activity/payment/1U426201N7447882M,PayPal Bank 3,--,$9.16,"$28,892.10"
Donations directed by individuals,11/22/2023,Deposit,1U426201N7447882M,07 1000 DRONES RESTR,1000 DRONES FOR UKRAINE - 1000 DRONES FOR UKRAINE,Contributed income:Donations directed by individuals,PayPal Bank 3,$10.00,"$28,902.10"
PayPal Fees,11/22/2023,Deposit,1U426201N7447882M,07 1000 DRONES RESTR,PayPal fees,OFFICE/GENERAL ADMINISTRATIVE EXPENSES:PayPal Fees,PayPal Bank 3,$0.84,"$28,902.94"
PayPal Bank 3,11/22/2023,Deposit,6EY05401BP0464255,04 PAYPAL GENERAL UNRESTR,Subject: GeneralPageTransaction ID: 6EY05401BP0464255https://www.paypal.com/activity/payment/6EY05401BP0464255,PayPal Bank 3,--,$9.16,"$28,912.10"
Donations directed by individuals,11/22/2023,Deposit,6EY05401BP0464255,04 PAYPAL GENERAL UNRESTR,Support Ukraine - Support Ukraine,Contributed income:Donations directed by individuals,PayPal Bank 3,$10.00,"$28,922.10"
PayPal Fees,11/22/2023,Deposit,6EY05401BP0464255,04 PAYPAL GENERAL UNRESTR,PayPal fees,OFFICE/GENERAL ADMINISTRATIVE EXPENSES:PayPal Fees,PayPal Bank 3,$0.84,"$28,922.94"
PayPal Bank 3,11/22/2023,Deposit,5FP24855065411035,04 PAYPAL GENERAL UNRESTR,Subject: GeneralPageTransaction ID: 5FP24855065411035https://www.paypal.com/activity/payment/5FP24855065411035,PayPal Bank 3,--,$500.00,"$29,422.94"
Donations directed by individuals,11/22/2023,Deposit,5FP24855065411035,04 PAYPAL GENERAL UNRESTR,Support Ukraine - Support Ukraine,Contributed income:Donations directed by individuals,PayPal Bank 3,$510.65,"$29,933.59"
PayPal Fees,11/22/2023,Deposit,5FP24855065411035,04 PAYPAL GENERAL UNRESTR,PayPal fees,OFFICE/GENERAL ADMINISTRATIVE EXPENSES:PayPal Fees,PayPal Bank 3,$10.65,"$29,944.24"
PayPal Bank 3,11/22/2023,Deposit,4N2931039J953594P,07 1000 DRONES RESTR,Subject: 1000 DRONES FOR UKRAINETransaction ID: 4N2931039J953594Phttps://www.paypal.com/activity/payment/4N2931039J953594P,PayPal Bank 3,--,$157.55,"$30,101.79"
Donations directed by individuals,11/22/2023,Deposit,4N2931039J953594P,07 1000 DRONES RESTR,Money in to PayPal,Contributed income:Donations directed by individuals,PayPal Bank 3,$163.75,"$30,265.54"
PayPal Fees,11/22/2023,Deposit,4N2931039J953594P,07 1000 DRONES RESTR,PayPal fees,OFFICE/GENERAL ADMINISTRATIVE EXPENSES:PayPal Fees,PayPal Bank 3,$6.20,"$30,271.74"
PayPal Bank 3,11/22/2023,Deposit,6C096253HR694951W,04 PAYPAL GENERAL UNRESTR,Subject: Support UkraineTransaction ID: 6C096253HR694951Whttps://www.paypal.com/activity/payment/6C096253HR694951W,PayPal Bank 3,--,$19.87,"$30,291.61"
Donations directed by individuals,11/22/2023,Deposit,6C096253HR694951W,04 PAYPAL GENERAL UNRESTR,Money in to PayPal,Contributed income:Donations directed by individuals,PayPal Bank 3,$21.10,"$30,312.71"
PayPal Fees,11/22/2023,Deposit,6C096253HR694951W,04 PAYPAL GENERAL UNRESTR,PayPal fees,OFFICE/GENERAL ADMINISTRATIVE EXPENSES:PayPal Fees,PayPal Bank 3,$1.23,"$30,313.94"
PayPal Bank 3,11/21/2023,Deposit,4CY7547329935040W,04 PAYPAL GENERAL UNRESTR,Subject: Support UkraineTransaction ID: 4CY7547329935040Whttps://www.paypal.com/activity/payment/4CY7547329935040W,PayPal Bank 3,--,$50.47,"$30,364.41"
Donations directed by individuals,11/21/2023,Deposit,4CY7547329935040W,04 PAYPAL GENERAL UNRESTR,Money in to PayPal,Contributed income:Donations directed by individuals,PayPal Bank 3,$51.99,"$30,416.40"
PayPal Fees,11/21/2023,Deposit,4CY7547329935040W,04 PAYPAL GENERAL UNRESTR,PayPal fees,OFFICE/GENERAL ADMINISTRATIVE EXPENSES:PayPal Fees,PayPal Bank 3,$1.52,"$30,417.92"
PayPal Bank 3,11/21/2023,Deposit,48N97635X10033144,04 PAYPAL GENERAL UNRESTR,Subject: Support UkraineTransaction ID: 48N97635X10033144https://www.paypal.com/activity/payment/48N97635X10033144,PayPal Bank 3,--,$24.84,"$30,442.76"
Donations directed by individuals,11/21/2023,Deposit,48N97635X10033144,04 PAYPAL GENERAL UNRESTR,Money in to PayPal,Contributed income:Donations directed by individuals,PayPal Bank 3,$26.25,"$30,469.01"
PayPal Fees,11/21/2023,Deposit,48N97635X10033144,04 PAYPAL GENERAL UNRESTR,PayPal fees,OFFICE/GENERAL ADMINISTRATIVE EXPENSES:PayPal Fees,PayPal Bank 3,$1.41,"$30,470.42"
PayPal Bank 3,11/21/2023,Deposit,10R01838R4978223D,04 PAYPAL GENERAL UNRESTR,Subject: GeneralPageTransaction ID: 10R01838R4978223Dhttps://www.paypal.com/activity/payment/10R01838R4978223D,PayPal Bank 3,--,$34.46,"$30,504.88"
Donations directed by individuals,11/21/2023,Deposit,10R01838R4978223D,04 PAYPAL GENERAL UNRESTR,Support Ukraine - Support Ukraine,Contributed income:Donations directed by individuals,PayPal Bank 3,$36.21,"$30,541.09"
PayPal Fees,11/21/2023,Deposit,10R01838R4978223D,04 PAYPAL GENERAL UNRESTR,PayPal fees,OFFICE/GENERAL ADMINISTRATIVE EXPENSES:PayPal Fees,PayPal Bank 3,$1.75,"$30,542.84"
PayPal Bank 3,11/21/2023,Deposit,5JG69579PP810320T,04 PAYPAL GENERAL UNRESTR,Subject: Support UkraineTransaction ID: 5JG69579PP810320Thttps://www.paypal.com/activity/payment/5JG69579PP810320T,PayPal Bank 3,--,$23.63,"$30,566.47"
Donations directed by individuals,11/21/2023,Deposit,5JG69579PP810320T,04 PAYPAL GENERAL UNRESTR,Money in to PayPal,Contributed income:Donations directed by individuals,PayPal Bank 3,$24.99,"$30,591.46"
PayPal Fees,11/21/2023,Deposit,5JG69579PP810320T,04 PAYPAL GENERAL UNRESTR,PayPal fees,OFFICE/GENERAL ADMINISTRATIVE EXPENSES:PayPal Fees,PayPal Bank 3,$1.36,"$30,592.82"
PayPal Bank 3,11/21/2023,Deposit,253365199H341794T,--,"Subject: GeneralPageNote: Дякую, Любо!Transaction ID: 253365199H341794Thttps://www.paypal.com/activity/payment/253365199H341794T",PayPal Bank 3,--,$250.00,"$30,842.82"
Donations directed by individuals,11/21/2023,Deposit,253365199H341794T,--,Support Ukraine - Support Ukraine,Contributed income:Donations directed by individuals,PayPal Bank 3,$255.58,"$31,098.40"
PayPal Fees,11/21/2023,Deposit,253365199H341794T,--,PayPal fees,OFFICE/GENERAL ADMINISTRATIVE EXPENSES:PayPal Fees,PayPal Bank 3,$5.58,"$31,103.98"
PayPal Bank 3,11/20/2023,Deposit,8V7241598D265010J,04 PAYPAL GENERAL UNRESTR,Subject: GeneralPageTransaction ID: 8V7241598D265010Jhttps://www.paypal.com/activity/payment/8V7241598D265010J,PayPal Bank 3,--,$50.00,"$31,153.98"
Donations directed by individuals,11/20/2023,Deposit,8V7241598D265010J,04 PAYPAL GENERAL UNRESTR,Support Ukraine - Support Ukraine,Contributed income:Donations directed by individuals,PayPal Bank 3,$51.52,"$31,205.50"
PayPal Fees,11/20/2023,Deposit,8V7241598D265010J,04 PAYPAL GENERAL UNRESTR,PayPal fees,OFFICE/GENERAL ADMINISTRATIVE EXPENSES:PayPal Fees,PayPal Bank 3,$1.52,"$31,207.02"
PayPal Bank 3,11/20/2023,Deposit,6W059068G6709415E,07 1000 DRONES RESTR,Subject: 1000DRONESTransaction ID: 6W059068G6709415Ehttps://www.paypal.com/activity/payment/6W059068G6709415E,PayPal Bank 3,--,$34.46,"$31,241.48"
Donations directed by individuals,11/20/2023,Deposit,6W059068G6709415E,07 1000 DRONES RESTR,1000 DRONES FOR UKRAINE - 1000 DRONES FOR UKRAINE,Contributed income:Donations directed by individuals,PayPal Bank 3,$36.21,"$31,277.69"
PayPal Fees,11/20/2023,Deposit,6W059068G6709415E,07 1000 DRONES RESTR,PayPal fees,OFFICE/GENERAL ADMINISTRATIVE EXPENSES:PayPal Fees,PayPal Bank 3,$1.75,"$31,279.44"
PayPal Bank 3,11/20/2023,Deposit,0HF1095302855471A,04 PAYPAL GENERAL UNRESTR,Subject: Support UkraineTransaction ID: 0HF1095302855471Ahttps://www.paypal.com/activity/payment/0HF1095302855471A,PayPal Bank 3,--,$9.16,"$31,288.60"
Donations directed by individuals,11/20/2023,Deposit,0HF1095302855471A,04 PAYPAL GENERAL UNRESTR,Money in to PayPal,Contributed income:Donations directed by individuals,PayPal Bank 3,$10.00,"$31,298.60"
PayPal Fees,11/20/2023,Deposit,0HF1095302855471A,04 PAYPAL GENERAL UNRESTR,PayPal fees,OFFICE/GENERAL ADMINISTRATIVE EXPENSES:PayPal Fees,PayPal Bank 3,$0.84,"$31,299.44"
PayPal Bank 3,11/20/2023,Deposit,33557123ES158280K,04 PAYPAL GENERAL UNRESTR,Subject: GeneralPageTransaction ID: 33557123ES158280Khttps://www.paypal.com/activity/payment/33557123ES158280K,PayPal Bank 3,--,$29.53,"$31,328.97"
Donations directed by individuals,11/20/2023,Deposit,33557123ES158280K,04 PAYPAL GENERAL UNRESTR,Support Ukraine - Support Ukraine,Contributed income:Donations directed by individuals,PayPal Bank 3,$31.11,"$31,360.08"
PayPal Fees,11/20/2023,Deposit,33557123ES158280K,04 PAYPAL GENERAL UNRESTR,PayPal fees,OFFICE/GENERAL ADMINISTRATIVE EXPENSES:PayPal Fees,PayPal Bank 3,$1.58,"$31,361.66"
PayPal Bank 3,11/20/2023,Deposit,00E57764GC219760N,04 PAYPAL GENERAL UNRESTR,Subject: GeneralPageTransaction ID: 00E57764GC219760Nhttps://www.paypal.com/activity/payment/00E57764GC219760N,PayPal Bank 3,--,$9.84,"$31,371.50"
Donations directed by individuals,11/20/2023,Deposit,00E57764GC219760N,04 PAYPAL GENERAL UNRESTR,Support Ukraine - Support Ukraine,Contributed income:Donations directed by individuals,PayPal Bank 3,$10.70,"$31,382.20"
PayPal Fees,11/20/2023,Deposit,00E57764GC219760N,04 PAYPAL GENERAL UNRESTR,PayPal fees,OFFICE/GENERAL ADMINISTRATIVE EXPENSES:PayPal Fees,PayPal Bank 3,$0.86,"$31,383.06"
PayPal Bank 3,11/20/2023,Deposit,7FP76769EF635015G,04 PAYPAL GENERAL UNRESTR,Subject: Support UkraineTransaction ID: 7FP76769EF635015Ghttps://www.paypal.com/activity/payment/7FP76769EF635015G,PayPal Bank 3,--,$9.16,"$31,392.22"
Donations directed by individuals,11/20/2023,Deposit,7FP76769EF635015G,04 PAYPAL GENERAL UNRESTR,Money in to PayPal,Contributed income:Donations directed by individuals,PayPal Bank 3,$10.00,"$31,402.22"
PayPal Fees,11/20/2023,Deposit,7FP76769EF635015G,04 PAYPAL GENERAL UNRESTR,PayPal fees,OFFICE/GENERAL ADMINISTRATIVE EXPENSES:PayPal Fees,PayPal Bank 3,$0.84,"$31,403.06"
PayPal Bank 3,11/20/2023,Deposit,4DB2006608285014V,04 PAYPAL GENERAL UNRESTR,Subject: GeneralPageTransaction ID: 4DB2006608285014Vhttps://www.paypal.com/activity/payment/4DB2006608285014V,PayPal Bank 3,--,$97.52,"$31,500.58"
Donations directed by individuals,11/20/2023,Deposit,4DB2006608285014V,04 PAYPAL GENERAL UNRESTR,Support Ukraine - Support Ukraine,Contributed income:Donations directed by individuals,PayPal Bank 3,$100.00,"$31,600.58"
PayPal Fees,11/20/2023,Deposit,4DB2006608285014V,04 PAYPAL GENERAL UNRESTR,PayPal fees,OFFICE/GENERAL ADMINISTRATIVE EXPENSES:PayPal Fees,PayPal Bank 3,$2.48,"$31,603.06"
PayPal Bank 3,11/20/2023,Deposit,6BW69333JG702230U,04 PAYPAL GENERAL UNRESTR,Subject: Support UkraineTransaction ID: 6BW69333JG702230Uhttps://www.paypal.com/activity/payment/6BW69333JG702230U,PayPal Bank 3,--,$70.08,"$31,673.14"
Donations directed by individuals,11/20/2023,Deposit,6BW69333JG702230U,04 PAYPAL GENERAL UNRESTR,Money in to PayPal,Contributed income:Donations directed by individuals,PayPal Bank 3,$72.00,"$31,745.14"
PayPal Fees,11/20/2023,Deposit,6BW69333JG702230U,04 PAYPAL GENERAL UNRESTR,PayPal fees,OFFICE/GENERAL ADMINISTRATIVE EXPENSES:PayPal Fees,PayPal Bank 3,$1.92,"$31,747.06"
PayPal Bank 3,11/20/2023,Deposit,0GL91133V98395644,07 1000 DRONES RESTR,Subject: 1000DRONESTransaction ID: 0GL91133V98395644https://www.paypal.com/activity/payment/0GL91133V98395644,PayPal Bank 3,--,$19.69,"$31,766.75"
Donations directed by individuals,11/20/2023,Deposit,0GL91133V98395644,07 1000 DRONES RESTR,1000 DRONES FOR UKRAINE - 1000 DRONES FOR UKRAINE,Contributed income:Donations directed by individuals,PayPal Bank 3,$20.91,"$31,787.66"
PayPal Fees,11/20/2023,Deposit,0GL91133V98395644,07 1000 DRONES RESTR,PayPal fees,OFFICE/GENERAL ADMINISTRATIVE EXPENSES:PayPal Fees,PayPal Bank 3,$1.22,"$31,788.88"
PayPal Bank 3,11/20/2023,Deposit,1JJ41240WY4893701,04 PAYPAL GENERAL UNRESTR,Subject: GeneralPageTransaction ID: 1JJ41240WY4893701https://www.paypal.com/activity/payment/1JJ41240WY4893701,PayPal Bank 3,--,$9.16,"$31,798.04"
Donations directed by individuals,11/20/2023,Deposit,1JJ41240WY4893701,04 PAYPAL GENERAL UNRESTR,Support Ukraine - Support Ukraine,Contributed income:Donations directed by individuals,PayPal Bank 3,$10.00,"$31,808.04"
PayPal Fees,11/20/2023,Deposit,1JJ41240WY4893701,04 PAYPAL GENERAL UNRESTR,PayPal fees,OFFICE/GENERAL ADMINISTRATIVE EXPENSES:PayPal Fees,PayPal Bank 3,$0.84,"$31,808.88"
PayPal Bank 3,11/19/2023,Deposit,7AW0007980209540U,04 PAYPAL GENERAL UNRESTR,Subject: GeneralPageTransaction ID: 7AW0007980209540Uhttps://www.paypal.com/activity/payment/7AW0007980209540U,PayPal Bank 3,--,$9.31,"$31,818.19"
Donations directed by individuals,11/19/2023,Deposit,7AW0007980209540U,04 PAYPAL GENERAL UNRESTR,Support Ukraine - Support Ukraine,Contributed income:Donations directed by individuals,PayPal Bank 3,$10.00,"$31,828.19"
PayPal Fees,11/19/2023,Deposit,7AW0007980209540U,04 PAYPAL GENERAL UNRESTR,PayPal fees,OFFICE/GENERAL ADMINISTRATIVE EXPENSES:PayPal Fees,PayPal Bank 3,$0.69,"$31,828.88"
PayPal Bank 3,11/19/2023,Deposit,41U22115V6649302L,07 1000 DRONES RESTR,Subject: 1000 DRONES FOR UKRAINETransaction ID: 41U22115V6649302Lhttps://www.paypal.com/activity/payment/41U22115V6649302L,PayPal Bank 3,--,$18.81,"$31,847.69"
Donations directed by individuals,11/19/2023,Deposit,41U22115V6649302L,07 1000 DRONES RESTR,Money in to PayPal,Contributed income:Donations directed by individuals,PayPal Bank 3,$20.00,"$31,867.69"
PayPal Fees,11/19/2023,Deposit,41U22115V6649302L,07 1000 DRONES RESTR,PayPal fees,OFFICE/GENERAL ADMINISTRATIVE EXPENSES:PayPal Fees,PayPal Bank 3,$1.19,"$31,868.88"
PayPal Bank 3,11/19/2023,Deposit,36N5900591660730M,04 PAYPAL GENERAL UNRESTR,Subject: Support UkraineTransaction ID: 36N5900591660730Mhttps://www.paypal.com/activity/payment/36N5900591660730M,PayPal Bank 3,--,$9.93,"$31,878.81"
Donations directed by individuals,11/19/2023,Deposit,36N5900591660730M,04 PAYPAL GENERAL UNRESTR,Money in to PayPal,Contributed income:Donations directed by individuals,PayPal Bank 3,$10.80,"$31,889.61"
PayPal Fees,11/19/2023,Deposit,36N5900591660730M,04 PAYPAL GENERAL UNRESTR,PayPal fees,OFFICE/GENERAL ADMINISTRATIVE EXPENSES:PayPal Fees,PayPal Bank 3,$0.87,"$31,890.48"
PayPal Bank 3,11/19/2023,Deposit,99V92616V09718308,04 PAYPAL GENERAL UNRESTR,Subject: Support UkraineTransaction ID: 99V92616V09718308https://www.paypal.com/activity/payment/99V92616V09718308,PayPal Bank 3,--,$47.70,"$31,938.18"
Donations directed by individuals,11/19/2023,Deposit,99V92616V09718308,04 PAYPAL GENERAL UNRESTR,Money in to PayPal,Contributed income:Donations directed by individuals,PayPal Bank 3,$49.93,"$31,988.11"
PayPal Fees,11/19/2023,Deposit,99V92616V09718308,04 PAYPAL GENERAL UNRESTR,PayPal fees,OFFICE/GENERAL ADMINISTRATIVE EXPENSES:PayPal Fees,PayPal Bank 3,$2.23,"$31,990.34"
PayPal Bank 3,11/19/2023,Deposit,30V01694B0899741R,04 PAYPAL GENERAL UNRESTR,Subject: Support UkraineTransaction ID: 30V01694B0899741Rhttps://www.paypal.com/activity/payment/30V01694B0899741R,PayPal Bank 3,--,$19.87,"$32,010.21"
Donations directed by individuals,11/19/2023,Deposit,30V01694B0899741R,04 PAYPAL GENERAL UNRESTR,Money in to PayPal,Contributed income:Donations directed by individuals,PayPal Bank 3,$21.10,"$32,031.31"
PayPal Fees,11/19/2023,Deposit,30V01694B0899741R,04 PAYPAL GENERAL UNRESTR,PayPal fees,OFFICE/GENERAL ADMINISTRATIVE EXPENSES:PayPal Fees,PayPal Bank 3,$1.23,"$32,032.54"
PayPal Bank 3,11/19/2023,Deposit,7W470114K4993945V,04 PAYPAL GENERAL UNRESTR,Subject: GeneralPageTransaction ID: 7W470114K4993945Vhttps://www.paypal.com/activity/payment/7W470114K4993945V,PayPal Bank 3,--,$9.16,"$32,041.70"
Donations directed by individuals,11/19/2023,Deposit,7W470114K4993945V,04 PAYPAL GENERAL UNRESTR,Support Ukraine - Support Ukraine,Contributed income:Donations directed by individuals,PayPal Bank 3,$10.00,"$32,051.70"
PayPal Fees,11/19/2023,Deposit,7W470114K4993945V,04 PAYPAL GENERAL UNRESTR,PayPal fees,OFFICE/GENERAL ADMINISTRATIVE EXPENSES:PayPal Fees,PayPal Bank 3,$0.84,"$32,052.54"
PayPal Bank 3,11/18/2023,Transfer,--,--,ORIG CO NAME:PAYPAL ORIG ID:PAYPALSD11 DESC DATE:231117 CO ENTRY DESCR:TRANSFER SEC:PPD TRACE#:091000010037318 EED:231120 IND ID: IND NAME:DIGNITAS UKRAINE TRN: XXXXXX7318TC,PayPal Bank 3,CHASE ENDING IN 5315,"-$11,500.00","$20,552.54"
CHASE ENDING IN 5315,11/18/2023,Transfer,--,--,ORIG CO NAME:PAYPAL ORIG ID:PAYPALSD11 DESC DATE:231117 CO ENTRY DESCR:TRANSFER SEC:PPD TRACE#:091000010037318 EED:231120 IND ID: IND NAME:DIGNITAS UKRAINE TRN: XXXXXX7318TC,CHASE ENDING IN 5315,PayPal Bank 3,"$11,500.00","$32,052.54"
PayPal Bank 3,11/18/2023,Deposit,4XA71597YP164750V,04 PAYPAL GENERAL UNRESTR,Subject: GeneralPageTransaction ID: 4XA71597YP164750Vhttps://www.paypal.com/activity/payment/4XA71597YP164750V,PayPal Bank 3,--,$20.00,"$32,072.54"
Donations directed by individuals,11/18/2023,Deposit,4XA71597YP164750V,04 PAYPAL GENERAL UNRESTR,Support Ukraine - Support Ukraine,Contributed income:Donations directed by individuals,PayPal Bank 3,$20.91,"$32,093.45"
PayPal Fees,11/18/2023,Deposit,4XA71597YP164750V,04 PAYPAL GENERAL UNRESTR,PayPal fees,OFFICE/GENERAL ADMINISTRATIVE EXPENSES:PayPal Fees,PayPal Bank 3,$0.91,"$32,094.36"
PayPal Bank 3,11/18/2023,Deposit,4YW78504J8812132N,04 PAYPAL GENERAL UNRESTR,Subject: GeneralPageTransaction ID: 4YW78504J8812132Nhttps://www.paypal.com/activity/payment/4YW78504J8812132N,PayPal Bank 3,--,$98.46,"$32,192.82"
Donations directed by individuals,11/18/2023,Deposit,4YW78504J8812132N,04 PAYPAL GENERAL UNRESTR,Support Ukraine - Support Ukraine,Contributed income:Donations directed by individuals,PayPal Bank 3,$102.53,"$32,295.35"
PayPal Fees,11/18/2023,Deposit,4YW78504J8812132N,04 PAYPAL GENERAL UNRESTR,PayPal fees,OFFICE/GENERAL ADMINISTRATIVE EXPENSES:PayPal Fees,PayPal Bank 3,$4.07,"$32,299.42"
PayPal Bank 3,11/18/2023,Deposit,67E00611110789140,04 PAYPAL GENERAL UNRESTR,Subject: GeneralPageTransaction ID: 67E00611110789140https://www.paypal.com/activity/payment/67E00611110789140,PayPal Bank 3,--,$200.00,"$32,499.42"
Donations directed by individuals,11/18/2023,Deposit,67E00611110789140,04 PAYPAL GENERAL UNRESTR,Support Ukraine - Support Ukraine,Contributed income:Donations directed by individuals,PayPal Bank 3,$204.56,"$32,703.98"
PayPal Fees,11/18/2023,Deposit,67E00611110789140,04 PAYPAL GENERAL UNRESTR,PayPal fees,OFFICE/GENERAL ADMINISTRATIVE EXPENSES:PayPal Fees,PayPal Bank 3,$4.56,"$32,708.54"
PayPal Bank 3,11/18/2023,Deposit,1E678340YS7240746,04 PAYPAL GENERAL UNRESTR,Subject: Support UkraineTransaction ID: 1E678340YS7240746https://www.paypal.com/activity/payment/1E678340YS7240746,PayPal Bank 3,--,$47.76,"$32,756.30"
Donations directed by individuals,11/18/2023,Deposit,1E678340YS7240746,04 PAYPAL GENERAL UNRESTR,Money in to PayPal,Contributed income:Donations directed by individuals,PayPal Bank 3,$50.00,"$32,806.30"
PayPal Fees,11/18/2023,Deposit,1E678340YS7240746,04 PAYPAL GENERAL UNRESTR,PayPal fees,OFFICE/GENERAL ADMINISTRATIVE EXPENSES:PayPal Fees,PayPal Bank 3,$2.24,"$32,808.54"
PayPal Bank 3,11/18/2023,Deposit,0YK72624BP374931J,09 MSU RESTR,Subject: New 10 UnitsTransaction ID: 0YK72624BP374931Jhttps://www.paypal.com/activity/payment/0YK72624BP374931J,PayPal Bank 3,--,$48.51,"$32,857.05"
Donations directed by individuals,11/18/2023,Deposit,0YK72624BP374931J,09 MSU RESTR,donation-form,Contributed income:Donations directed by individuals,PayPal Bank 3,$50.00,"$32,907.05"
PayPal Fees,11/18/2023,Deposit,0YK72624BP374931J,09 MSU RESTR,PayPal fees,OFFICE/GENERAL ADMINISTRATIVE EXPENSES:PayPal Fees,PayPal Bank 3,$1.49,"$32,908.54"
PayPal Bank 3,11/18/2023,Deposit,5DF65154JB865143F,04 PAYPAL GENERAL UNRESTR,Subject: GeneralPageTransaction ID: 5DF65154JB865143Fhttps://www.paypal.com/activity/payment/5DF65154JB865143F,PayPal Bank 3,--,$18.81,"$32,927.35"
Donations directed by individuals,11/18/2023,Deposit,5DF65154JB865143F,04 PAYPAL GENERAL UNRESTR,Support Ukraine - Support Ukraine,Contributed income:Donations directed by individuals,PayPal Bank 3,$20.00,"$32,947.35"
PayPal Fees,11/18/2023,Deposit,5DF65154JB865143F,04 PAYPAL GENERAL UNRESTR,PayPal fees,OFFICE/GENERAL ADMINISTRATIVE EXPENSES:PayPal Fees,PayPal Bank 3,$1.19,"$32,948.54"
PayPal Bank 3,11/17/2023,Deposit,1K185757M7106850K,08 VICTORY DRONES RESTR,Subject: VICTORY DRONESTransaction ID: 1K185757M7106850Khttps://www.paypal.com/activity/payment/1K185757M7106850K,PayPal Bank 3,--,$2.97,"$32,951.51"
Donations directed by individuals,11/17/2023,Deposit,1K185757M7106850K,08 VICTORY DRONES RESTR,Money in to PayPal,Contributed income:Donations directed by individuals,PayPal Bank 3,$3.59,"$32,955.10"
PayPal Fees,11/17/2023,Deposit,1K185757M7106850K,08 VICTORY DRONES RESTR,PayPal fees,OFFICE/GENERAL ADMINISTRATIVE EXPENSES:PayPal Fees,PayPal Bank 3,$0.62,"$32,955.72"
PayPal Bank 3,11/17/2023,Deposit,6J4245493J161114B,04 PAYPAL GENERAL UNRESTR,Subject: GeneralPageTransaction ID: 6J4245493J161114Bhttps://www.paypal.com/activity/payment/6J4245493J161114B,PayPal Bank 3,--,$14.76,"$32,970.48"
Donations directed by individuals,11/17/2023,Deposit,6J4245493J161114B,04 PAYPAL GENERAL UNRESTR,Support Ukraine - Support Ukraine,Contributed income:Donations directed by individuals,PayPal Bank 3,$15.80,"$32,986.28"
PayPal Fees,11/17/2023,Deposit,6J4245493J161114B,04 PAYPAL GENERAL UNRESTR,PayPal fees,OFFICE/GENERAL ADMINISTRATIVE EXPENSES:PayPal Fees,PayPal Bank 3,$1.04,"$32,987.32"
PayPal Bank 3,11/17/2023,Deposit,7VR32295WD960731K,09 MSU RESTR,Subject: New 10 UnitsTransaction ID: 7VR32295WD960731Khttps://www.paypal.com/activity/payment/7VR32295WD960731K,PayPal Bank 3,--,$48.51,"$33,035.83"
Donations directed by individuals,11/17/2023,Deposit,7VR32295WD960731K,09 MSU RESTR,donation-form,Contributed income:Donations directed by individuals,PayPal Bank 3,$50.00,"$33,085.83"
PayPal Fees,11/17/2023,Deposit,7VR32295WD960731K,09 MSU RESTR,PayPal fees,OFFICE/GENERAL ADMINISTRATIVE EXPENSES:PayPal Fees,PayPal Bank 3,$1.49,"$33,087.32"
PayPal Bank 3,11/17/2023,Deposit,9LT38414GY201121K,04 PAYPAL GENERAL UNRESTR,Subject: Support UkraineTransaction ID: 9LT38414GY201121Khttps://www.paypal.com/activity/payment/9LT38414GY201121K,PayPal Bank 3,--,$47.76,"$33,135.08"
Donations directed by individuals,11/17/2023,Deposit,9LT38414GY201121K,04 PAYPAL GENERAL UNRESTR,Money in to PayPal,Contributed income:Donations directed by individuals,PayPal Bank 3,$50.00,"$33,185.08"
PayPal Fees,11/17/2023,Deposit,9LT38414GY201121K,04 PAYPAL GENERAL UNRESTR,PayPal fees,OFFICE/GENERAL ADMINISTRATIVE EXPENSES:PayPal Fees,PayPal Bank 3,$2.24,"$33,187.32"
PayPal Bank 3,11/17/2023,Deposit,4H291932RP475962P,09 MSU RESTR,Subject: New 10 UnitsTransaction ID: 4H291932RP475962Phttps://www.paypal.com/activity/payment/4H291932RP475962P,PayPal Bank 3,--,$9.31,"$33,196.63"
Donations directed by individuals,11/17/2023,Deposit,4H291932RP475962P,09 MSU RESTR,donation-form,Contributed income:Donations directed by individuals,PayPal Bank 3,$10.00,"$33,206.63"
PayPal Fees,11/17/2023,Deposit,4H291932RP475962P,09 MSU RESTR,PayPal fees,OFFICE/GENERAL ADMINISTRATIVE EXPENSES:PayPal Fees,PayPal Bank 3,$0.69,"$33,207.32"
PayPal Bank 3,11/17/2023,Deposit,946590784K897934L,09 MSU RESTR,Subject: New 10 UnitsTransaction ID: 946590784K897934Lhttps://www.paypal.com/activity/payment/946590784K897934L,PayPal Bank 3,--,$675.08,"$33,882.40"
Donations directed by individuals,11/17/2023,Deposit,946590784K897934L,09 MSU RESTR,donation-form,Contributed income:Donations directed by individuals,PayPal Bank 3,$700.00,"$34,582.40"
PayPal Fees,11/17/2023,Deposit,946590784K897934L,09 MSU RESTR,PayPal fees,OFFICE/GENERAL ADMINISTRATIVE EXPENSES:PayPal Fees,PayPal Bank 3,$24.92,"$34,607.32"
PayPal Bank 3,11/16/2023,Deposit,1RP33938FU887203C,04 PAYPAL GENERAL UNRESTR,Subject: GeneralPageTransaction ID: 1RP33938FU887203Chttps://www.paypal.com/activity/payment/1RP33938FU887203C,PayPal Bank 3,--,$19.69,"$34,627.01"
Donations directed by individuals,11/16/2023,Deposit,1RP33938FU887203C,04 PAYPAL GENERAL UNRESTR,Support Ukraine - Support Ukraine,Contributed income:Donations directed by individuals,PayPal Bank 3,$20.91,"$34,647.92"
PayPal Fees,11/16/2023,Deposit,1RP33938FU887203C,04 PAYPAL GENERAL UNRESTR,PayPal fees,OFFICE/GENERAL ADMINISTRATIVE EXPENSES:PayPal Fees,PayPal Bank 3,$1.22,"$34,649.14"
PayPal Bank 3,11/16/2023,Deposit,4NM84474AD8908245,04 PAYPAL GENERAL UNRESTR,Subject: Support UkraineTransaction ID: 4NM84474AD8908245https://www.paypal.com/activity/payment/4NM84474AD8908245,PayPal Bank 3,--,$20.95,"$34,670.09"
Donations directed by individuals,11/16/2023,Deposit,4NM84474AD8908245,04 PAYPAL GENERAL UNRESTR,Money in to PayPal,Contributed income:Donations directed by individuals,PayPal Bank 3,$22.22,"$34,692.31"
PayPal Fees,11/16/2023,Deposit,4NM84474AD8908245,04 PAYPAL GENERAL UNRESTR,PayPal fees,OFFICE/GENERAL ADMINISTRATIVE EXPENSES:PayPal Fees,PayPal Bank 3,$1.27,"$34,693.58"
PayPal Bank 3,11/16/2023,Deposit,6U502206B3752410U,04 PAYPAL GENERAL UNRESTR,Subject: Support UkraineTransaction ID: 6U502206B3752410Uhttps://www.paypal.com/activity/payment/6U502206B3752410U,PayPal Bank 3,--,$96.02,"$34,789.60"
Donations directed by individuals,11/16/2023,Deposit,6U502206B3752410U,04 PAYPAL GENERAL UNRESTR,Money in to PayPal,Contributed income:Donations directed by individuals,PayPal Bank 3,$100.00,"$34,889.60"
PayPal Fees,11/16/2023,Deposit,6U502206B3752410U,04 PAYPAL GENERAL UNRESTR,PayPal fees,OFFICE/GENERAL ADMINISTRATIVE EXPENSES:PayPal Fees,PayPal Bank 3,$3.98,"$34,893.58"
PayPal Bank 3,11/16/2023,Deposit,8N631128NU283800D,04 PAYPAL GENERAL UNRESTR,Subject: Support UkraineTransaction ID: 8N631128NU283800Dhttps://www.paypal.com/activity/payment/8N631128NU283800D,PayPal Bank 3,--,$99.38,"$34,992.96"
Donations directed by individuals,11/16/2023,Deposit,8N631128NU283800D,04 PAYPAL GENERAL UNRESTR,Money in to PayPal,Contributed income:Donations directed by individuals,PayPal Bank 3,$103.48,"$35,096.44"
PayPal Fees,11/16/2023,Deposit,8N631128NU283800D,04 PAYPAL GENERAL UNRESTR,PayPal fees,OFFICE/GENERAL ADMINISTRATIVE EXPENSES:PayPal Fees,PayPal Bank 3,$4.10,"$35,100.54"
PayPal Bank 3,11/15/2023,Deposit,5DU69793R9774634B,04 PAYPAL GENERAL UNRESTR,Subject: GeneralPageTransaction ID: 5DU69793R9774634Bhttps://www.paypal.com/activity/payment/5DU69793R9774634B,PayPal Bank 3,--,$29.53,"$35,130.07"
Donations directed by individuals,11/15/2023,Deposit,5DU69793R9774634B,04 PAYPAL GENERAL UNRESTR,Support Ukraine - Support Ukraine,Contributed income:Donations directed by individuals,PayPal Bank 3,$31.11,"$35,161.18"
PayPal Fees,11/15/2023,Deposit,5DU69793R9774634B,04 PAYPAL GENERAL UNRESTR,PayPal fees,OFFICE/GENERAL ADMINISTRATIVE EXPENSES:PayPal Fees,PayPal Bank 3,$1.58,"$35,162.76"
PayPal Bank 3,11/15/2023,Deposit,63F41457RF437581V,04 PAYPAL GENERAL UNRESTR,Subject: GeneralPageNote: Підтримую Марію БерлінськуTransaction ID: 63F41457RF437581Vhttps://www.paypal.com/activity/payment/63F41457RF437581V,PayPal Bank 3,--,$344.64,"$35,507.40"
Donations directed by individuals,11/15/2023,Deposit,63F41457RF437581V,04 PAYPAL GENERAL UNRESTR,Support Ukraine - Support Ukraine,Contributed income:Donations directed by individuals,PayPal Bank 3,$357.61,"$35,865.01"
PayPal Fees,11/15/2023,Deposit,63F41457RF437581V,04 PAYPAL GENERAL UNRESTR,PayPal fees,OFFICE/GENERAL ADMINISTRATIVE EXPENSES:PayPal Fees,PayPal Bank 3,$12.97,"$35,877.98"
PayPal Bank 3,11/14/2023,Deposit,2KV57684GJ548525A,07 1000 DRONES RESTR,Subject: 1000DRONESTransaction ID: 2KV57684GJ548525Ahttps://www.paypal.com/activity/payment/2KV57684GJ548525A,PayPal Bank 3,--,$9.84,"$35,887.82"
Donations directed by individuals,11/14/2023,Deposit,2KV57684GJ548525A,07 1000 DRONES RESTR,1000 DRONES FOR UKRAINE - 1000 DRONES FOR UKRAINE,Contributed income:Donations directed by individuals,PayPal Bank 3,$10.70,"$35,898.52"
PayPal Fees,11/14/2023,Deposit,2KV57684GJ548525A,07 1000 DRONES RESTR,PayPal fees,OFFICE/GENERAL ADMINISTRATIVE EXPENSES:PayPal Fees,PayPal Bank 3,$0.86,"$35,899.38"
PayPal Bank 3,11/14/2023,Deposit,15439952BG7656434,04 PAYPAL GENERAL UNRESTR,Subject: GeneralPageTransaction ID: 15439952BG7656434https://www.paypal.com/activity/payment/15439952BG7656434,PayPal Bank 3,--,$9.84,"$35,909.22"
Donations directed by individuals,11/14/2023,Deposit,15439952BG7656434,04 PAYPAL GENERAL UNRESTR,Support Ukraine - Support Ukraine,Contributed income:Donations directed by individuals,PayPal Bank 3,$10.70,"$35,919.92"
PayPal Fees,11/14/2023,Deposit,15439952BG7656434,04 PAYPAL GENERAL UNRESTR,PayPal fees,OFFICE/GENERAL ADMINISTRATIVE EXPENSES:PayPal Fees,PayPal Bank 3,$0.86,"$35,920.78"
CHASE ENDING IN 5315,11/13/2023,Expense,--,QuickBooks Payments,ORIG CO NAME:INTUIT * ORIG ID:0000756346 DESC DATE:231113 CO ENTRY DESCR:QBooks OnlSEC:CCD TRACE#:021000028042721 EED:231113 IND ID:1049765 IND NAME:DIGNITAS UK RAINE INC XXX-XXX-8848 TRN: XXXXXX2721 TC,CHASE ENDING IN 5315,Software & apps,-$85.00,"$35,835.78"
Software & apps,11/13/2023,Expense,--,QuickBooks Payments,ORIG CO NAME:INTUIT * ORIG ID:0000756346 DESC DATE:231113 CO ENTRY DESCR:QBooks OnlSEC:CCD TRACE#:021000028042721 EED:231113 IND ID:1049765 IND NAME:DIGNITAS UK RAINE INC XXX-XXX-8848 TRN: XXXXXX2721 TC,OFFICE/GENERAL ADMINISTRATIVE EXPENSES:Software & apps,CHASE ENDING IN 5315,$85.00,"$35,920.78"
PayPal Bank 3,11/13/2023,Deposit,78869021TW708474E,10 Flight to Recovery RESTR,Subject: FlightToRecoveryNote: IsaacTransaction ID: 78869021TW708474Ehttps://www.paypal.com/activity/payment/78869021TW708474E,PayPal Bank 3,--,$50.00,"$35,970.78"
Donations directed by individuals,11/13/2023,Deposit,78869021TW708474E,10 Flight to Recovery RESTR,Flight to Recovery - Flight to Recovery,Contributed income:Donations directed by individuals,PayPal Bank 3,$51.52,"$36,022.30"
PayPal Fees,11/13/2023,Deposit,78869021TW708474E,10 Flight to Recovery RESTR,PayPal fees,OFFICE/GENERAL ADMINISTRATIVE EXPENSES:PayPal Fees,PayPal Bank 3,$1.52,"$36,023.82"
PayPal Bank 3,11/13/2023,Deposit,0RS08551F78623230,04 PAYPAL GENERAL UNRESTR,Subject: GeneralPageTransaction ID: 0RS08551F78623230https://www.paypal.com/activity/payment/0RS08551F78623230,PayPal Bank 3,--,$29.53,"$36,053.35"
Donations directed by individuals,11/13/2023,Deposit,0RS08551F78623230,04 PAYPAL GENERAL UNRESTR,Support Ukraine - Support Ukraine,Contributed income:Donations directed by individuals,PayPal Bank 3,$31.11,"$36,084.46"
PayPal Fees,11/13/2023,Deposit,0RS08551F78623230,04 PAYPAL GENERAL UNRESTR,PayPal fees,OFFICE/GENERAL ADMINISTRATIVE EXPENSES:PayPal Fees,PayPal Bank 3,$1.58,"$36,086.04"
PayPal Bank 3,11/13/2023,Deposit,36V58161VY376170A,04 PAYPAL GENERAL UNRESTR,Subject: Support UkraineTransaction ID: 36V58161VY376170Ahttps://www.paypal.com/activity/payment/36V58161VY376170A,PayPal Bank 3,--,$47.76,"$36,133.80"
Donations directed by individuals,11/13/2023,Deposit,36V58161VY376170A,04 PAYPAL GENERAL UNRESTR,Money in to PayPal,Contributed income:Donations directed by individuals,PayPal Bank 3,$50.00,"$36,183.80"
PayPal Fees,11/13/2023,Deposit,36V58161VY376170A,04 PAYPAL GENERAL UNRESTR,PayPal fees,OFFICE/GENERAL ADMINISTRATIVE EXPENSES:PayPal Fees,PayPal Bank 3,$2.24,"$36,186.04"
PayPal Bank 3,11/13/2023,Deposit,56T20513P1956125C,04 PAYPAL GENERAL UNRESTR,Subject: GeneralPageTransaction ID: 56T20513P1956125Chttps://www.paypal.com/activity/payment/56T20513P1956125C,PayPal Bank 3,--,"$1,969.39","$38,155.43"
Donations directed by individuals,11/13/2023,Deposit,56T20513P1956125C,04 PAYPAL GENERAL UNRESTR,Support Ukraine - Support Ukraine,Contributed income:Donations directed by individuals,PayPal Bank 3,"$2,041.11","$40,196.54"
PayPal Fees,11/13/2023,Deposit,56T20513P1956125C,04 PAYPAL GENERAL UNRESTR,PayPal fees,OFFICE/GENERAL ADMINISTRATIVE EXPENSES:PayPal Fees,PayPal Bank 3,$71.72,"$40,268.26"
PayPal Bank 3,11/13/2023,Deposit,7B755064TX917653F,04 PAYPAL GENERAL UNRESTR,Subject: Support UkraineTransaction ID: 7B755064TX917653Fhttps://www.paypal.com/activity/payment/7B755064TX917653F,PayPal Bank 3,--,$25.24,"$40,293.50"
Donations directed by individuals,11/13/2023,Deposit,7B755064TX917653F,04 PAYPAL GENERAL UNRESTR,Money in to PayPal,Contributed income:Donations directed by individuals,PayPal Bank 3,$26.25,"$40,319.75"
PayPal Fees,11/13/2023,Deposit,7B755064TX917653F,04 PAYPAL GENERAL UNRESTR,PayPal fees,OFFICE/GENERAL ADMINISTRATIVE EXPENSES:PayPal Fees,PayPal Bank 3,$1.01,"$40,320.76"
PayPal Bank 3,11/13/2023,Deposit,8X736057NS3616720,04 PAYPAL GENERAL UNRESTR,Subject: GeneralPageTransaction ID: 8X736057NS3616720https://www.paypal.com/activity/payment/8X736057NS3616720,PayPal Bank 3,--,$100.00,"$40,420.76"
Donations directed by individuals,11/13/2023,Deposit,8X736057NS3616720,04 PAYPAL GENERAL UNRESTR,Support Ukraine - Support Ukraine,Contributed income:Donations directed by individuals,PayPal Bank 3,$102.53,"$40,523.29"
PayPal Fees,11/13/2023,Deposit,8X736057NS3616720,04 PAYPAL GENERAL UNRESTR,PayPal fees,OFFICE/GENERAL ADMINISTRATIVE EXPENSES:PayPal Fees,PayPal Bank 3,$2.53,"$40,525.82"
PayPal Bank 3,11/13/2023,Deposit,654961033L200014S,09 MSU RESTR,Subject: GeneralPageTransaction ID: 654961033L200014Shttps://www.paypal.com/activity/payment/654961033L200014S,PayPal Bank 3,--,$500.00,"$41,025.82"
Donations directed by individuals,11/13/2023,Deposit,654961033L200014S,09 MSU RESTR,Support Ukraine - Support Ukraine,Contributed income:Donations directed by individuals,PayPal Bank 3,$510.65,"$41,536.47"
PayPal Fees,11/13/2023,Deposit,654961033L200014S,09 MSU RESTR,PayPal fees,OFFICE/GENERAL ADMINISTRATIVE EXPENSES:PayPal Fees,PayPal Bank 3,$10.65,"$41,547.12"
PayPal Bank 3,11/12/2023,Deposit,1D374671VH947992T,04 PAYPAL GENERAL UNRESTR,Subject: Support UkraineTransaction ID: 1D374671VH947992Thttps://www.paypal.com/activity/payment/1D374671VH947992T,PayPal Bank 3,--,$50.47,"$41,597.59"
Donations directed by individuals,11/12/2023,Deposit,1D374671VH947992T,04 PAYPAL GENERAL UNRESTR,Money in to PayPal,Contributed income:Donations directed by individuals,PayPal Bank 3,$51.99,"$41,649.58"
PayPal Fees,11/12/2023,Deposit,1D374671VH947992T,04 PAYPAL GENERAL UNRESTR,PayPal fees,OFFICE/GENERAL ADMINISTRATIVE EXPENSES:PayPal Fees,PayPal Bank 3,$1.52,"$41,651.10"
PayPal Bank 3,11/12/2023,Deposit,87R761628E259863L,04 PAYPAL GENERAL UNRESTR,Subject: GeneralPageNote: This is in memory of Alan GrodinTransaction ID: 87R761628E259863Lhttps://www.paypal.com/activity/payment/87R761628E259863L,PayPal Bank 3,--,$34.79,"$41,685.89"
Donations directed by individuals,11/12/2023,Deposit,87R761628E259863L,04 PAYPAL GENERAL UNRESTR,Support Ukraine - Support Ukraine,Contributed income:Donations directed by individuals,PayPal Bank 3,$36.00,"$41,721.89"
PayPal Fees,11/12/2023,Deposit,87R761628E259863L,04 PAYPAL GENERAL UNRESTR,PayPal fees,OFFICE/GENERAL ADMINISTRATIVE EXPENSES:PayPal Fees,PayPal Bank 3,$1.21,"$41,723.10"
PayPal Bank 3,11/11/2023,Deposit,5U7226499J3975933,09 MSU RESTR,Subject: New 10 UnitsTransaction ID: 5U7226499J3975933https://www.paypal.com/activity/payment/5U7226499J3975933,PayPal Bank 3,--,$385.55,"$42,108.65"
Donations directed by individuals,11/11/2023,Deposit,5U7226499J3975933,09 MSU RESTR,donation-form,Contributed income:Donations directed by individuals,PayPal Bank 3,$400.00,"$42,508.65"
PayPal Fees,11/11/2023,Deposit,5U7226499J3975933,09 MSU RESTR,PayPal fees,OFFICE/GENERAL ADMINISTRATIVE EXPENSES:PayPal Fees,PayPal Bank 3,$14.45,"$42,523.10"
PayPal Bank 3,11/11/2023,Deposit,51A94533F78069624,07 1000 DRONES RESTR,Subject: 1000DRONESTransaction ID: 51A94533F78069624https://www.paypal.com/activity/payment/51A94533F78069624,PayPal Bank 3,--,$97.52,"$42,620.62"
Donations directed by individuals,11/11/2023,Deposit,51A94533F78069624,07 1000 DRONES RESTR,1000 DRONES FOR UKRAINE - 1000 DRONES FOR UKRAINE,Contributed income:Donations directed by individuals,PayPal Bank 3,$100.00,"$42,720.62"
PayPal Fees,11/11/2023,Deposit,51A94533F78069624,07 1000 DRONES RESTR,PayPal fees,OFFICE/GENERAL ADMINISTRATIVE EXPENSES:PayPal Fees,PayPal Bank 3,$2.48,"$42,723.10"
PayPal Bank 3,11/11/2023,Deposit,1N655123MG198440Y,04 PAYPAL GENERAL UNRESTR,Subject: Support UkraineTransaction ID: 1N655123MG198440Yhttps://www.paypal.com/activity/payment/1N655123MG198440Y,PayPal Bank 3,--,$47.76,"$42,770.86"
Donations directed by individuals,11/11/2023,Deposit,1N655123MG198440Y,04 PAYPAL GENERAL UNRESTR,Money in to PayPal,Contributed income:Donations directed by individuals,PayPal Bank 3,$50.00,"$42,820.86"
PayPal Fees,11/11/2023,Deposit,1N655123MG198440Y,04 PAYPAL GENERAL UNRESTR,PayPal fees,OFFICE/GENERAL ADMINISTRATIVE EXPENSES:PayPal Fees,PayPal Bank 3,$2.24,"$42,823.10"
PayPal Bank 3,11/11/2023,Deposit,0U6546026X424724E,04 PAYPAL GENERAL UNRESTR,Subject: Support UkraineTransaction ID: 0U6546026X424724Ehttps://www.paypal.com/activity/payment/0U6546026X424724E,PayPal Bank 3,--,$4.96,"$42,828.06"
Donations directed by individuals,11/11/2023,Deposit,0U6546026X424724E,04 PAYPAL GENERAL UNRESTR,Money in to PayPal,Contributed income:Donations directed by individuals,PayPal Bank 3,$5.65,"$42,833.71"
PayPal Fees,11/11/2023,Deposit,0U6546026X424724E,04 PAYPAL GENERAL UNRESTR,PayPal fees,OFFICE/GENERAL ADMINISTRATIVE EXPENSES:PayPal Fees,PayPal Bank 3,$0.69,"$42,834.40"
PayPal Bank 3,11/11/2023,Deposit,9JU36938CB3463615,04 PAYPAL GENERAL UNRESTR,Subject: Support UkraineTransaction ID: 9JU36938CB3463615https://www.paypal.com/activity/payment/9JU36938CB3463615,PayPal Bank 3,--,$23.64,"$42,858.04"
Donations directed by individuals,11/11/2023,Deposit,9JU36938CB3463615,04 PAYPAL GENERAL UNRESTR,Money in to PayPal,Contributed income:Donations directed by individuals,PayPal Bank 3,$25.00,"$42,883.04"
PayPal Fees,11/11/2023,Deposit,9JU36938CB3463615,04 PAYPAL GENERAL UNRESTR,PayPal fees,OFFICE/GENERAL ADMINISTRATIVE EXPENSES:PayPal Fees,PayPal Bank 3,$1.36,"$42,884.40"
PayPal Bank 3,11/11/2023,Deposit,2MH54477VK815370R,04 PAYPAL GENERAL UNRESTR,Subject: Support UkraineTransaction ID: 2MH54477VK815370Rhttps://www.paypal.com/activity/payment/2MH54477VK815370R,PayPal Bank 3,--,$100.93,"$42,985.33"
Donations directed by individuals,11/11/2023,Deposit,2MH54477VK815370R,04 PAYPAL GENERAL UNRESTR,Money in to PayPal,Contributed income:Donations directed by individuals,PayPal Bank 3,$103.48,"$43,088.81"
PayPal Fees,11/11/2023,Deposit,2MH54477VK815370R,04 PAYPAL GENERAL UNRESTR,PayPal fees,OFFICE/GENERAL ADMINISTRATIVE EXPENSES:PayPal Fees,PayPal Bank 3,$2.55,"$43,091.36"
PayPal Bank 3,11/11/2023,Deposit,3WJ048240K5550949,04 PAYPAL GENERAL UNRESTR,Subject: Support UkraineTransaction ID: 3WJ048240K5550949https://www.paypal.com/activity/payment/3WJ048240K5550949,PayPal Bank 3,--,$18.81,"$43,110.17"
Donations directed by individuals,11/11/2023,Deposit,3WJ048240K5550949,04 PAYPAL GENERAL UNRESTR,Money in to PayPal,Contributed income:Donations directed by individuals,PayPal Bank 3,$20.00,"$43,130.17"
PayPal Fees,11/11/2023,Deposit,3WJ048240K5550949,04 PAYPAL GENERAL UNRESTR,PayPal fees,OFFICE/GENERAL ADMINISTRATIVE EXPENSES:PayPal Fees,PayPal Bank 3,$1.19,"$43,131.36"
PayPal Bank 3,11/10/2023,Deposit,4M375196YS401223R,04 PAYPAL GENERAL UNRESTR,Subject: GeneralPageTransaction ID: 4M375196YS401223Rhttps://www.paypal.com/activity/payment/4M375196YS401223R,PayPal Bank 3,--,$100.00,"$43,231.36"
Donations directed by individuals,11/10/2023,Deposit,4M375196YS401223R,04 PAYPAL GENERAL UNRESTR,Support Ukraine - Support Ukraine,Contributed income:Donations directed by individuals,PayPal Bank 3,$102.53,"$43,333.89"
PayPal Fees,11/10/2023,Deposit,4M375196YS401223R,04 PAYPAL GENERAL UNRESTR,PayPal fees,OFFICE/GENERAL ADMINISTRATIVE EXPENSES:PayPal Fees,PayPal Bank 3,$2.53,"$43,336.42"
PayPal Bank 3,11/10/2023,Deposit,265038198F498983U,09 MSU RESTR,Subject: New 10 UnitsTransaction ID: 265038198F498983Uhttps://www.paypal.com/activity/payment/265038198F498983U,PayPal Bank 3,--,$96.02,"$43,432.44"
Donations directed by individuals,11/10/2023,Deposit,265038198F498983U,09 MSU RESTR,donation-form,Contributed income:Donations directed by individuals,PayPal Bank 3,$100.00,"$43,532.44"
PayPal Fees,11/10/2023,Deposit,265038198F498983U,09 MSU RESTR,PayPal fees,OFFICE/GENERAL ADMINISTRATIVE EXPENSES:PayPal Fees,PayPal Bank 3,$3.98,"$43,536.42"
PayPal Bank 3,11/10/2023,Deposit,39V47375DL031561N,04 PAYPAL GENERAL UNRESTR,Subject: GeneralPageTransaction ID: 39V47375DL031561Nhttps://www.paypal.com/activity/payment/39V47375DL031561N,PayPal Bank 3,--,$49.23,"$43,585.65"
Donations directed by individuals,11/10/2023,Deposit,39V47375DL031561N,04 PAYPAL GENERAL UNRESTR,Support Ukraine - Support Ukraine,Contributed income:Donations directed by individuals,PayPal Bank 3,$51.52,"$43,637.17"
PayPal Fees,11/10/2023,Deposit,39V47375DL031561N,04 PAYPAL GENERAL UNRESTR,PayPal fees,OFFICE/GENERAL ADMINISTRATIVE EXPENSES:PayPal Fees,PayPal Bank 3,$2.29,"$43,639.46"
PayPal Bank 3,11/10/2023,Deposit,4UC672896T226773P,09 MSU RESTR,Subject: New 10 UnitsTransaction ID: 4UC672896T226773Phttps://www.paypal.com/activity/payment/4UC672896T226773P,PayPal Bank 3,--,$9.16,"$43,648.62"
Donations directed by individuals,11/10/2023,Deposit,4UC672896T226773P,09 MSU RESTR,donation-form,Contributed income:Donations directed by individuals,PayPal Bank 3,$10.00,"$43,658.62"
PayPal Fees,11/10/2023,Deposit,4UC672896T226773P,09 MSU RESTR,PayPal fees,OFFICE/GENERAL ADMINISTRATIVE EXPENSES:PayPal Fees,PayPal Bank 3,$0.84,"$43,659.46"
PayPal Bank 3,11/10/2023,Deposit,9UV35178ER036441J,04 PAYPAL GENERAL UNRESTR,Subject: GeneralPageNote: Donation for Saving UkraineTransaction ID: 9UV35178ER036441Jhttps://www.paypal.com/activity/payment/9UV35178ER036441J,PayPal Bank 3,--,$100.00,"$43,759.46"
Donations directed by individuals,11/10/2023,Deposit,9UV35178ER036441J,04 PAYPAL GENERAL UNRESTR,Support Ukraine - Support Ukraine,Contributed income:Donations directed by individuals,PayPal Bank 3,$102.53,"$43,861.99"
PayPal Fees,11/10/2023,Deposit,9UV35178ER036441J,04 PAYPAL GENERAL UNRESTR,PayPal fees,OFFICE/GENERAL ADMINISTRATIVE EXPENSES:PayPal Fees,PayPal Bank 3,$2.53,"$43,864.52"
PayPal Bank 3,11/10/2023,Deposit,1H080363RR630732D,04 PAYPAL GENERAL UNRESTR,Subject: Support UkraineTransaction ID: 1H080363RR630732Dhttps://www.paypal.com/activity/payment/1H080363RR630732D,PayPal Bank 3,--,$29.81,"$43,894.33"
Donations directed by individuals,11/10/2023,Deposit,1H080363RR630732D,04 PAYPAL GENERAL UNRESTR,Money in to PayPal,Contributed income:Donations directed by individuals,PayPal Bank 3,$31.40,"$43,925.73"
PayPal Fees,11/10/2023,Deposit,1H080363RR630732D,04 PAYPAL GENERAL UNRESTR,PayPal fees,OFFICE/GENERAL ADMINISTRATIVE EXPENSES:PayPal Fees,PayPal Bank 3,$1.59,"$43,927.32"
PayPal Bank 3,11/10/2023,Deposit,8DU565541T2160140,09 MSU RESTR,Subject: New 10 UnitsTransaction ID: 8DU565541T2160140https://www.paypal.com/activity/payment/8DU565541T2160140,PayPal Bank 3,--,$244.53,"$44,171.85"
Donations directed by individuals,11/10/2023,Deposit,8DU565541T2160140,09 MSU RESTR,donation-form,Contributed income:Donations directed by individuals,PayPal Bank 3,$250.00,"$44,421.85"
PayPal Fees,11/10/2023,Deposit,8DU565541T2160140,09 MSU RESTR,PayPal fees,OFFICE/GENERAL ADMINISTRATIVE EXPENSES:PayPal Fees,PayPal Bank 3,$5.47,"$44,427.32"
PayPal Bank 3,11/10/2023,Deposit,97C07921F3708191D,04 PAYPAL GENERAL UNRESTR,Subject: GeneralPageTransaction ID: 97C07921F3708191Dhttps://www.paypal.com/activity/payment/97C07921F3708191D,PayPal Bank 3,--,$49.23,"$44,476.55"
Donations directed by individuals,11/10/2023,Deposit,97C07921F3708191D,04 PAYPAL GENERAL UNRESTR,Support Ukraine - Support Ukraine,Contributed income:Donations directed by individuals,PayPal Bank 3,$51.52,"$44,528.07"
PayPal Fees,11/10/2023,Deposit,97C07921F3708191D,04 PAYPAL GENERAL UNRESTR,PayPal fees,OFFICE/GENERAL ADMINISTRATIVE EXPENSES:PayPal Fees,PayPal Bank 3,$2.29,"$44,530.36"
PayPal Bank 3,11/09/2023,Deposit,6AC425960S3157333,07 1000 DRONES RESTR,Subject: 1000DRONESTransaction ID: 6AC425960S3157333https://www.paypal.com/activity/payment/6AC425960S3157333,PayPal Bank 3,--,$196.93,"$44,727.29"
Donations directed by individuals,11/09/2023,Deposit,6AC425960S3157333,07 1000 DRONES RESTR,1000 DRONES FOR UKRAINE - 1000 DRONES FOR UKRAINE,Contributed income:Donations directed by individuals,PayPal Bank 3,$204.56,"$44,931.85"
PayPal Fees,11/09/2023,Deposit,6AC425960S3157333,07 1000 DRONES RESTR,PayPal fees,OFFICE/GENERAL ADMINISTRATIVE EXPENSES:PayPal Fees,PayPal Bank 3,$7.63,"$44,939.48"
PayPal Bank 3,11/09/2023,Deposit,88J63350RK9817538,04 PAYPAL GENERAL UNRESTR,Subject: GeneralPageTransaction ID: 88J63350RK9817538https://www.paypal.com/activity/payment/88J63350RK9817538,PayPal Bank 3,--,$50.00,"$44,989.48"
Donations directed by individuals,11/09/2023,Deposit,88J63350RK9817538,04 PAYPAL GENERAL UNRESTR,Support Ukraine - Support Ukraine,Contributed income:Donations directed by individuals,PayPal Bank 3,$51.52,"$45,041.00"
PayPal Fees,11/09/2023,Deposit,88J63350RK9817538,04 PAYPAL GENERAL UNRESTR,PayPal fees,OFFICE/GENERAL ADMINISTRATIVE EXPENSES:PayPal Fees,PayPal Bank 3,$1.52,"$45,042.52"
PayPal Bank 3,11/08/2023,Deposit,3BM45253DS8382105,04 PAYPAL GENERAL UNRESTR,Subject: GeneralPageTransaction ID: 3BM45253DS8382105https://www.paypal.com/activity/payment/3BM45253DS8382105,PayPal Bank 3,--,$492.34,"$45,534.86"
Donations directed by individuals,11/08/2023,Deposit,3BM45253DS8382105,04 PAYPAL GENERAL UNRESTR,Support Ukraine - Support Ukraine,Contributed income:Donations directed by individuals,PayPal Bank 3,$510.65,"$46,045.51"
PayPal Fees,11/08/2023,Deposit,3BM45253DS8382105,04 PAYPAL GENERAL UNRESTR,PayPal fees,OFFICE/GENERAL ADMINISTRATIVE EXPENSES:PayPal Fees,PayPal Bank 3,$18.31,"$46,063.82"
PayPal Bank 3,11/08/2023,Deposit,8ND56931PM159324A,04 PAYPAL GENERAL UNRESTR,Subject: GeneralPageTransaction ID: 8ND56931PM159324Ahttps://www.paypal.com/activity/payment/8ND56931PM159324A,PayPal Bank 3,--,$4.34,"$46,068.16"
Donations directed by individuals,11/08/2023,Deposit,8ND56931PM159324A,04 PAYPAL GENERAL UNRESTR,Support Ukraine - Support Ukraine,Contributed income:Donations directed by individuals,PayPal Bank 3,$5.00,"$46,073.16"
PayPal Fees,11/08/2023,Deposit,8ND56931PM159324A,04 PAYPAL GENERAL UNRESTR,PayPal fees,OFFICE/GENERAL ADMINISTRATIVE EXPENSES:PayPal Fees,PayPal Bank 3,$0.66,"$46,073.82"
PayPal Bank 3,11/08/2023,Deposit,4NU25664KM384682N,09 MSU RESTR,Subject: New 10 UnitsTransaction ID: 4NU25664KM384682Nhttps://www.paypal.com/activity/payment/4NU25664KM384682N,PayPal Bank 3,--,$24.01,"$46,097.83"
Donations directed by individuals,11/08/2023,Deposit,4NU25664KM384682N,09 MSU RESTR,donation-form,Contributed income:Donations directed by individuals,PayPal Bank 3,$25.00,"$46,122.83"
PayPal Fees,11/08/2023,Deposit,4NU25664KM384682N,09 MSU RESTR,PayPal fees,OFFICE/GENERAL ADMINISTRATIVE EXPENSES:PayPal Fees,PayPal Bank 3,$0.99,"$46,123.82"
PayPal Bank 3,11/08/2023,Deposit,2E109844K8437032H,04 PAYPAL GENERAL UNRESTR,Subject: GeneralPageTransaction ID: 2E109844K8437032Hhttps://www.paypal.com/activity/payment/2E109844K8437032H,PayPal Bank 3,--,$587.57,"$46,711.39"
Donations directed by individuals,11/08/2023,Deposit,2E109844K8437032H,04 PAYPAL GENERAL UNRESTR,Support Ukraine - Support Ukraine,Contributed income:Donations directed by individuals,PayPal Bank 3,$600.00,"$47,311.39"
PayPal Fees,11/08/2023,Deposit,2E109844K8437032H,04 PAYPAL GENERAL UNRESTR,PayPal fees,OFFICE/GENERAL ADMINISTRATIVE EXPENSES:PayPal Fees,PayPal Bank 3,$12.43,"$47,323.82"
PayPal Bank 3,11/08/2023,Deposit,6D152917S27452359,09 MSU RESTR,Subject: New 10 UnitsTransaction ID: 6D152917S27452359https://www.paypal.com/activity/payment/6D152917S27452359,PayPal Bank 3,--,$24.01,"$47,347.83"
Donations directed by individuals,11/08/2023,Deposit,6D152917S27452359,09 MSU RESTR,donation-form,Contributed income:Donations directed by individuals,PayPal Bank 3,$25.00,"$47,372.83"
PayPal Fees,11/08/2023,Deposit,6D152917S27452359,09 MSU RESTR,PayPal fees,OFFICE/GENERAL ADMINISTRATIVE EXPENSES:PayPal Fees,PayPal Bank 3,$0.99,"$47,373.82"
PayPal Bank 3,11/07/2023,Deposit,7D7638180F816601D,04 PAYPAL GENERAL UNRESTR,Subject: Support UkraineTransaction ID: 7D7638180F816601Dhttps://www.paypal.com/activity/payment/7D7638180F816601D,PayPal Bank 3,--,$50.00,"$47,423.82"
Donations directed by individuals,11/07/2023,Deposit,7D7638180F816601D,04 PAYPAL GENERAL UNRESTR,Money in to PayPal,Contributed income:Donations directed by individuals,PayPal Bank 3,$51.52,"$47,475.34"
PayPal Fees,11/07/2023,Deposit,7D7638180F816601D,04 PAYPAL GENERAL UNRESTR,PayPal fees,OFFICE/GENERAL ADMINISTRATIVE EXPENSES:PayPal Fees,PayPal Bank 3,$1.52,"$47,476.86"
PayPal Bank 3,11/07/2023,Deposit,9X597589P7464142X,04 PAYPAL GENERAL UNRESTR,Subject: GeneralPageTransaction ID: 9X597589P7464142Xhttps://www.paypal.com/activity/payment/9X597589P7464142X,PayPal Bank 3,--,$14.76,"$47,491.62"
Donations directed by individuals,11/07/2023,Deposit,9X597589P7464142X,04 PAYPAL GENERAL UNRESTR,Support Ukraine - Support Ukraine,Contributed income:Donations directed by individuals,PayPal Bank 3,$15.80,"$47,507.42"
PayPal Fees,11/07/2023,Deposit,9X597589P7464142X,04 PAYPAL GENERAL UNRESTR,PayPal fees,OFFICE/GENERAL ADMINISTRATIVE EXPENSES:PayPal Fees,PayPal Bank 3,$1.04,"$47,508.46"
PayPal Bank 3,11/07/2023,Deposit,6NA26645VV291590K,04 PAYPAL GENERAL UNRESTR,Subject: GeneralPageTransaction ID: 6NA26645VV291590Khttps://www.paypal.com/activity/payment/6NA26645VV291590K,PayPal Bank 3,--,$29.53,"$47,537.99"
Donations directed by individuals,11/07/2023,Deposit,6NA26645VV291590K,04 PAYPAL GENERAL UNRESTR,Support Ukraine - Support Ukraine,Contributed income:Donations directed by individuals,PayPal Bank 3,$31.11,"$47,569.10"
PayPal Fees,11/07/2023,Deposit,6NA26645VV291590K,04 PAYPAL GENERAL UNRESTR,PayPal fees,OFFICE/GENERAL ADMINISTRATIVE EXPENSES:PayPal Fees,PayPal Bank 3,$1.58,"$47,570.68"
PayPal Bank 3,11/06/2023,Deposit,82566927NW225203G,--,Subject: GeneralPageTransaction ID: 82566927NW225203Ghttps://www.paypal.com/activity/payment/82566927NW225203G,PayPal Bank 3,--,$50.00,"$47,620.68"
Donations directed by individuals,11/06/2023,Deposit,82566927NW225203G,--,Support Ukraine - Support Ukraine,Contributed income:Donations directed by individuals,PayPal Bank 3,$51.52,"$47,672.20"
PayPal Fees,11/06/2023,Deposit,82566927NW225203G,--,PayPal fees,OFFICE/GENERAL ADMINISTRATIVE EXPENSES:PayPal Fees,PayPal Bank 3,$1.52,"$47,673.72"
PayPal Bank 3,11/06/2023,Deposit,4S825731PT536113T,04 PAYPAL GENERAL UNRESTR,Transaction ID: 4S825731PT536113Thttps://www.paypal.com/activity/payment/4S825731PT536113T,PayPal Bank 3,Donations directed by individuals,$30.57,"$47,704.29"
Donations directed by individuals,11/06/2023,Deposit,4S825731PT536113T,04 PAYPAL GENERAL UNRESTR,Money in to PayPal,Contributed income:Donations directed by individuals,PayPal Bank 3,$30.57,"$47,734.86"
PayPal Bank 3,11/06/2023,Deposit,4CS40352D7239531V,04 PAYPAL GENERAL UNRESTR,Subject: Support UkraineTransaction ID: 4CS40352D7239531Vhttps://www.paypal.com/activity/payment/4CS40352D7239531V,PayPal Bank 3,--,$4.34,"$47,739.20"
Donations directed by individuals,11/06/2023,Deposit,4CS40352D7239531V,04 PAYPAL GENERAL UNRESTR,Money in to PayPal,Contributed income:Donations directed by individuals,PayPal Bank 3,$5.00,"$47,744.20"
PayPal Fees,11/06/2023,Deposit,4CS40352D7239531V,04 PAYPAL GENERAL UNRESTR,PayPal fees,OFFICE/GENERAL ADMINISTRATIVE EXPENSES:PayPal Fees,PayPal Bank 3,$0.66,"$47,744.86"
PayPal Bank 3,11/06/2023,Deposit,7J1330564C9419710,04 PAYPAL GENERAL UNRESTR,Subject: GeneralPageTransaction ID: 7J1330564C9419710https://www.paypal.com/activity/payment/7J1330564C9419710,PayPal Bank 3,--,$96.02,"$47,840.88"
Donations directed by individuals,11/06/2023,Deposit,7J1330564C9419710,04 PAYPAL GENERAL UNRESTR,Support Ukraine - Support Ukraine,Contributed income:Donations directed by individuals,PayPal Bank 3,$100.00,"$47,940.88"
PayPal Fees,11/06/2023,Deposit,7J1330564C9419710,04 PAYPAL GENERAL UNRESTR,PayPal fees,OFFICE/GENERAL ADMINISTRATIVE EXPENSES:PayPal Fees,PayPal Bank 3,$3.98,"$47,944.86"
PayPal Bank 3,11/06/2023,Deposit,0L889328759168148,04 PAYPAL GENERAL UNRESTR,Subject: Support UkraineTransaction ID: 0L889328759168148https://www.paypal.com/activity/payment/0L889328759168148,PayPal Bank 3,--,$69.00,"$48,013.86"
Donations directed by individuals,11/06/2023,Deposit,0L889328759168148,04 PAYPAL GENERAL UNRESTR,Money in to PayPal,Contributed income:Donations directed by individuals,PayPal Bank 3,$72.00,"$48,085.86"
PayPal Fees,11/06/2023,Deposit,0L889328759168148,04 PAYPAL GENERAL UNRESTR,PayPal fees,OFFICE/GENERAL ADMINISTRATIVE EXPENSES:PayPal Fees,PayPal Bank 3,$3.00,"$48,088.86"
PayPal Bank 3,11/05/2023,Deposit,4DF52576C2571600D,04 PAYPAL GENERAL UNRESTR,Subject: GeneralPageTransaction ID: 4DF52576C2571600Dhttps://www.paypal.com/activity/payment/4DF52576C2571600D,PayPal Bank 3,--,$34.79,"$48,123.65"
Donations directed by individuals,11/05/2023,Deposit,4DF52576C2571600D,04 PAYPAL GENERAL UNRESTR,Support Ukraine - Support Ukraine,Contributed income:Donations directed by individuals,PayPal Bank 3,$36.00,"$48,159.65"
PayPal Fees,11/05/2023,Deposit,4DF52576C2571600D,04 PAYPAL GENERAL UNRESTR,PayPal fees,OFFICE/GENERAL ADMINISTRATIVE EXPENSES:PayPal Fees,PayPal Bank 3,$1.21,"$48,160.86"
PayPal Bank 3,11/05/2023,Deposit,9X960290TE256110F,07 1000 DRONES RESTR,Subject: 1000 DRONES FOR UKRAINETransaction ID: 9X960290TE256110Fhttps://www.paypal.com/activity/payment/9X960290TE256110F,PayPal Bank 3,--,$24.84,"$48,185.70"
Donations directed by individuals,11/05/2023,Deposit,9X960290TE256110F,07 1000 DRONES RESTR,Money in to PayPal,Contributed income:Donations directed by individuals,PayPal Bank 3,$26.25,"$48,211.95"
PayPal Fees,11/05/2023,Deposit,9X960290TE256110F,07 1000 DRONES RESTR,PayPal fees,OFFICE/GENERAL ADMINISTRATIVE EXPENSES:PayPal Fees,PayPal Bank 3,$1.41,"$48,213.36"
PayPal Bank 3,11/05/2023,Deposit,5DF10798AN556245H,04 PAYPAL GENERAL UNRESTR,Subject: GeneralPageTransaction ID: 5DF10798AN556245Hhttps://www.paypal.com/activity/payment/5DF10798AN556245H,PayPal Bank 3,--,$49.23,"$48,262.59"
Donations directed by individuals,11/05/2023,Deposit,5DF10798AN556245H,04 PAYPAL GENERAL UNRESTR,Support Ukraine - Support Ukraine,Contributed income:Donations directed by individuals,PayPal Bank 3,$51.52,"$48,314.11"
PayPal Fees,11/05/2023,Deposit,5DF10798AN556245H,04 PAYPAL GENERAL UNRESTR,PayPal fees,OFFICE/GENERAL ADMINISTRATIVE EXPENSES:PayPal Fees,PayPal Bank 3,$2.29,"$48,316.40"
PayPal Bank 3,11/05/2023,Deposit,4YB35206YB127561M,04 PAYPAL GENERAL UNRESTR,Subject: GeneralPageNote: Glory to UkraineTransaction ID: 4YB35206YB127561Mhttps://www.paypal.com/activity/payment/4YB35206YB127561M,PayPal Bank 3,--,$489.56,"$48,805.96"
Donations directed by individuals,11/05/2023,Deposit,4YB35206YB127561M,04 PAYPAL GENERAL UNRESTR,Support Ukraine - Support Ukraine,Contributed income:Donations directed by individuals,PayPal Bank 3,$500.00,"$49,305.96"
PayPal Fees,11/05/2023,Deposit,4YB35206YB127561M,04 PAYPAL GENERAL UNRESTR,PayPal fees,OFFICE/GENERAL ADMINISTRATIVE EXPENSES:PayPal Fees,PayPal Bank 3,$10.44,"$49,316.40"
PayPal Bank 3,11/05/2023,Deposit,1TV21081GK059772S,04 PAYPAL GENERAL UNRESTR,Subject: Support UkraineTransaction ID: 1TV21081GK059772Shttps://www.paypal.com/activity/payment/1TV21081GK059772S,PayPal Bank 3,--,$11.92,"$49,328.32"
Donations directed by individuals,11/05/2023,Deposit,1TV21081GK059772S,04 PAYPAL GENERAL UNRESTR,Money in to PayPal,Contributed income:Donations directed by individuals,PayPal Bank 3,$12.86,"$49,341.18"
PayPal Fees,11/05/2023,Deposit,1TV21081GK059772S,04 PAYPAL GENERAL UNRESTR,PayPal fees,OFFICE/GENERAL ADMINISTRATIVE EXPENSES:PayPal Fees,PayPal Bank 3,$0.94,"$49,342.12"
PayPal Bank 3,11/05/2023,Deposit,3PS78966SG9335847,07 1000 DRONES RESTR,Subject: 1000 DRONES FOR UKRAINETransaction ID: 3PS78966SG9335847https://www.paypal.com/activity/payment/3PS78966SG9335847,PayPal Bank 3,--,$10.93,"$49,353.05"
Donations directed by individuals,11/05/2023,Deposit,3PS78966SG9335847,07 1000 DRONES RESTR,Money in to PayPal,Contributed income:Donations directed by individuals,PayPal Bank 3,$11.83,"$49,364.88"
PayPal Fees,11/05/2023,Deposit,3PS78966SG9335847,07 1000 DRONES RESTR,PayPal fees,OFFICE/GENERAL ADMINISTRATIVE EXPENSES:PayPal Fees,PayPal Bank 3,$0.90,"$49,365.78"
PayPal Bank 3,11/05/2023,Deposit,3KG50446G6980404Y,04 PAYPAL GENERAL UNRESTR,Subject: GeneralPageTransaction ID: 3KG50446G6980404Yhttps://www.paypal.com/activity/payment/3KG50446G6980404Y,PayPal Bank 3,--,$47.76,"$49,413.54"
Donations directed by individuals,11/05/2023,Deposit,3KG50446G6980404Y,04 PAYPAL GENERAL UNRESTR,Support Ukraine - Support Ukraine,Contributed income:Donations directed by individuals,PayPal Bank 3,$50.00,"$49,463.54"
PayPal Fees,11/05/2023,Deposit,3KG50446G6980404Y,04 PAYPAL GENERAL UNRESTR,PayPal fees,OFFICE/GENERAL ADMINISTRATIVE EXPENSES:PayPal Fees,PayPal Bank 3,$2.24,"$49,465.78"
PayPal Bank 3,11/05/2023,Deposit,2FD91573BU3783408,04 PAYPAL GENERAL UNRESTR,Subject: Support UkraineTransaction ID: 2FD91573BU3783408https://www.paypal.com/activity/payment/2FD91573BU3783408,PayPal Bank 3,--,$50.00,"$49,515.78"
Donations directed by individuals,11/05/2023,Deposit,2FD91573BU3783408,04 PAYPAL GENERAL UNRESTR,Money in to PayPal,Contributed income:Donations directed by individuals,PayPal Bank 3,$51.52,"$49,567.30"
PayPal Fees,11/05/2023,Deposit,2FD91573BU3783408,04 PAYPAL GENERAL UNRESTR,PayPal fees,OFFICE/GENERAL ADMINISTRATIVE EXPENSES:PayPal Fees,PayPal Bank 3,$1.52,"$49,568.82"
PayPal Bank 3,11/05/2023,Deposit,2LT016854L959084U,04 PAYPAL GENERAL UNRESTR,Subject: GeneralPageTransaction ID: 2LT016854L959084Uhttps://www.paypal.com/activity/payment/2LT016854L959084U,PayPal Bank 3,--,$300.00,"$49,868.82"
Donations directed by individuals,11/05/2023,Deposit,2LT016854L959084U,04 PAYPAL GENERAL UNRESTR,Support Ukraine - Support Ukraine,Contributed income:Donations directed by individuals,PayPal Bank 3,$306.59,"$50,175.41"
PayPal Fees,11/05/2023,Deposit,2LT016854L959084U,04 PAYPAL GENERAL UNRESTR,PayPal fees,OFFICE/GENERAL ADMINISTRATIVE EXPENSES:PayPal Fees,PayPal Bank 3,$6.59,"$50,182.00"
PayPal Bank 3,11/05/2023,Deposit,6EU44732M2785030E,07 1000 DRONES RESTR,Subject: 1000DRONESTransaction ID: 6EU44732M2785030Ehttps://www.paypal.com/activity/payment/6EU44732M2785030E,PayPal Bank 3,--,$98.46,"$50,280.46"
Donations directed by individuals,11/05/2023,Deposit,6EU44732M2785030E,07 1000 DRONES RESTR,1000 DRONES FOR UKRAINE - 1000 DRONES FOR UKRAINE,Contributed income:Donations directed by individuals,PayPal Bank 3,$102.53,"$50,382.99"
PayPal Fees,11/05/2023,Deposit,6EU44732M2785030E,07 1000 DRONES RESTR,PayPal fees,OFFICE/GENERAL ADMINISTRATIVE EXPENSES:PayPal Fees,PayPal Bank 3,$4.07,"$50,387.06"
PayPal Bank 3,11/05/2023,Deposit,2CC666159C950690R,04 PAYPAL GENERAL UNRESTR,Subject: GeneralPageTransaction ID: 2CC666159C950690Rhttps://www.paypal.com/activity/payment/2CC666159C950690R,PayPal Bank 3,--,$9.84,"$50,396.90"
Donations directed by individuals,11/05/2023,Deposit,2CC666159C950690R,04 PAYPAL GENERAL UNRESTR,Support Ukraine - Support Ukraine,Contributed income:Donations directed by individuals,PayPal Bank 3,$10.70,"$50,407.60"
PayPal Fees,11/05/2023,Deposit,2CC666159C950690R,04 PAYPAL GENERAL UNRESTR,PayPal fees,OFFICE/GENERAL ADMINISTRATIVE EXPENSES:PayPal Fees,PayPal Bank 3,$0.86,"$50,408.46"
PayPal Bank 3,11/05/2023,Deposit,01J482401B636171F,04 PAYPAL GENERAL UNRESTR,Subject: Support UkraineTransaction ID: 01J482401B636171Fhttps://www.paypal.com/activity/payment/01J482401B636171F,PayPal Bank 3,--,$98.46,"$50,506.92"
Donations directed by individuals,11/05/2023,Deposit,01J482401B636171F,04 PAYPAL GENERAL UNRESTR,Money in to PayPal,Contributed income:Donations directed by individuals,PayPal Bank 3,$102.53,"$50,609.45"
PayPal Fees,11/05/2023,Deposit,01J482401B636171F,04 PAYPAL GENERAL UNRESTR,PayPal fees,OFFICE/GENERAL ADMINISTRATIVE EXPENSES:PayPal Fees,PayPal Bank 3,$4.07,"$50,613.52"
PayPal Bank 3,11/05/2023,Deposit,0RF43823UR961231Y,09 MSU RESTR,Subject: New 10 UnitsTransaction ID: 0RF43823UR961231Yhttps://www.paypal.com/activity/payment/0RF43823UR961231Y,PayPal Bank 3,--,$9.31,"$50,622.83"
Donations directed by individuals,11/05/2023,Deposit,0RF43823UR961231Y,09 MSU RESTR,donation-form,Contributed income:Donations directed by individuals,PayPal Bank 3,$10.00,"$50,632.83"
PayPal Fees,11/05/2023,Deposit,0RF43823UR961231Y,09 MSU RESTR,PayPal fees,OFFICE/GENERAL ADMINISTRATIVE EXPENSES:PayPal Fees,PayPal Bank 3,$0.69,"$50,633.52"
PayPal Bank 3,11/05/2023,Deposit,4RK44825YF203294X,04 PAYPAL GENERAL UNRESTR,Subject: GeneralPageTransaction ID: 4RK44825YF203294Xhttps://www.paypal.com/activity/payment/4RK44825YF203294X,PayPal Bank 3,--,$98.46,"$50,731.98"
Donations directed by individuals,11/05/2023,Deposit,4RK44825YF203294X,04 PAYPAL GENERAL UNRESTR,Support Ukraine - Support Ukraine,Contributed income:Donations directed by individuals,PayPal Bank 3,$102.53,"$50,834.51"
PayPal Fees,11/05/2023,Deposit,4RK44825YF203294X,04 PAYPAL GENERAL UNRESTR,PayPal fees,OFFICE/GENERAL ADMINISTRATIVE EXPENSES:PayPal Fees,PayPal Bank 3,$4.07,"$50,838.58"
PayPal Bank 3,11/05/2023,Deposit,8RD43581YN547854B,07 1000 DRONES RESTR,Subject: 1000DRONESTransaction ID: 8RD43581YN547854Bhttps://www.paypal.com/activity/payment/8RD43581YN547854B,PayPal Bank 3,--,$97.52,"$50,936.10"
Donations directed by individuals,11/05/2023,Deposit,8RD43581YN547854B,07 1000 DRONES RESTR,1000 DRONES FOR UKRAINE - 1000 DRONES FOR UKRAINE,Contributed income:Donations directed by individuals,PayPal Bank 3,$100.00,"$51,036.10"
PayPal Fees,11/05/2023,Deposit,8RD43581YN547854B,07 1000 DRONES RESTR,PayPal fees,OFFICE/GENERAL ADMINISTRATIVE EXPENSES:PayPal Fees,PayPal Bank 3,$2.48,"$51,038.58"
PayPal Bank 3,11/05/2023,Deposit,2AR2865650922993Y,04 PAYPAL GENERAL UNRESTR,Subject: Support UkraineTransaction ID: 2AR2865650922993Yhttps://www.paypal.com/activity/payment/2AR2865650922993Y,PayPal Bank 3,--,$29.81,"$51,068.39"
Donations directed by individuals,11/05/2023,Deposit,2AR2865650922993Y,04 PAYPAL GENERAL UNRESTR,Money in to PayPal,Contributed income:Donations directed by individuals,PayPal Bank 3,$31.40,"$51,099.79"
PayPal Fees,11/05/2023,Deposit,2AR2865650922993Y,04 PAYPAL GENERAL UNRESTR,PayPal fees,OFFICE/GENERAL ADMINISTRATIVE EXPENSES:PayPal Fees,PayPal Bank 3,$1.59,"$51,101.38"
PayPal Bank 3,11/05/2023,Deposit,25589971AV562435E,07 1000 DRONES RESTR,Subject: 1000DRONESTransaction ID: 25589971AV562435Ehttps://www.paypal.com/activity/payment/25589971AV562435E,PayPal Bank 3,--,$33.29,"$51,134.67"
Donations directed by individuals,11/05/2023,Deposit,25589971AV562435E,07 1000 DRONES RESTR,1000 DRONES FOR UKRAINE - 1000 DRONES FOR UKRAINE,Contributed income:Donations directed by individuals,PayPal Bank 3,$35.00,"$51,169.67"
PayPal Fees,11/05/2023,Deposit,25589971AV562435E,07 1000 DRONES RESTR,PayPal fees,OFFICE/GENERAL ADMINISTRATIVE EXPENSES:PayPal Fees,PayPal Bank 3,$1.71,"$51,171.38"
PayPal Bank 3,11/05/2023,Deposit,9N722833B7849450H,08 VICTORY DRONES RESTR,Subject: VICTORY DRONESTransaction ID: 9N722833B7849450Hhttps://www.paypal.com/activity/payment/9N722833B7849450H,PayPal Bank 3,--,$99.38,"$51,270.76"
Donations directed by individuals,11/05/2023,Deposit,9N722833B7849450H,08 VICTORY DRONES RESTR,Money in to PayPal,Contributed income:Donations directed by individuals,PayPal Bank 3,$103.48,"$51,374.24"
PayPal Fees,11/05/2023,Deposit,9N722833B7849450H,08 VICTORY DRONES RESTR,PayPal fees,OFFICE/GENERAL ADMINISTRATIVE EXPENSES:PayPal Fees,PayPal Bank 3,$4.10,"$51,378.34"
PayPal Bank 3,11/05/2023,Deposit,97P29807VV5375237,10 Flight to Recovery RESTR,Subject: Dignitas Ukraine Flight to RecoveryTransaction ID: 97P29807VV5375237https://www.paypal.com/activity/payment/97P29807VV5375237,PayPal Bank 3,--,$99.38,"$51,477.72"
Donations directed by individuals,11/05/2023,Deposit,97P29807VV5375237,10 Flight to Recovery RESTR,Money in to PayPal,Contributed income:Donations directed by individuals,PayPal Bank 3,$103.48,"$51,581.20"
PayPal Fees,11/05/2023,Deposit,97P29807VV5375237,10 Flight to Recovery RESTR,PayPal fees,OFFICE/GENERAL ADMINISTRATIVE EXPENSES:PayPal Fees,PayPal Bank 3,$4.10,"$51,585.30"
PayPal Bank 3,11/05/2023,Deposit,5LT23684R07683725,10 Flight to Recovery RESTR,Subject: Dignitas Ukraine Flight to RecoveryTransaction ID: 5LT23684R07683725https://www.paypal.com/activity/payment/5LT23684R07683725,PayPal Bank 3,--,$50.47,"$51,635.77"
Donations directed by individuals,11/05/2023,Deposit,5LT23684R07683725,10 Flight to Recovery RESTR,Money in to PayPal,Contributed income:Donations directed by individuals,PayPal Bank 3,$51.99,"$51,687.76"
PayPal Fees,11/05/2023,Deposit,5LT23684R07683725,10 Flight to Recovery RESTR,PayPal fees,OFFICE/GENERAL ADMINISTRATIVE EXPENSES:PayPal Fees,PayPal Bank 3,$1.52,"$51,689.28"
PayPal Bank 3,11/05/2023,Deposit,3EB92737WN208953A,07 1000 DRONES RESTR,Subject: 1000DRONESTransaction ID: 3EB92737WN208953Ahttps://www.paypal.com/activity/payment/3EB92737WN208953A,PayPal Bank 3,--,$50.00,"$51,739.28"
Donations directed by individuals,11/05/2023,Deposit,3EB92737WN208953A,07 1000 DRONES RESTR,1000 DRONES FOR UKRAINE - 1000 DRONES FOR UKRAINE,Contributed income:Donations directed by individuals,PayPal Bank 3,$51.52,"$51,790.80"
PayPal Fees,11/05/2023,Deposit,3EB92737WN208953A,07 1000 DRONES RESTR,PayPal fees,OFFICE/GENERAL ADMINISTRATIVE EXPENSES:PayPal Fees,PayPal Bank 3,$1.52,"$51,792.32"
PayPal Bank 3,11/05/2023,Deposit,88V228802K136161H,07 1000 DRONES RESTR,Subject: 1000DRONESTransaction ID: 88V228802K136161Hhttps://www.paypal.com/activity/payment/88V228802K136161H,PayPal Bank 3,--,$118.16,"$51,910.48"
Donations directed by individuals,11/05/2023,Deposit,88V228802K136161H,07 1000 DRONES RESTR,1000 DRONES FOR UKRAINE - 1000 DRONES FOR UKRAINE,Contributed income:Donations directed by individuals,PayPal Bank 3,$122.94,"$52,033.42"
PayPal Fees,11/05/2023,Deposit,88V228802K136161H,07 1000 DRONES RESTR,PayPal fees,OFFICE/GENERAL ADMINISTRATIVE EXPENSES:PayPal Fees,PayPal Bank 3,$4.78,"$52,038.20"
PayPal Bank 3,11/05/2023,Deposit,1PG864757L132402T,09 MSU RESTR,Subject: New 10 UnitsTransaction ID: 1PG864757L132402Thttps://www.paypal.com/activity/payment/1PG864757L132402T,PayPal Bank 3,--,$48.51,"$52,086.71"
Donations directed by individuals,11/05/2023,Deposit,1PG864757L132402T,09 MSU RESTR,donation-form,Contributed income:Donations directed by individuals,PayPal Bank 3,$50.00,"$52,136.71"
PayPal Fees,11/05/2023,Deposit,1PG864757L132402T,09 MSU RESTR,PayPal fees,OFFICE/GENERAL ADMINISTRATIVE EXPENSES:PayPal Fees,PayPal Bank 3,$1.49,"$52,138.20"
PayPal Bank 3,11/05/2023,Deposit,18T273452J963242H,04 PAYPAL GENERAL UNRESTR,Subject: GeneralPageTransaction ID: 18T273452J963242Hhttps://www.paypal.com/activity/payment/18T273452J963242H,PayPal Bank 3,--,$48.51,"$52,186.71"
Donations directed by individuals,11/05/2023,Deposit,18T273452J963242H,04 PAYPAL GENERAL UNRESTR,Support Ukraine - Support Ukraine,Contributed income:Donations directed by individuals,PayPal Bank 3,$50.00,"$52,236.71"
PayPal Fees,11/05/2023,Deposit,18T273452J963242H,04 PAYPAL GENERAL UNRESTR,PayPal fees,OFFICE/GENERAL ADMINISTRATIVE EXPENSES:PayPal Fees,PayPal Bank 3,$1.49,"$52,238.20"
PayPal Bank 3,11/05/2023,Deposit,9CC47767NC359583L,09 MSU RESTR,Subject: MobileShowersTransaction ID: 9CC47767NC359583Lhttps://www.paypal.com/activity/payment/9CC47767NC359583L,PayPal Bank 3,--,$96.49,"$52,334.69"
Donations directed by individuals,11/05/2023,Deposit,9CC47767NC359583L,09 MSU RESTR,Mobile Shower/Laundry Units - Mobile Shower/Laundry Units,Contributed income:Donations directed by individuals,PayPal Bank 3,$100.49,"$52,435.18"
PayPal Fees,11/05/2023,Deposit,9CC47767NC359583L,09 MSU RESTR,PayPal fees,OFFICE/GENERAL ADMINISTRATIVE EXPENSES:PayPal Fees,PayPal Bank 3,$4.00,"$52,439.18"
PayPal Bank 3,11/05/2023,Deposit,1SC80570W3523930K,07 1000 DRONES RESTR,Subject: 1000DRONESTransaction ID: 1SC80570W3523930Khttps://www.paypal.com/activity/payment/1SC80570W3523930K,PayPal Bank 3,--,$146.52,"$52,585.70"
Donations directed by individuals,11/05/2023,Deposit,1SC80570W3523930K,07 1000 DRONES RESTR,1000 DRONES FOR UKRAINE - 1000 DRONES FOR UKRAINE,Contributed income:Donations directed by individuals,PayPal Bank 3,$150.00,"$52,735.70"
PayPal Fees,11/05/2023,Deposit,1SC80570W3523930K,07 1000 DRONES RESTR,PayPal fees,OFFICE/GENERAL ADMINISTRATIVE EXPENSES:PayPal Fees,PayPal Bank 3,$3.48,"$52,739.18"
PayPal Bank 3,11/05/2023,Deposit,52485945VE245320N,07 1000 DRONES RESTR,Subject: 1000DRONESTransaction ID: 52485945VE245320Nhttps://www.paypal.com/activity/payment/52485945VE245320N,PayPal Bank 3,--,$393.87,"$53,133.05"
Donations directed by individuals,11/05/2023,Deposit,52485945VE245320N,07 1000 DRONES RESTR,1000 DRONES FOR UKRAINE - 1000 DRONES FOR UKRAINE,Contributed income:Donations directed by individuals,PayPal Bank 3,$408.62,"$53,541.67"
PayPal Fees,11/05/2023,Deposit,52485945VE245320N,07 1000 DRONES RESTR,PayPal fees,OFFICE/GENERAL ADMINISTRATIVE EXPENSES:PayPal Fees,PayPal Bank 3,$14.75,"$53,556.42"
PayPal Bank 3,11/05/2023,Deposit,0XM19224N83721744,09 MSU RESTR,Subject: MobileShowersNote: Keep up the great work.   Ukraine will win this war!!!!!!!!!!!!Transaction ID: 0XM19224N83721744https://www.paypal.com/activity/payment/0XM19224N83721744,PayPal Bank 3,--,$200.00,"$53,756.42"
Donations directed by individuals,11/05/2023,Deposit,0XM19224N83721744,09 MSU RESTR,Mobile Shower/Laundry Units - Mobile Shower/Laundry Units,Contributed income:Donations directed by individuals,PayPal Bank 3,$204.56,"$53,960.98"
PayPal Fees,11/05/2023,Deposit,0XM19224N83721744,09 MSU RESTR,PayPal fees,OFFICE/GENERAL ADMINISTRATIVE EXPENSES:PayPal Fees,PayPal Bank 3,$4.56,"$53,965.54"
PayPal Bank 3,11/05/2023,Deposit,45V540329Y2977325,07 1000 DRONES RESTR,Subject: 1000DRONESTransaction ID: 45V540329Y2977325https://www.paypal.com/activity/payment/45V540329Y2977325,PayPal Bank 3,--,$97.52,"$54,063.06"
Donations directed by individuals,11/05/2023,Deposit,45V540329Y2977325,07 1000 DRONES RESTR,1000 DRONES FOR UKRAINE - 1000 DRONES FOR UKRAINE,Contributed income:Donations directed by individuals,PayPal Bank 3,$100.00,"$54,163.06"
PayPal Fees,11/05/2023,Deposit,45V540329Y2977325,07 1000 DRONES RESTR,PayPal fees,OFFICE/GENERAL ADMINISTRATIVE EXPENSES:PayPal Fees,PayPal Bank 3,$2.48,"$54,165.54"
PayPal Bank 3,11/05/2023,Deposit,53E435826W121344M,07 1000 DRONES RESTR,Subject: 1000DRONESTransaction ID: 53E435826W121344Mhttps://www.paypal.com/activity/payment/53E435826W121344M,PayPal Bank 3,--,$14.76,"$54,180.30"
Donations directed by individuals,11/05/2023,Deposit,53E435826W121344M,07 1000 DRONES RESTR,1000 DRONES FOR UKRAINE - 1000 DRONES FOR UKRAINE,Contributed income:Donations directed by individuals,PayPal Bank 3,$15.80,"$54,196.10"
PayPal Fees,11/05/2023,Deposit,53E435826W121344M,07 1000 DRONES RESTR,PayPal fees,OFFICE/GENERAL ADMINISTRATIVE EXPENSES:PayPal Fees,PayPal Bank 3,$1.04,"$54,197.14"
PayPal Bank 3,11/05/2023,Deposit,9A98266633457280M,09 MSU RESTR,Subject: New 10 UnitsTransaction ID: 9A98266633457280Mhttps://www.paypal.com/activity/payment/9A98266633457280M,PayPal Bank 3,--,$13.99,"$54,211.13"
Donations directed by individuals,11/05/2023,Deposit,9A98266633457280M,09 MSU RESTR,donation-form,Contributed income:Donations directed by individuals,PayPal Bank 3,$15.00,"$54,226.13"
PayPal Fees,11/05/2023,Deposit,9A98266633457280M,09 MSU RESTR,PayPal fees,OFFICE/GENERAL ADMINISTRATIVE EXPENSES:PayPal Fees,PayPal Bank 3,$1.01,"$54,227.14"
PayPal Bank 3,11/05/2023,Deposit,32A7740179613930U,04 PAYPAL GENERAL UNRESTR,Subject: GeneralPageTransaction ID: 32A7740179613930Uhttps://www.paypal.com/activity/payment/32A7740179613930U,PayPal Bank 3,--,$9.84,"$54,236.98"
Donations directed by individuals,11/05/2023,Deposit,32A7740179613930U,04 PAYPAL GENERAL UNRESTR,Support Ukraine - Support Ukraine,Contributed income:Donations directed by individuals,PayPal Bank 3,$10.70,"$54,247.68"
PayPal Fees,11/05/2023,Deposit,32A7740179613930U,04 PAYPAL GENERAL UNRESTR,PayPal fees,OFFICE/GENERAL ADMINISTRATIVE EXPENSES:PayPal Fees,PayPal Bank 3,$0.86,"$54,248.54"
PayPal Bank 3,11/05/2023,Deposit,66Y794376F7357127,09 MSU RESTR,Subject: New 10 UnitsTransaction ID: 66Y794376F7357127https://www.paypal.com/activity/payment/66Y794376F7357127,PayPal Bank 3,--,$489.56,"$54,738.10"
Donations directed by individuals,11/05/2023,Deposit,66Y794376F7357127,09 MSU RESTR,donation-form,Contributed income:Donations directed by individuals,PayPal Bank 3,$500.00,"$55,238.10"
PayPal Fees,11/05/2023,Deposit,66Y794376F7357127,09 MSU RESTR,PayPal fees,OFFICE/GENERAL ADMINISTRATIVE EXPENSES:PayPal Fees,PayPal Bank 3,$10.44,"$55,248.54"
PayPal Bank 3,11/05/2023,Deposit,40U541568N532984S,07 1000 DRONES RESTR,Subject: 1000DRONESTransaction ID: 40U541568N532984Shttps://www.paypal.com/activity/payment/40U541568N532984S,PayPal Bank 3,--,$14.76,"$55,263.30"
Donations directed by individuals,11/05/2023,Deposit,40U541568N532984S,07 1000 DRONES RESTR,1000 DRONES FOR UKRAINE - 1000 DRONES FOR UKRAINE,Contributed income:Donations directed by individuals,PayPal Bank 3,$15.80,"$55,279.10"
PayPal Fees,11/05/2023,Deposit,40U541568N532984S,07 1000 DRONES RESTR,PayPal fees,OFFICE/GENERAL ADMINISTRATIVE EXPENSES:PayPal Fees,PayPal Bank 3,$1.04,"$55,280.14"
PayPal Bank 3,11/05/2023,Deposit,593837728H206982C,07 1000 DRONES RESTR,Subject: 1000DRONESTransaction ID: 593837728H206982Chttps://www.paypal.com/activity/payment/593837728H206982C,PayPal Bank 3,--,$97.52,"$55,377.66"
Donations directed by individuals,11/05/2023,Deposit,593837728H206982C,07 1000 DRONES RESTR,1000 DRONES FOR UKRAINE - 1000 DRONES FOR UKRAINE,Contributed income:Donations directed by individuals,PayPal Bank 3,$100.00,"$55,477.66"
PayPal Fees,11/05/2023,Deposit,593837728H206982C,07 1000 DRONES RESTR,PayPal fees,OFFICE/GENERAL ADMINISTRATIVE EXPENSES:PayPal Fees,PayPal Bank 3,$2.48,"$55,480.14"
PayPal Bank 3,11/03/2023,Deposit,31329143V1351235M,04 PAYPAL GENERAL UNRESTR,Subject: GeneralPageNote: Go UkraineTransaction ID: 31329143V1351235Mhttps://www.paypal.com/activity/payment/31329143V1351235M,PayPal Bank 3,--,$18.81,"$55,498.95"
Donations directed by individuals,11/03/2023,Deposit,31329143V1351235M,04 PAYPAL GENERAL UNRESTR,Support Ukraine - Support Ukraine,Contributed income:Donations directed by individuals,PayPal Bank 3,$20.00,"$55,518.95"
PayPal Fees,11/03/2023,Deposit,31329143V1351235M,04 PAYPAL GENERAL UNRESTR,PayPal fees,OFFICE/GENERAL ADMINISTRATIVE EXPENSES:PayPal Fees,PayPal Bank 3,$1.19,"$55,520.14"
PayPal Bank 3,11/03/2023,Deposit,67W50184PR851213W,04 PAYPAL GENERAL UNRESTR,Subject: GeneralPageTransaction ID: 67W50184PR851213Whttps://www.paypal.com/activity/payment/67W50184PR851213W,PayPal Bank 3,--,$50.00,"$55,570.14"
Donations directed by individuals,11/03/2023,Deposit,67W50184PR851213W,04 PAYPAL GENERAL UNRESTR,Support Ukraine - Support Ukraine,Contributed income:Donations directed by individuals,PayPal Bank 3,$51.52,"$55,621.66"
PayPal Fees,11/03/2023,Deposit,67W50184PR851213W,04 PAYPAL GENERAL UNRESTR,PayPal fees,OFFICE/GENERAL ADMINISTRATIVE EXPENSES:PayPal Fees,PayPal Bank 3,$1.52,"$55,623.18"
PayPal Bank 3,11/03/2023,Deposit,7KL77716B7303870X,08 VICTORY DRONES RESTR,Subject: VictoryDronesTransaction ID: 7KL77716B7303870Xhttps://www.paypal.com/activity/payment/7KL77716B7303870X,PayPal Bank 3,--,$98.46,"$55,721.64"
Donations directed by individuals,11/03/2023,Deposit,7KL77716B7303870X,08 VICTORY DRONES RESTR,VICTORY DRONES - VICTORY DRONES,Contributed income:Donations directed by individuals,PayPal Bank 3,$102.53,"$55,824.17"
PayPal Fees,11/03/2023,Deposit,7KL77716B7303870X,08 VICTORY DRONES RESTR,PayPal fees,OFFICE/GENERAL ADMINISTRATIVE EXPENSES:PayPal Fees,PayPal Bank 3,$4.07,"$55,828.24"
PayPal Bank 3,11/03/2023,Deposit,9NE468945J383160S,04 PAYPAL GENERAL UNRESTR,Subject: GeneralPageTransaction ID: 9NE468945J383160Shttps://www.paypal.com/activity/payment/9NE468945J383160S,PayPal Bank 3,--,$984.68,"$56,812.92"
Donations directed by individuals,11/03/2023,Deposit,9NE468945J383160S,04 PAYPAL GENERAL UNRESTR,Support Ukraine - Support Ukraine,Contributed income:Donations directed by individuals,PayPal Bank 3,"$1,020.80","$57,833.72"
PayPal Fees,11/03/2023,Deposit,9NE468945J383160S,04 PAYPAL GENERAL UNRESTR,PayPal fees,OFFICE/GENERAL ADMINISTRATIVE EXPENSES:PayPal Fees,PayPal Bank 3,$36.12,"$57,869.84"
PayPal Bank 3,11/03/2023,Deposit,0NB58438XM008824P,04 PAYPAL GENERAL UNRESTR,Subject: Support UkraineTransaction ID: 0NB58438XM008824Phttps://www.paypal.com/activity/payment/0NB58438XM008824P,PayPal Bank 3,--,$195.53,"$58,065.37"
Donations directed by individuals,11/03/2023,Deposit,0NB58438XM008824P,04 PAYPAL GENERAL UNRESTR,Money in to PayPal,Contributed income:Donations directed by individuals,PayPal Bank 3,$200.00,"$58,265.37"
PayPal Fees,11/03/2023,Deposit,0NB58438XM008824P,04 PAYPAL GENERAL UNRESTR,PayPal fees,OFFICE/GENERAL ADMINISTRATIVE EXPENSES:PayPal Fees,PayPal Bank 3,$4.47,"$58,269.84"
PayPal Bank 3,11/02/2023,Deposit,7TB34639Y8051010X,04 PAYPAL GENERAL UNRESTR,Subject: GeneralPageTransaction ID: 7TB34639Y8051010Xhttps://www.paypal.com/activity/payment/7TB34639Y8051010X,PayPal Bank 3,--,$979.61,"$59,249.45"
Donations directed by individuals,11/02/2023,Deposit,7TB34639Y8051010X,04 PAYPAL GENERAL UNRESTR,Support Ukraine - Support Ukraine,Contributed income:Donations directed by individuals,PayPal Bank 3,"$1,000.00","$60,249.45"
PayPal Fees,11/02/2023,Deposit,7TB34639Y8051010X,04 PAYPAL GENERAL UNRESTR,PayPal fees,OFFICE/GENERAL ADMINISTRATIVE EXPENSES:PayPal Fees,PayPal Bank 3,$20.39,"$60,269.84"
PayPal Bank 3,11/02/2023,Deposit,13G78199BR5571225,04 PAYPAL GENERAL UNRESTR,Subject: Support UkraineTransaction ID: 13G78199BR5571225https://www.paypal.com/activity/payment/13G78199BR5571225,PayPal Bank 3,--,$25.24,"$60,295.08"
Donations directed by individuals,11/02/2023,Deposit,13G78199BR5571225,04 PAYPAL GENERAL UNRESTR,Money in to PayPal,Contributed income:Donations directed by individuals,PayPal Bank 3,$26.25,"$60,321.33"
PayPal Fees,11/02/2023,Deposit,13G78199BR5571225,04 PAYPAL GENERAL UNRESTR,PayPal fees,OFFICE/GENERAL ADMINISTRATIVE EXPENSES:PayPal Fees,PayPal Bank 3,$1.01,"$60,322.34"
PayPal Bank 3,11/02/2023,Deposit,1L6016670J8910054,04 PAYPAL GENERAL UNRESTR,Subject: GeneralPageTransaction ID: 1L6016670J8910054https://www.paypal.com/activity/payment/1L6016670J8910054,PayPal Bank 3,--,$100.00,"$60,422.34"
Donations directed by individuals,11/02/2023,Deposit,1L6016670J8910054,04 PAYPAL GENERAL UNRESTR,Support Ukraine - Support Ukraine,Contributed income:Donations directed by individuals,PayPal Bank 3,$102.53,"$60,524.87"
PayPal Fees,11/02/2023,Deposit,1L6016670J8910054,04 PAYPAL GENERAL UNRESTR,PayPal fees,OFFICE/GENERAL ADMINISTRATIVE EXPENSES:PayPal Fees,PayPal Bank 3,$2.53,"$60,527.40"
PayPal Bank 3,11/02/2023,Deposit,76W645309G683473U,04 PAYPAL GENERAL UNRESTR,Subject: GeneralPageTransaction ID: 76W645309G683473Uhttps://www.paypal.com/activity/payment/76W645309G683473U,PayPal Bank 3,--,$47.76,"$60,575.16"
Donations directed by individuals,11/02/2023,Deposit,76W645309G683473U,04 PAYPAL GENERAL UNRESTR,Support Ukraine - Support Ukraine,Contributed income:Donations directed by individuals,PayPal Bank 3,$50.00,"$60,625.16"
PayPal Fees,11/02/2023,Deposit,76W645309G683473U,04 PAYPAL GENERAL UNRESTR,PayPal fees,OFFICE/GENERAL ADMINISTRATIVE EXPENSES:PayPal Fees,PayPal Bank 3,$2.24,"$60,627.40"
PayPal Bank 3,11/02/2023,Deposit,6FD973956K689600H,04 PAYPAL GENERAL UNRESTR,Subject: Support UkraineTransaction ID: 6FD973956K689600Hhttps://www.paypal.com/activity/payment/6FD973956K689600H,PayPal Bank 3,--,$69.00,"$60,696.40"
Donations directed by individuals,11/02/2023,Deposit,6FD973956K689600H,04 PAYPAL GENERAL UNRESTR,Money in to PayPal,Contributed income:Donations directed by individuals,PayPal Bank 3,$72.00,"$60,768.40"
PayPal Fees,11/02/2023,Deposit,6FD973956K689600H,04 PAYPAL GENERAL UNRESTR,PayPal fees,OFFICE/GENERAL ADMINISTRATIVE EXPENSES:PayPal Fees,PayPal Bank 3,$3.00,"$60,771.40"
PayPal Bank 3,11/02/2023,Deposit,11K48568GE477421V,04 PAYPAL GENERAL UNRESTR,Subject: GeneralPageTransaction ID: 11K48568GE477421Vhttps://www.paypal.com/activity/payment/11K48568GE477421V,PayPal Bank 3,--,$100.00,"$60,871.40"
Donations directed by individuals,11/02/2023,Deposit,11K48568GE477421V,04 PAYPAL GENERAL UNRESTR,Support Ukraine - Support Ukraine,Contributed income:Donations directed by individuals,PayPal Bank 3,$102.53,"$60,973.93"
PayPal Fees,11/02/2023,Deposit,11K48568GE477421V,04 PAYPAL GENERAL UNRESTR,PayPal fees,OFFICE/GENERAL ADMINISTRATIVE EXPENSES:PayPal Fees,PayPal Bank 3,$2.53,"$60,976.46"
PayPal Bank 3,11/02/2023,Deposit,63R46588H0486211W,04 PAYPAL GENERAL UNRESTR,Subject: GeneralPageNote: Щоб їбашити руснюTransaction ID: 63R46588H0486211Whttps://www.paypal.com/activity/payment/63R46588H0486211W,PayPal Bank 3,--,$49.23,"$61,025.69"
Donations directed by individuals,11/02/2023,Deposit,63R46588H0486211W,04 PAYPAL GENERAL UNRESTR,Support Ukraine - Support Ukraine,Contributed income:Donations directed by individuals,PayPal Bank 3,$51.52,"$61,077.21"
PayPal Fees,11/02/2023,Deposit,63R46588H0486211W,04 PAYPAL GENERAL UNRESTR,PayPal fees,OFFICE/GENERAL ADMINISTRATIVE EXPENSES:PayPal Fees,PayPal Bank 3,$2.29,"$61,079.50"
PayPal Bank 3,11/02/2023,Deposit,535595476U611613C,04 PAYPAL GENERAL UNRESTR,Subject: GeneralPageTransaction ID: 535595476U611613Chttps://www.paypal.com/activity/payment/535595476U611613C,PayPal Bank 3,--,$28.46,"$61,107.96"
Donations directed by individuals,11/02/2023,Deposit,535595476U611613C,04 PAYPAL GENERAL UNRESTR,Support Ukraine - Support Ukraine,Contributed income:Donations directed by individuals,PayPal Bank 3,$30.00,"$61,137.96"
PayPal Fees,11/02/2023,Deposit,535595476U611613C,04 PAYPAL GENERAL UNRESTR,PayPal fees,OFFICE/GENERAL ADMINISTRATIVE EXPENSES:PayPal Fees,PayPal Bank 3,$1.54,"$61,139.50"
PayPal Bank 3,11/02/2023,Deposit,5FG038106W132400N,07 1000 DRONES RESTR,Subject: 1000DRONESTransaction ID: 5FG038106W132400Nhttps://www.paypal.com/activity/payment/5FG038106W132400N,PayPal Bank 3,--,$31.85,"$61,171.35"
Donations directed by individuals,11/02/2023,Deposit,5FG038106W132400N,07 1000 DRONES RESTR,1000 DRONES FOR UKRAINE - 1000 DRONES FOR UKRAINE,Contributed income:Donations directed by individuals,PayPal Bank 3,$33.00,"$61,204.35"
PayPal Fees,11/02/2023,Deposit,5FG038106W132400N,07 1000 DRONES RESTR,PayPal fees,OFFICE/GENERAL ADMINISTRATIVE EXPENSES:PayPal Fees,PayPal Bank 3,$1.15,"$61,205.50"
PayPal Bank 3,11/02/2023,Deposit,29P22347EK084674M,07 1000 DRONES RESTR,Subject: 1000DRONESTransaction ID: 29P22347EK084674Mhttps://www.paypal.com/activity/payment/29P22347EK084674M,PayPal Bank 3,--,$200.00,"$61,405.50"
Donations directed by individuals,11/02/2023,Deposit,29P22347EK084674M,07 1000 DRONES RESTR,1000 DRONES FOR UKRAINE - 1000 DRONES FOR UKRAINE,Contributed income:Donations directed by individuals,PayPal Bank 3,$204.56,"$61,610.06"
PayPal Fees,11/02/2023,Deposit,29P22347EK084674M,07 1000 DRONES RESTR,PayPal fees,OFFICE/GENERAL ADMINISTRATIVE EXPENSES:PayPal Fees,PayPal Bank 3,$4.56,"$61,614.62"
PayPal Bank 3,11/02/2023,Deposit,2AT657827L627915D,07 1000 DRONES RESTR,Subject: 1000DRONESTransaction ID: 2AT657827L627915Dhttps://www.paypal.com/activity/payment/2AT657827L627915D,PayPal Bank 3,--,$196.93,"$61,811.55"
Donations directed by individuals,11/02/2023,Deposit,2AT657827L627915D,07 1000 DRONES RESTR,1000 DRONES FOR UKRAINE - 1000 DRONES FOR UKRAINE,Contributed income:Donations directed by individuals,PayPal Bank 3,$204.56,"$62,016.11"
PayPal Fees,11/02/2023,Deposit,2AT657827L627915D,07 1000 DRONES RESTR,PayPal fees,OFFICE/GENERAL ADMINISTRATIVE EXPENSES:PayPal Fees,PayPal Bank 3,$7.63,"$62,023.74"
PayPal Bank 3,11/02/2023,Deposit,1EH92644R24871441,07 1000 DRONES RESTR,Subject: 1000DRONESTransaction ID: 1EH92644R24871441https://www.paypal.com/activity/payment/1EH92644R24871441,PayPal Bank 3,--,$49.23,"$62,072.97"
Donations directed by individuals,11/02/2023,Deposit,1EH92644R24871441,07 1000 DRONES RESTR,1000 DRONES FOR UKRAINE - 1000 DRONES FOR UKRAINE,Contributed income:Donations directed by individuals,PayPal Bank 3,$51.52,"$62,124.49"
PayPal Fees,11/02/2023,Deposit,1EH92644R24871441,07 1000 DRONES RESTR,PayPal fees,OFFICE/GENERAL ADMINISTRATIVE EXPENSES:PayPal Fees,PayPal Bank 3,$2.29,"$62,126.78"
PayPal Bank 3,11/02/2023,Deposit,1Y767928E73575017,04 PAYPAL GENERAL UNRESTR,Subject: GeneralPageTransaction ID: 1Y767928E73575017https://www.paypal.com/activity/payment/1Y767928E73575017,PayPal Bank 3,--,$28.46,"$62,155.24"
Donations directed by individuals,11/02/2023,Deposit,1Y767928E73575017,04 PAYPAL GENERAL UNRESTR,Support Ukraine - Support Ukraine,Contributed income:Donations directed by individuals,PayPal Bank 3,$30.00,"$62,185.24"
PayPal Fees,11/02/2023,Deposit,1Y767928E73575017,04 PAYPAL GENERAL UNRESTR,PayPal fees,OFFICE/GENERAL ADMINISTRATIVE EXPENSES:PayPal Fees,PayPal Bank 3,$1.54,"$62,186.78"
PayPal Bank 3,11/02/2023,Deposit,7CY11024J6075894R,04 PAYPAL GENERAL UNRESTR,Note: Le soutien pour l'UkraineTransaction ID: 7CY11024J6075894Rhttps://www.paypal.com/activity/payment/7CY11024J6075894R,PayPal Bank 3,--,$96.20,"$62,282.98"
Donations directed by individuals,11/02/2023,Deposit,7CY11024J6075894R,04 PAYPAL GENERAL UNRESTR,Money in to PayPal,Contributed income:Donations directed by individuals,PayPal Bank 3,$100.19,"$62,383.17"
PayPal Fees,11/02/2023,Deposit,7CY11024J6075894R,04 PAYPAL GENERAL UNRESTR,PayPal fees,OFFICE/GENERAL ADMINISTRATIVE EXPENSES:PayPal Fees,PayPal Bank 3,$3.99,"$62,387.16"
PayPal Bank 3,11/02/2023,Deposit,5W8307794H413024X,04 PAYPAL GENERAL UNRESTR,Subject: Support UkraineTransaction ID: 5W8307794H413024Xhttps://www.paypal.com/activity/payment/5W8307794H413024X,PayPal Bank 3,--,$29.81,"$62,416.97"
Donations directed by individuals,11/02/2023,Deposit,5W8307794H413024X,04 PAYPAL GENERAL UNRESTR,Money in to PayPal,Contributed income:Donations directed by individuals,PayPal Bank 3,$31.40,"$62,448.37"
PayPal Fees,11/02/2023,Deposit,5W8307794H413024X,04 PAYPAL GENERAL UNRESTR,PayPal fees,OFFICE/GENERAL ADMINISTRATIVE EXPENSES:PayPal Fees,PayPal Bank 3,$1.59,"$62,449.96"
PayPal Bank 3,11/02/2023,Deposit,04R22566J0206603T,04 PAYPAL GENERAL UNRESTR,Subject: Support UkraineTransaction ID: 04R22566J0206603Thttps://www.paypal.com/activity/payment/04R22566J0206603T,PayPal Bank 3,--,$23.64,"$62,473.60"
Donations directed by individuals,11/02/2023,Deposit,04R22566J0206603T,04 PAYPAL GENERAL UNRESTR,Money in to PayPal,Contributed income:Donations directed by individuals,PayPal Bank 3,$25.00,"$62,498.60"
PayPal Fees,11/02/2023,Deposit,04R22566J0206603T,04 PAYPAL GENERAL UNRESTR,PayPal fees,OFFICE/GENERAL ADMINISTRATIVE EXPENSES:PayPal Fees,PayPal Bank 3,$1.36,"$62,499.96"
PayPal Bank 3,11/02/2023,Deposit,6BB825684H157352C,04 PAYPAL GENERAL UNRESTR,Subject: Support UkraineTransaction ID: 6BB825684H157352Chttps://www.paypal.com/activity/payment/6BB825684H157352C,PayPal Bank 3,--,$100.93,"$62,600.89"
Donations directed by individuals,11/02/2023,Deposit,6BB825684H157352C,04 PAYPAL GENERAL UNRESTR,Money in to PayPal,Contributed income:Donations directed by individuals,PayPal Bank 3,$103.48,"$62,704.37"
PayPal Fees,11/02/2023,Deposit,6BB825684H157352C,04 PAYPAL GENERAL UNRESTR,PayPal fees,OFFICE/GENERAL ADMINISTRATIVE EXPENSES:PayPal Fees,PayPal Bank 3,$2.55,"$62,706.92"
PayPal Bank 3,11/02/2023,Deposit,82W383273R430244F,04 PAYPAL GENERAL UNRESTR,Subject: Support UkraineTransaction ID: 82W383273R430244Fhttps://www.paypal.com/activity/payment/82W383273R430244F,PayPal Bank 3,--,$47.76,"$62,754.68"
Donations directed by individuals,11/02/2023,Deposit,82W383273R430244F,04 PAYPAL GENERAL UNRESTR,Money in to PayPal,Contributed income:Donations directed by individuals,PayPal Bank 3,$50.00,"$62,804.68"
PayPal Fees,11/02/2023,Deposit,82W383273R430244F,04 PAYPAL GENERAL UNRESTR,PayPal fees,OFFICE/GENERAL ADMINISTRATIVE EXPENSES:PayPal Fees,PayPal Bank 3,$2.24,"$62,806.92"
PayPal Bank 3,11/02/2023,Deposit,86L96832PD468583P,04 PAYPAL GENERAL UNRESTR,Subject: Support UkraineTransaction ID: 86L96832PD468583Phttps://www.paypal.com/activity/payment/86L96832PD468583P,PayPal Bank 3,--,$4.96,"$62,811.88"
Donations directed by individuals,11/02/2023,Deposit,86L96832PD468583P,04 PAYPAL GENERAL UNRESTR,Money in to PayPal,Contributed income:Donations directed by individuals,PayPal Bank 3,$5.65,"$62,817.53"
PayPal Fees,11/02/2023,Deposit,86L96832PD468583P,04 PAYPAL GENERAL UNRESTR,PayPal fees,OFFICE/GENERAL ADMINISTRATIVE EXPENSES:PayPal Fees,PayPal Bank 3,$0.69,"$62,818.22"
PayPal Bank 3,11/02/2023,Deposit,9NN250816N917460X,04 PAYPAL GENERAL UNRESTR,Subject: Support UkraineTransaction ID: 9NN250816N917460Xhttps://www.paypal.com/activity/payment/9NN250816N917460X,PayPal Bank 3,--,$18.81,"$62,837.03"
Donations directed by individuals,11/02/2023,Deposit,9NN250816N917460X,04 PAYPAL GENERAL UNRESTR,Money in to PayPal,Contributed income:Donations directed by individuals,PayPal Bank 3,$20.00,"$62,857.03"
PayPal Fees,11/02/2023,Deposit,9NN250816N917460X,04 PAYPAL GENERAL UNRESTR,PayPal fees,OFFICE/GENERAL ADMINISTRATIVE EXPENSES:PayPal Fees,PayPal Bank 3,$1.19,"$62,858.22"
PayPal Bank 3,11/02/2023,Deposit,0UN01230N9204791A,04 PAYPAL GENERAL UNRESTR,Subject: GeneralPageTransaction ID: 0UN01230N9204791Ahttps://www.paypal.com/activity/payment/0UN01230N9204791A,PayPal Bank 3,--,"$2,939.81","$65,798.03"
Donations directed by individuals,11/02/2023,Deposit,0UN01230N9204791A,04 PAYPAL GENERAL UNRESTR,Support Ukraine - Support Ukraine,Contributed income:Donations directed by individuals,PayPal Bank 3,"$3,000.00","$68,798.03"
PayPal Fees,11/02/2023,Deposit,0UN01230N9204791A,04 PAYPAL GENERAL UNRESTR,PayPal fees,OFFICE/GENERAL ADMINISTRATIVE EXPENSES:PayPal Fees,PayPal Bank 3,$60.19,"$68,858.22"
PayPal Bank 3,11/02/2023,Deposit,4W099560F3541363G,04 PAYPAL GENERAL UNRESTR,Subject: Support UkraineTransaction ID: 4W099560F3541363Ghttps://www.paypal.com/activity/payment/4W099560F3541363G,PayPal Bank 3,--,$50.47,"$68,908.69"
Donations directed by individuals,11/02/2023,Deposit,4W099560F3541363G,04 PAYPAL GENERAL UNRESTR,Money in to PayPal,Contributed income:Donations directed by individuals,PayPal Bank 3,$51.99,"$68,960.68"
PayPal Fees,11/02/2023,Deposit,4W099560F3541363G,04 PAYPAL GENERAL UNRESTR,PayPal fees,OFFICE/GENERAL ADMINISTRATIVE EXPENSES:PayPal Fees,PayPal Bank 3,$1.52,"$68,962.20"
PayPal Bank 3,11/02/2023,Deposit,9DX77341BW0842841,04 PAYPAL GENERAL UNRESTR,Subject: Support UkraineTransaction ID: 9DX77341BW0842841https://www.paypal.com/activity/payment/9DX77341BW0842841,PayPal Bank 3,--,$50.47,"$69,012.67"
Donations directed by individuals,11/02/2023,Deposit,9DX77341BW0842841,04 PAYPAL GENERAL UNRESTR,Money in to PayPal,Contributed income:Donations directed by individuals,PayPal Bank 3,$51.99,"$69,064.66"
PayPal Fees,11/02/2023,Deposit,9DX77341BW0842841,04 PAYPAL GENERAL UNRESTR,PayPal fees,OFFICE/GENERAL ADMINISTRATIVE EXPENSES:PayPal Fees,PayPal Bank 3,$1.52,"$69,066.18"
PayPal Bank 3,11/02/2023,Deposit,3W016561DL9041847,04 PAYPAL GENERAL UNRESTR,Subject: Support UkraineTransaction ID: 3W016561DL9041847https://www.paypal.com/activity/payment/3W016561DL9041847,PayPal Bank 3,--,$47.76,"$69,113.94"
Donations directed by individuals,11/02/2023,Deposit,3W016561DL9041847,04 PAYPAL GENERAL UNRESTR,Money in to PayPal,Contributed income:Donations directed by individuals,PayPal Bank 3,$50.00,"$69,163.94"
PayPal Fees,11/02/2023,Deposit,3W016561DL9041847,04 PAYPAL GENERAL UNRESTR,PayPal fees,OFFICE/GENERAL ADMINISTRATIVE EXPENSES:PayPal Fees,PayPal Bank 3,$2.24,"$69,166.18"
PayPal Bank 3,11/02/2023,Deposit,8B619661CM855522N,04 PAYPAL GENERAL UNRESTR,Subject: Support UkraineTransaction ID: 8B619661CM855522Nhttps://www.paypal.com/activity/payment/8B619661CM855522N,PayPal Bank 3,--,$25.24,"$69,191.42"
Donations directed by individuals,11/02/2023,Deposit,8B619661CM855522N,04 PAYPAL GENERAL UNRESTR,Money in to PayPal,Contributed income:Donations directed by individuals,PayPal Bank 3,$26.25,"$69,217.67"
PayPal Fees,11/02/2023,Deposit,8B619661CM855522N,04 PAYPAL GENERAL UNRESTR,PayPal fees,OFFICE/GENERAL ADMINISTRATIVE EXPENSES:PayPal Fees,PayPal Bank 3,$1.01,"$69,218.68"
PayPal Bank 3,11/02/2023,Deposit,59G86583R26797307,04 PAYPAL GENERAL UNRESTR,Subject: GeneralPageTransaction ID: 59G86583R26797307https://www.paypal.com/activity/payment/59G86583R26797307,PayPal Bank 3,--,$29.53,"$69,248.21"
Donations directed by individuals,11/02/2023,Deposit,59G86583R26797307,04 PAYPAL GENERAL UNRESTR,Support Ukraine - Support Ukraine,Contributed income:Donations directed by individuals,PayPal Bank 3,$31.11,"$69,279.32"
PayPal Fees,11/02/2023,Deposit,59G86583R26797307,04 PAYPAL GENERAL UNRESTR,PayPal fees,OFFICE/GENERAL ADMINISTRATIVE EXPENSES:PayPal Fees,PayPal Bank 3,$1.58,"$69,280.90"
PayPal Bank 3,11/02/2023,Deposit,54L40010JG777912M,07 1000 DRONES RESTR,Subject: GeneralPageNote: na drony!Transaction ID: 54L40010JG777912Mhttps://www.paypal.com/activity/payment/54L40010JG777912M,PayPal Bank 3,--,$50.00,"$69,330.90"
Donations directed by individuals,11/02/2023,Deposit,54L40010JG777912M,07 1000 DRONES RESTR,Support Ukraine - Support Ukraine,Contributed income:Donations directed by individuals,PayPal Bank 3,$51.52,"$69,382.42"
PayPal Fees,11/02/2023,Deposit,54L40010JG777912M,07 1000 DRONES RESTR,PayPal fees,OFFICE/GENERAL ADMINISTRATIVE EXPENSES:PayPal Fees,PayPal Bank 3,$1.52,"$69,383.94"
PayPal Bank 3,11/02/2023,Deposit,9EU69810C5360492T,04 PAYPAL GENERAL UNRESTR,Subject: GeneralPageTransaction ID: 9EU69810C5360492Thttps://www.paypal.com/activity/payment/9EU69810C5360492T,PayPal Bank 3,--,$50.00,"$69,433.94"
Donations directed by individuals,11/02/2023,Deposit,9EU69810C5360492T,04 PAYPAL GENERAL UNRESTR,Support Ukraine - Support Ukraine,Contributed income:Donations directed by individuals,PayPal Bank 3,$51.52,"$69,485.46"
PayPal Fees,11/02/2023,Deposit,9EU69810C5360492T,04 PAYPAL GENERAL UNRESTR,PayPal fees,OFFICE/GENERAL ADMINISTRATIVE EXPENSES:PayPal Fees,PayPal Bank 3,$1.52,"$69,486.98"
PayPal Bank 3,11/02/2023,Deposit,9YY73441YB023790R,04 PAYPAL GENERAL UNRESTR,Subject: GeneralPageTransaction ID: 9YY73441YB023790Rhttps://www.paypal.com/activity/payment/9YY73441YB023790R,PayPal Bank 3,--,$47.76,"$69,534.74"
Donations directed by individuals,11/02/2023,Deposit,9YY73441YB023790R,04 PAYPAL GENERAL UNRESTR,Support Ukraine - Support Ukraine,Contributed income:Donations directed by individuals,PayPal Bank 3,$50.00,"$69,584.74"
PayPal Fees,11/02/2023,Deposit,9YY73441YB023790R,04 PAYPAL GENERAL UNRESTR,PayPal fees,OFFICE/GENERAL ADMINISTRATIVE EXPENSES:PayPal Fees,PayPal Bank 3,$2.24,"$69,586.98"
PayPal Bank 3,11/02/2023,Deposit,3MH06201AA455492E,04 PAYPAL GENERAL UNRESTR,Subject: GeneralPageTransaction ID: 3MH06201AA455492Ehttps://www.paypal.com/activity/payment/3MH06201AA455492E,PayPal Bank 3,--,$9.16,"$69,596.14"
Donations directed by individuals,11/02/2023,Deposit,3MH06201AA455492E,04 PAYPAL GENERAL UNRESTR,Support Ukraine - Support Ukraine,Contributed income:Donations directed by individuals,PayPal Bank 3,$10.00,"$69,606.14"
PayPal Fees,11/02/2023,Deposit,3MH06201AA455492E,04 PAYPAL GENERAL UNRESTR,PayPal fees,OFFICE/GENERAL ADMINISTRATIVE EXPENSES:PayPal Fees,PayPal Bank 3,$0.84,"$69,606.98"
PayPal Bank 3,11/02/2023,Deposit,72Y31378VM764163U,04 PAYPAL GENERAL UNRESTR,Subject: GeneralPageTransaction ID: 72Y31378VM764163Uhttps://www.paypal.com/activity/payment/72Y31378VM764163U,PayPal Bank 3,--,$98.46,"$69,705.44"
Donations directed by individuals,11/02/2023,Deposit,72Y31378VM764163U,04 PAYPAL GENERAL UNRESTR,Support Ukraine - Support Ukraine,Contributed income:Donations directed by individuals,PayPal Bank 3,$102.53,"$69,807.97"
PayPal Fees,11/02/2023,Deposit,72Y31378VM764163U,04 PAYPAL GENERAL UNRESTR,PayPal fees,OFFICE/GENERAL ADMINISTRATIVE EXPENSES:PayPal Fees,PayPal Bank 3,$4.07,"$69,812.04"
PayPal Bank 3,11/02/2023,Deposit,41K55411DA818151B,04 PAYPAL GENERAL UNRESTR,Subject: GeneralPageNote: A la place d'un cadeau d'anniversaire.   Slava Ukraîni - Herojm slava!Transaction ID: 41K55411DA818151Bhttps://www.paypal.com/activity/payment/41K55411DA818151B,PayPal Bank 3,--,$207.76,"$70,019.80"
Donations directed by individuals,11/02/2023,Deposit,41K55411DA818151B,04 PAYPAL GENERAL UNRESTR,Support Ukraine - Support Ukraine,Contributed income:Donations directed by individuals,PayPal Bank 3,$215.78,"$70,235.58"
PayPal Fees,11/02/2023,Deposit,41K55411DA818151B,04 PAYPAL GENERAL UNRESTR,PayPal fees,OFFICE/GENERAL ADMINISTRATIVE EXPENSES:PayPal Fees,PayPal Bank 3,$8.02,"$70,243.60"
PayPal Bank 3,11/02/2023,Deposit,7LR697392X9348514,04 PAYPAL GENERAL UNRESTR,Subject: GeneralPageTransaction ID: 7LR697392X9348514https://www.paypal.com/activity/payment/7LR697392X9348514,PayPal Bank 3,--,$195.53,"$70,439.13"
Donations directed by individuals,11/02/2023,Deposit,7LR697392X9348514,04 PAYPAL GENERAL UNRESTR,Support Ukraine - Support Ukraine,Contributed income:Donations directed by individuals,PayPal Bank 3,$200.00,"$70,639.13"
PayPal Fees,11/02/2023,Deposit,7LR697392X9348514,04 PAYPAL GENERAL UNRESTR,PayPal fees,OFFICE/GENERAL ADMINISTRATIVE EXPENSES:PayPal Fees,PayPal Bank 3,$4.47,"$70,643.60"
PayPal Bank 3,11/02/2023,Deposit,1BD00464D28063439,04 PAYPAL GENERAL UNRESTR,Subject: GeneralPageNote: Дякую вам рідненькіTransaction ID: 1BD00464D28063439https://www.paypal.com/activity/payment/1BD00464D28063439,PayPal Bank 3,--,$24.61,"$70,668.21"
Donations directed by individuals,11/02/2023,Deposit,1BD00464D28063439,04 PAYPAL GENERAL UNRESTR,Support Ukraine - Support Ukraine,Contributed income:Donations directed by individuals,PayPal Bank 3,$26.01,"$70,694.22"
PayPal Fees,11/02/2023,Deposit,1BD00464D28063439,04 PAYPAL GENERAL UNRESTR,PayPal fees,OFFICE/GENERAL ADMINISTRATIVE EXPENSES:PayPal Fees,PayPal Bank 3,$1.40,"$70,695.62"
PayPal Bank 3,11/02/2023,Deposit,6AM99324L4134762W,07 1000 DRONES RESTR,Subject: 1000DRONESTransaction ID: 6AM99324L4134762Whttps://www.paypal.com/activity/payment/6AM99324L4134762W,PayPal Bank 3,--,$100.00,"$70,795.62"
Donations directed by individuals,11/02/2023,Deposit,6AM99324L4134762W,07 1000 DRONES RESTR,1000 DRONES FOR UKRAINE - 1000 DRONES FOR UKRAINE,Contributed income:Donations directed by individuals,PayPal Bank 3,$102.53,"$70,898.15"
PayPal Fees,11/02/2023,Deposit,6AM99324L4134762W,07 1000 DRONES RESTR,PayPal fees,OFFICE/GENERAL ADMINISTRATIVE EXPENSES:PayPal Fees,PayPal Bank 3,$2.53,"$70,900.68"
PayPal Bank 3,11/02/2023,Deposit,5VM72884G6296400U,04 PAYPAL GENERAL UNRESTR,Subject: GeneralPageTransaction ID: 5VM72884G6296400Uhttps://www.paypal.com/activity/payment/5VM72884G6296400U,PayPal Bank 3,--,$391.55,"$71,292.23"
Donations directed by individuals,11/02/2023,Deposit,5VM72884G6296400U,04 PAYPAL GENERAL UNRESTR,Support Ukraine - Support Ukraine,Contributed income:Donations directed by individuals,PayPal Bank 3,$400.00,"$71,692.23"
PayPal Fees,11/02/2023,Deposit,5VM72884G6296400U,04 PAYPAL GENERAL UNRESTR,PayPal fees,OFFICE/GENERAL ADMINISTRATIVE EXPENSES:PayPal Fees,PayPal Bank 3,$8.45,"$71,700.68"
PayPal Bank 3,11/02/2023,Deposit,8TF957513D036384H,10 Flight to Recovery RESTR,Subject: FlightToRecoveryTransaction ID: 8TF957513D036384Hhttps://www.paypal.com/activity/payment/8TF957513D036384H,PayPal Bank 3,--,$10.00,"$71,710.68"
Donations directed by individuals,11/02/2023,Deposit,8TF957513D036384H,10 Flight to Recovery RESTR,Flight to Recovery - Flight to Recovery,Contributed income:Donations directed by individuals,PayPal Bank 3,$10.70,"$71,721.38"
PayPal Fees,11/02/2023,Deposit,8TF957513D036384H,10 Flight to Recovery RESTR,PayPal fees,OFFICE/GENERAL ADMINISTRATIVE EXPENSES:PayPal Fees,PayPal Bank 3,$0.70,"$71,722.08"
PayPal Bank 3,11/02/2023,Deposit,5FL1289581131674L,04 PAYPAL GENERAL UNRESTR,Subject: Support UkraineTransaction ID: 5FL1289581131674Lhttps://www.paypal.com/activity/payment/5FL1289581131674L,PayPal Bank 3,--,$20.95,"$71,743.03"
Donations directed by individuals,11/02/2023,Deposit,5FL1289581131674L,04 PAYPAL GENERAL UNRESTR,Money in to PayPal,Contributed income:Donations directed by individuals,PayPal Bank 3,$22.22,"$71,765.25"
PayPal Fees,11/02/2023,Deposit,5FL1289581131674L,04 PAYPAL GENERAL UNRESTR,PayPal fees,OFFICE/GENERAL ADMINISTRATIVE EXPENSES:PayPal Fees,PayPal Bank 3,$1.27,"$71,766.52"
PayPal Bank 3,11/02/2023,Deposit,04S77503649846826,04 PAYPAL GENERAL UNRESTR,Subject: Support UkraineTransaction ID: 04S77503649846826https://www.paypal.com/activity/payment/04S77503649846826,PayPal Bank 3,--,$96.02,"$71,862.54"
Donations directed by individuals,11/02/2023,Deposit,04S77503649846826,04 PAYPAL GENERAL UNRESTR,Money in to PayPal,Contributed income:Donations directed by individuals,PayPal Bank 3,$100.00,"$71,962.54"
PayPal Fees,11/02/2023,Deposit,04S77503649846826,04 PAYPAL GENERAL UNRESTR,PayPal fees,OFFICE/GENERAL ADMINISTRATIVE EXPENSES:PayPal Fees,PayPal Bank 3,$3.98,"$71,966.52"
PayPal Bank 3,11/02/2023,Deposit,6EN16584H11935213,04 PAYPAL GENERAL UNRESTR,Subject: GeneralPageTransaction ID: 6EN16584H11935213https://www.paypal.com/activity/payment/6EN16584H11935213,PayPal Bank 3,--,$49.23,"$72,015.75"
Donations directed by individuals,11/02/2023,Deposit,6EN16584H11935213,04 PAYPAL GENERAL UNRESTR,Support Ukraine - Support Ukraine,Contributed income:Donations directed by individuals,PayPal Bank 3,$51.52,"$72,067.27"
PayPal Fees,11/02/2023,Deposit,6EN16584H11935213,04 PAYPAL GENERAL UNRESTR,PayPal fees,OFFICE/GENERAL ADMINISTRATIVE EXPENSES:PayPal Fees,PayPal Bank 3,$2.29,"$72,069.56"
PayPal Bank 3,11/02/2023,Deposit,34N22848125695619,04 PAYPAL GENERAL UNRESTR,Subject: Support UkraineTransaction ID: 34N22848125695619https://www.paypal.com/activity/payment/34N22848125695619,PayPal Bank 3,--,$99.38,"$72,168.94"
Donations directed by individuals,11/02/2023,Deposit,34N22848125695619,04 PAYPAL GENERAL UNRESTR,Money in to PayPal,Contributed income:Donations directed by individuals,PayPal Bank 3,$103.48,"$72,272.42"
PayPal Fees,11/02/2023,Deposit,34N22848125695619,04 PAYPAL GENERAL UNRESTR,PayPal fees,OFFICE/GENERAL ADMINISTRATIVE EXPENSES:PayPal Fees,PayPal Bank 3,$4.10,"$72,276.52"
PayPal Bank 3,11/02/2023,Deposit,5UW14341CU3450645,04 PAYPAL GENERAL UNRESTR,Subject: GeneralPageTransaction ID: 5UW14341CU3450645https://www.paypal.com/activity/payment/5UW14341CU3450645,PayPal Bank 3,--,$18.81,"$72,295.33"
Donations directed by individuals,11/02/2023,Deposit,5UW14341CU3450645,04 PAYPAL GENERAL UNRESTR,Support Ukraine - Support Ukraine,Contributed income:Donations directed by individuals,PayPal Bank 3,$20.00,"$72,315.33"
PayPal Fees,11/02/2023,Deposit,5UW14341CU3450645,04 PAYPAL GENERAL UNRESTR,PayPal fees,OFFICE/GENERAL ADMINISTRATIVE EXPENSES:PayPal Fees,PayPal Bank 3,$1.19,"$72,316.52"
PayPal Bank 3,11/02/2023,Deposit,5BG9426871632820K,08 VICTORY DRONES RESTR,Subject: VICTORY DRONESTransaction ID: 5BG9426871632820Khttps://www.paypal.com/activity/payment/5BG9426871632820K,PayPal Bank 3,--,$2.97,"$72,319.49"
Donations directed by individuals,11/02/2023,Deposit,5BG9426871632820K,08 VICTORY DRONES RESTR,Money in to PayPal,Contributed income:Donations directed by individuals,PayPal Bank 3,$3.59,"$72,323.08"
PayPal Fees,11/02/2023,Deposit,5BG9426871632820K,08 VICTORY DRONES RESTR,PayPal fees,OFFICE/GENERAL ADMINISTRATIVE EXPENSES:PayPal Fees,PayPal Bank 3,$0.62,"$72,323.70"
PayPal Bank 3,11/02/2023,Deposit,7F526915F3033662C,04 PAYPAL GENERAL UNRESTR,Subject: GeneralPageTransaction ID: 7F526915F3033662Chttps://www.paypal.com/activity/payment/7F526915F3033662C,PayPal Bank 3,--,$17.72,"$72,341.42"
Donations directed by individuals,11/02/2023,Deposit,7F526915F3033662C,04 PAYPAL GENERAL UNRESTR,Support Ukraine - Support Ukraine,Contributed income:Donations directed by individuals,PayPal Bank 3,$18.87,"$72,360.29"
PayPal Fees,11/02/2023,Deposit,7F526915F3033662C,04 PAYPAL GENERAL UNRESTR,PayPal fees,OFFICE/GENERAL ADMINISTRATIVE EXPENSES:PayPal Fees,PayPal Bank 3,$1.15,"$72,361.44"
PayPal Bank 3,11/02/2023,Deposit,5HT77327J2234344F,04 PAYPAL GENERAL UNRESTR,Subject: Support UkraineTransaction ID: 5HT77327J2234344Fhttps://www.paypal.com/activity/payment/5HT77327J2234344F,PayPal Bank 3,--,$14.90,"$72,376.34"
Donations directed by individuals,11/02/2023,Deposit,5HT77327J2234344F,04 PAYPAL GENERAL UNRESTR,Money in to PayPal,Contributed income:Donations directed by individuals,PayPal Bank 3,$15.95,"$72,392.29"
PayPal Fees,11/02/2023,Deposit,5HT77327J2234344F,04 PAYPAL GENERAL UNRESTR,PayPal fees,OFFICE/GENERAL ADMINISTRATIVE EXPENSES:PayPal Fees,PayPal Bank 3,$1.05,"$72,393.34"
PayPal Bank 3,11/02/2023,Deposit,13P331347A817623E,07 1000 DRONES RESTR,Subject: GeneralPageNote: Slava Ukraini! We are with you until victory! Please use this money for the drone program.Transaction ID: 13P331347A817623Ehttps://www.paypal.com/activity/payment/13P331347A817623E,PayPal Bank 3,--,$100.00,"$72,493.34"
Donations directed by individuals,11/02/2023,Deposit,13P331347A817623E,07 1000 DRONES RESTR,Support Ukraine - Support Ukraine,Contributed income:Donations directed by individuals,PayPal Bank 3,$102.53,"$72,595.87"
PayPal Fees,11/02/2023,Deposit,13P331347A817623E,07 1000 DRONES RESTR,PayPal fees,OFFICE/GENERAL ADMINISTRATIVE EXPENSES:PayPal Fees,PayPal Bank 3,$2.53,"$72,598.40"
PayPal Bank 3,11/02/2023,Deposit,83U181313P913514C,07 1000 DRONES RESTR,Subject: 1000DRONESTransaction ID: 83U181313P913514Chttps://www.paypal.com/activity/payment/83U181313P913514C,PayPal Bank 3,--,$295.40,"$72,893.80"
Donations directed by individuals,11/02/2023,Deposit,83U181313P913514C,07 1000 DRONES RESTR,1000 DRONES FOR UKRAINE - 1000 DRONES FOR UKRAINE,Contributed income:Donations directed by individuals,PayPal Bank 3,$306.59,"$73,200.39"
PayPal Fees,11/02/2023,Deposit,83U181313P913514C,07 1000 DRONES RESTR,PayPal fees,OFFICE/GENERAL ADMINISTRATIVE EXPENSES:PayPal Fees,PayPal Bank 3,$11.19,"$73,211.58"
PayPal Bank 3,11/02/2023,Deposit,27E10633WY216840D,07 1000 DRONES RESTR,Subject: GeneralPageNote: For dronesTransaction ID: 27E10633WY216840Dhttps://www.paypal.com/activity/payment/27E10633WY216840D,PayPal Bank 3,--,$97.52,"$73,309.10"
Donations directed by individuals,11/02/2023,Deposit,27E10633WY216840D,07 1000 DRONES RESTR,Support Ukraine - Support Ukraine,Contributed income:Donations directed by individuals,PayPal Bank 3,$100.00,"$73,409.10"
PayPal Fees,11/02/2023,Deposit,27E10633WY216840D,07 1000 DRONES RESTR,PayPal fees,OFFICE/GENERAL ADMINISTRATIVE EXPENSES:PayPal Fees,PayPal Bank 3,$2.48,"$73,411.58"
PayPal Bank 3,11/02/2023,Deposit,3F3014658M436335G,04 PAYPAL GENERAL UNRESTR,Subject: GeneralPageTransaction ID: 3F3014658M436335Ghttps://www.paypal.com/activity/payment/3F3014658M436335G,PayPal Bank 3,--,$24.01,"$73,435.59"
Donations directed by individuals,11/02/2023,Deposit,3F3014658M436335G,04 PAYPAL GENERAL UNRESTR,Support Ukraine - Support Ukraine,Contributed income:Donations directed by individuals,PayPal Bank 3,$25.00,"$73,460.59"
PayPal Fees,11/02/2023,Deposit,3F3014658M436335G,04 PAYPAL GENERAL UNRESTR,PayPal fees,OFFICE/GENERAL ADMINISTRATIVE EXPENSES:PayPal Fees,PayPal Bank 3,$0.99,"$73,461.58"
PayPal Bank 3,11/02/2023,Deposit,83M777545L734752K,04 PAYPAL GENERAL UNRESTR,Subject: GeneralPageTransaction ID: 83M777545L734752Khttps://www.paypal.com/activity/payment/83M777545L734752K,PayPal Bank 3,--,$38.11,"$73,499.69"
Donations directed by individuals,11/02/2023,Deposit,83M777545L734752K,04 PAYPAL GENERAL UNRESTR,Support Ukraine - Support Ukraine,Contributed income:Donations directed by individuals,PayPal Bank 3,$40.00,"$73,539.69"
PayPal Fees,11/02/2023,Deposit,83M777545L734752K,04 PAYPAL GENERAL UNRESTR,PayPal fees,OFFICE/GENERAL ADMINISTRATIVE EXPENSES:PayPal Fees,PayPal Bank 3,$1.89,"$73,541.58"
PayPal Bank 3,11/02/2023,Deposit,1SA58753YS304094S,04 PAYPAL GENERAL UNRESTR,Subject: GeneralPageTransaction ID: 1SA58753YS304094Shttps://www.paypal.com/activity/payment/1SA58753YS304094S,PayPal Bank 3,--,$50.00,"$73,591.58"
Donations directed by individuals,11/02/2023,Deposit,1SA58753YS304094S,04 PAYPAL GENERAL UNRESTR,Support Ukraine - Support Ukraine,Contributed income:Donations directed by individuals,PayPal Bank 3,$51.52,"$73,643.10"
PayPal Fees,11/02/2023,Deposit,1SA58753YS304094S,04 PAYPAL GENERAL UNRESTR,PayPal fees,OFFICE/GENERAL ADMINISTRATIVE EXPENSES:PayPal Fees,PayPal Bank 3,$1.52,"$73,644.62"
PayPal Bank 3,11/02/2023,Deposit,0XE44745SH120300R,07 1000 DRONES RESTR,Subject: 1000DRONESTransaction ID: 0XE44745SH120300Rhttps://www.paypal.com/activity/payment/0XE44745SH120300R,PayPal Bank 3,--,$157.55,"$73,802.17"
Donations directed by individuals,11/02/2023,Deposit,0XE44745SH120300R,07 1000 DRONES RESTR,1000 DRONES FOR UKRAINE - 1000 DRONES FOR UKRAINE,Contributed income:Donations directed by individuals,PayPal Bank 3,$163.75,"$73,965.92"
PayPal Fees,11/02/2023,Deposit,0XE44745SH120300R,07 1000 DRONES RESTR,PayPal fees,OFFICE/GENERAL ADMINISTRATIVE EXPENSES:PayPal Fees,PayPal Bank 3,$6.20,"$73,972.12"
PayPal Bank 3,11/02/2023,Deposit,3M341799T8834504Y,07 1000 DRONES RESTR,Subject: 1000 DRONES FOR UKRAINETransaction ID: 3M341799T8834504Yhttps://www.paypal.com/activity/payment/3M341799T8834504Y,PayPal Bank 3,--,$18.81,"$73,990.93"
Donations directed by individuals,11/02/2023,Deposit,3M341799T8834504Y,07 1000 DRONES RESTR,Money in to PayPal,Contributed income:Donations directed by individuals,PayPal Bank 3,$20.00,"$74,010.93"
PayPal Fees,11/02/2023,Deposit,3M341799T8834504Y,07 1000 DRONES RESTR,PayPal fees,OFFICE/GENERAL ADMINISTRATIVE EXPENSES:PayPal Fees,PayPal Bank 3,$1.19,"$74,012.12"
PayPal Bank 3,11/02/2023,Deposit,1HA8496047804583P,04 PAYPAL GENERAL UNRESTR,Subject: GeneralPageTransaction ID: 1HA8496047804583Phttps://www.paypal.com/activity/payment/1HA8496047804583P,PayPal Bank 3,--,$18.81,"$74,030.93"
Donations directed by individuals,11/02/2023,Deposit,1HA8496047804583P,04 PAYPAL GENERAL UNRESTR,Support Ukraine - Support Ukraine,Contributed income:Donations directed by individuals,PayPal Bank 3,$20.00,"$74,050.93"
PayPal Fees,11/02/2023,Deposit,1HA8496047804583P,04 PAYPAL GENERAL UNRESTR,PayPal fees,OFFICE/GENERAL ADMINISTRATIVE EXPENSES:PayPal Fees,PayPal Bank 3,$1.19,"$74,052.12"
PayPal Bank 3,11/02/2023,Deposit,3YH05274LC609050K,04 PAYPAL GENERAL UNRESTR,Subject: GeneralPageTransaction ID: 3YH05274LC609050Khttps://www.paypal.com/activity/payment/3YH05274LC609050K,PayPal Bank 3,--,$38.50,"$74,090.62"
Donations directed by individuals,11/02/2023,Deposit,3YH05274LC609050K,04 PAYPAL GENERAL UNRESTR,Support Ukraine - Support Ukraine,Contributed income:Donations directed by individuals,PayPal Bank 3,$40.40,"$74,131.02"
PayPal Fees,11/02/2023,Deposit,3YH05274LC609050K,04 PAYPAL GENERAL UNRESTR,PayPal fees,OFFICE/GENERAL ADMINISTRATIVE EXPENSES:PayPal Fees,PayPal Bank 3,$1.90,"$74,132.92"
PayPal Bank 3,11/02/2023,Deposit,5SS893741J441774L,04 PAYPAL GENERAL UNRESTR,Subject: Support UkraineTransaction ID: 5SS893741J441774Lhttps://www.paypal.com/activity/payment/5SS893741J441774L,PayPal Bank 3,--,$47.70,"$74,180.62"
Donations directed by individuals,11/02/2023,Deposit,5SS893741J441774L,04 PAYPAL GENERAL UNRESTR,Money in to PayPal,Contributed income:Donations directed by individuals,PayPal Bank 3,$49.93,"$74,230.55"
PayPal Fees,11/02/2023,Deposit,5SS893741J441774L,04 PAYPAL GENERAL UNRESTR,PayPal fees,OFFICE/GENERAL ADMINISTRATIVE EXPENSES:PayPal Fees,PayPal Bank 3,$2.23,"$74,232.78"
PayPal Bank 3,11/02/2023,Deposit,7SD790536E6467917,04 PAYPAL GENERAL UNRESTR,Subject: GeneralPageTransaction ID: 7SD790536E6467917https://www.paypal.com/activity/payment/7SD790536E6467917,PayPal Bank 3,--,$636.57,"$74,869.35"
Donations directed by individuals,11/02/2023,Deposit,7SD790536E6467917,04 PAYPAL GENERAL UNRESTR,Support Ukraine - Support Ukraine,Contributed income:Donations directed by individuals,PayPal Bank 3,$650.00,"$75,519.35"
PayPal Fees,11/02/2023,Deposit,7SD790536E6467917,04 PAYPAL GENERAL UNRESTR,PayPal fees,OFFICE/GENERAL ADMINISTRATIVE EXPENSES:PayPal Fees,PayPal Bank 3,$13.43,"$75,532.78"
PayPal Bank 3,11/02/2023,Deposit,06845088KR850060K,04 PAYPAL GENERAL UNRESTR,Subject: Support UkraineTransaction ID: 06845088KR850060Khttps://www.paypal.com/activity/payment/06845088KR850060K,PayPal Bank 3,--,$19.87,"$75,552.65"
Donations directed by individuals,11/02/2023,Deposit,06845088KR850060K,04 PAYPAL GENERAL UNRESTR,Money in to PayPal,Contributed income:Donations directed by individuals,PayPal Bank 3,$21.10,"$75,573.75"
PayPal Fees,11/02/2023,Deposit,06845088KR850060K,04 PAYPAL GENERAL UNRESTR,PayPal fees,OFFICE/GENERAL ADMINISTRATIVE EXPENSES:PayPal Fees,PayPal Bank 3,$1.23,"$75,574.98"
PayPal Bank 3,11/02/2023,Deposit,4KL71461TP2691905,04 PAYPAL GENERAL UNRESTR,Subject: Support UkraineTransaction ID: 4KL71461TP2691905https://www.paypal.com/activity/payment/4KL71461TP2691905,PayPal Bank 3,--,$9.93,"$75,584.91"
Donations directed by individuals,11/02/2023,Deposit,4KL71461TP2691905,04 PAYPAL GENERAL UNRESTR,Money in to PayPal,Contributed income:Donations directed by individuals,PayPal Bank 3,$10.80,"$75,595.71"
PayPal Fees,11/02/2023,Deposit,4KL71461TP2691905,04 PAYPAL GENERAL UNRESTR,PayPal fees,OFFICE/GENERAL ADMINISTRATIVE EXPENSES:PayPal Fees,PayPal Bank 3,$0.87,"$75,596.58"
PayPal Bank 3,11/02/2023,Deposit,8D209453K5199041L,04 PAYPAL GENERAL UNRESTR,Subject: GeneralPageTransaction ID: 8D209453K5199041Lhttps://www.paypal.com/activity/payment/8D209453K5199041L,PayPal Bank 3,--,$49.23,"$75,645.81"
Donations directed by individuals,11/02/2023,Deposit,8D209453K5199041L,04 PAYPAL GENERAL UNRESTR,Support Ukraine - Support Ukraine,Contributed income:Donations directed by individuals,PayPal Bank 3,$51.52,"$75,697.33"
PayPal Fees,11/02/2023,Deposit,8D209453K5199041L,04 PAYPAL GENERAL UNRESTR,PayPal fees,OFFICE/GENERAL ADMINISTRATIVE EXPENSES:PayPal Fees,PayPal Bank 3,$2.29,"$75,699.62"
PayPal Bank 3,11/02/2023,Deposit,32644378AB678960N,04 PAYPAL GENERAL UNRESTR,Subject: GeneralPageTransaction ID: 32644378AB678960Nhttps://www.paypal.com/activity/payment/32644378AB678960N,PayPal Bank 3,--,$34.46,"$75,734.08"
Donations directed by individuals,11/02/2023,Deposit,32644378AB678960N,04 PAYPAL GENERAL UNRESTR,Support Ukraine - Support Ukraine,Contributed income:Donations directed by individuals,PayPal Bank 3,$36.21,"$75,770.29"
PayPal Fees,11/02/2023,Deposit,32644378AB678960N,04 PAYPAL GENERAL UNRESTR,PayPal fees,OFFICE/GENERAL ADMINISTRATIVE EXPENSES:PayPal Fees,PayPal Bank 3,$1.75,"$75,772.04"
PayPal Bank 3,11/02/2023,Deposit,8AG38644B10040449,04 PAYPAL GENERAL UNRESTR,Subject: Support UkraineTransaction ID: 8AG38644B10040449https://www.paypal.com/activity/payment/8AG38644B10040449,PayPal Bank 3,--,$9.16,"$75,781.20"
Donations directed by individuals,11/02/2023,Deposit,8AG38644B10040449,04 PAYPAL GENERAL UNRESTR,Money in to PayPal,Contributed income:Donations directed by individuals,PayPal Bank 3,$10.00,"$75,791.20"
PayPal Fees,11/02/2023,Deposit,8AG38644B10040449,04 PAYPAL GENERAL UNRESTR,PayPal fees,OFFICE/GENERAL ADMINISTRATIVE EXPENSES:PayPal Fees,PayPal Bank 3,$0.84,"$75,792.04"
PayPal Bank 3,11/02/2023,Deposit,3KS98685AV5365022,04 PAYPAL GENERAL UNRESTR,Subject: Support UkraineTransaction ID: 3KS98685AV5365022https://www.paypal.com/activity/payment/3KS98685AV5365022,PayPal Bank 3,--,$9.16,"$75,801.20"
Donations directed by individuals,11/02/2023,Deposit,3KS98685AV5365022,04 PAYPAL GENERAL UNRESTR,Money in to PayPal,Contributed income:Donations directed by individuals,PayPal Bank 3,$10.00,"$75,811.20"
PayPal Fees,11/02/2023,Deposit,3KS98685AV5365022,04 PAYPAL GENERAL UNRESTR,PayPal fees,OFFICE/GENERAL ADMINISTRATIVE EXPENSES:PayPal Fees,PayPal Bank 3,$0.84,"$75,812.04"
PayPal Bank 3,11/02/2023,Deposit,9LA26910HG593401C,04 PAYPAL GENERAL UNRESTR,Subject: Support UkraineTransaction ID: 9LA26910HG593401Chttps://www.paypal.com/activity/payment/9LA26910HG593401C,PayPal Bank 3,--,$70.08,"$75,882.12"
Donations directed by individuals,11/02/2023,Deposit,9LA26910HG593401C,04 PAYPAL GENERAL UNRESTR,Money in to PayPal,Contributed income:Donations directed by individuals,PayPal Bank 3,$72.00,"$75,954.12"
PayPal Fees,11/02/2023,Deposit,9LA26910HG593401C,04 PAYPAL GENERAL UNRESTR,PayPal fees,OFFICE/GENERAL ADMINISTRATIVE EXPENSES:PayPal Fees,PayPal Bank 3,$1.92,"$75,956.04"
PayPal Bank 3,11/02/2023,Deposit,6C998884V1573704R,04 PAYPAL GENERAL UNRESTR,Subject: GeneralPageTransaction ID: 6C998884V1573704Rhttps://www.paypal.com/activity/payment/6C998884V1573704R,PayPal Bank 3,--,$100.00,"$76,056.04"
Donations directed by individuals,11/02/2023,Deposit,6C998884V1573704R,04 PAYPAL GENERAL UNRESTR,Support Ukraine - Support Ukraine,Contributed income:Donations directed by individuals,PayPal Bank 3,$102.53,"$76,158.57"
PayPal Fees,11/02/2023,Deposit,6C998884V1573704R,04 PAYPAL GENERAL UNRESTR,PayPal fees,OFFICE/GENERAL ADMINISTRATIVE EXPENSES:PayPal Fees,PayPal Bank 3,$2.53,"$76,161.10"
PayPal Bank 3,11/02/2023,Deposit,98D410012M504045G,04 PAYPAL GENERAL UNRESTR,Subject: GeneralPageTransaction ID: 98D410012M504045Ghttps://www.paypal.com/activity/payment/98D410012M504045G,PayPal Bank 3,--,$97.52,"$76,258.62"
Donations directed by individuals,11/02/2023,Deposit,98D410012M504045G,04 PAYPAL GENERAL UNRESTR,Support Ukraine - Support Ukraine,Contributed income:Donations directed by individuals,PayPal Bank 3,$100.00,"$76,358.62"
PayPal Fees,11/02/2023,Deposit,98D410012M504045G,04 PAYPAL GENERAL UNRESTR,PayPal fees,OFFICE/GENERAL ADMINISTRATIVE EXPENSES:PayPal Fees,PayPal Bank 3,$2.48,"$76,361.10"
PayPal Bank 3,11/02/2023,Deposit,3JV59504J14669436,04 PAYPAL GENERAL UNRESTR,Subject: Support UkraineTransaction ID: 3JV59504J14669436https://www.paypal.com/activity/payment/3JV59504J14669436,PayPal Bank 3,--,$23.63,"$76,384.73"
Donations directed by individuals,11/02/2023,Deposit,3JV59504J14669436,04 PAYPAL GENERAL UNRESTR,Money in to PayPal,Contributed income:Donations directed by individuals,PayPal Bank 3,$24.99,"$76,409.72"
PayPal Fees,11/02/2023,Deposit,3JV59504J14669436,04 PAYPAL GENERAL UNRESTR,PayPal fees,OFFICE/GENERAL ADMINISTRATIVE EXPENSES:PayPal Fees,PayPal Bank 3,$1.36,"$76,411.08"
PayPal Bank 3,11/02/2023,Deposit,46S78770H8359904B,04 PAYPAL GENERAL UNRESTR,Subject: Support UkraineTransaction ID: 46S78770H8359904Bhttps://www.paypal.com/activity/payment/46S78770H8359904B,PayPal Bank 3,--,$50.47,"$76,461.55"
Donations directed by individuals,11/02/2023,Deposit,46S78770H8359904B,04 PAYPAL GENERAL UNRESTR,Money in to PayPal,Contributed income:Donations directed by individuals,PayPal Bank 3,$51.99,"$76,513.54"
PayPal Fees,11/02/2023,Deposit,46S78770H8359904B,04 PAYPAL GENERAL UNRESTR,PayPal fees,OFFICE/GENERAL ADMINISTRATIVE EXPENSES:PayPal Fees,PayPal Bank 3,$1.52,"$76,515.06"
PayPal Bank 3,11/02/2023,Deposit,7S091274T51450322,04 PAYPAL GENERAL UNRESTR,Subject: GeneralPageTransaction ID: 7S091274T51450322https://www.paypal.com/activity/payment/7S091274T51450322,PayPal Bank 3,--,$28.46,"$76,543.52"
Donations directed by individuals,11/02/2023,Deposit,7S091274T51450322,04 PAYPAL GENERAL UNRESTR,Support Ukraine - Support Ukraine,Contributed income:Donations directed by individuals,PayPal Bank 3,$30.00,"$76,573.52"
PayPal Fees,11/02/2023,Deposit,7S091274T51450322,04 PAYPAL GENERAL UNRESTR,PayPal fees,OFFICE/GENERAL ADMINISTRATIVE EXPENSES:PayPal Fees,PayPal Bank 3,$1.54,"$76,575.06"
PayPal Bank 3,11/02/2023,Deposit,7K531671X7800044G,04 PAYPAL GENERAL UNRESTR,Subject: Support UkraineTransaction ID: 7K531671X7800044Ghttps://www.paypal.com/activity/payment/7K531671X7800044G,PayPal Bank 3,--,$24.84,"$76,599.90"
Donations directed by individuals,11/02/2023,Deposit,7K531671X7800044G,04 PAYPAL GENERAL UNRESTR,Money in to PayPal,Contributed income:Donations directed by individuals,PayPal Bank 3,$26.25,"$76,626.15"
PayPal Fees,11/02/2023,Deposit,7K531671X7800044G,04 PAYPAL GENERAL UNRESTR,PayPal fees,OFFICE/GENERAL ADMINISTRATIVE EXPENSES:PayPal Fees,PayPal Bank 3,$1.41,"$76,627.56"
PayPal Bank 3,11/02/2023,Deposit,0HS31560MU411664D,04 PAYPAL GENERAL UNRESTR,Subject: GeneralPageTransaction ID: 0HS31560MU411664Dhttps://www.paypal.com/activity/payment/0HS31560MU411664D,PayPal Bank 3,--,$295.40,"$76,922.96"
Donations directed by individuals,11/02/2023,Deposit,0HS31560MU411664D,04 PAYPAL GENERAL UNRESTR,Support Ukraine - Support Ukraine,Contributed income:Donations directed by individuals,PayPal Bank 3,$306.59,"$77,229.55"
PayPal Fees,11/02/2023,Deposit,0HS31560MU411664D,04 PAYPAL GENERAL UNRESTR,PayPal fees,OFFICE/GENERAL ADMINISTRATIVE EXPENSES:PayPal Fees,PayPal Bank 3,$11.19,"$77,240.74"
PayPal Bank 3,11/02/2023,Deposit,8RX38575U7779404T,07 1000 DRONES RESTR,Subject: 1000DRONESTransaction ID: 8RX38575U7779404Thttps://www.paypal.com/activity/payment/8RX38575U7779404T,PayPal Bank 3,--,$96.02,"$77,336.76"
Donations directed by individuals,11/02/2023,Deposit,8RX38575U7779404T,07 1000 DRONES RESTR,1000 DRONES FOR UKRAINE - 1000 DRONES FOR UKRAINE,Contributed income:Donations directed by individuals,PayPal Bank 3,$100.00,"$77,436.76"
PayPal Fees,11/02/2023,Deposit,8RX38575U7779404T,07 1000 DRONES RESTR,PayPal fees,OFFICE/GENERAL ADMINISTRATIVE EXPENSES:PayPal Fees,PayPal Bank 3,$3.98,"$77,440.74"
PayPal Bank 3,11/02/2023,Deposit,75B56241149645710,04 PAYPAL GENERAL UNRESTR,Subject: Support UkraineTransaction ID: 75B56241149645710https://www.paypal.com/activity/payment/75B56241149645710,PayPal Bank 3,--,$19.87,"$77,460.61"
Donations directed by individuals,11/02/2023,Deposit,75B56241149645710,04 PAYPAL GENERAL UNRESTR,Money in to PayPal,Contributed income:Donations directed by individuals,PayPal Bank 3,$21.10,"$77,481.71"
PayPal Fees,11/02/2023,Deposit,75B56241149645710,04 PAYPAL GENERAL UNRESTR,PayPal fees,OFFICE/GENERAL ADMINISTRATIVE EXPENSES:PayPal Fees,PayPal Bank 3,$1.23,"$77,482.94"
PayPal Bank 3,11/02/2023,Deposit,1YS81098026772949,07 1000 DRONES RESTR,Subject: 1000DRONESNote: PersevereTransaction ID: 1YS81098026772949https://www.paypal.com/activity/payment/1YS81098026772949,PayPal Bank 3,--,$196.93,"$77,679.87"
Donations directed by individuals,11/02/2023,Deposit,1YS81098026772949,07 1000 DRONES RESTR,1000 DRONES FOR UKRAINE - 1000 DRONES FOR UKRAINE,Contributed income:Donations directed by individuals,PayPal Bank 3,$204.56,"$77,884.43"
PayPal Fees,11/02/2023,Deposit,1YS81098026772949,07 1000 DRONES RESTR,PayPal fees,OFFICE/GENERAL ADMINISTRATIVE EXPENSES:PayPal Fees,PayPal Bank 3,$7.63,"$77,892.06"
PayPal Bank 3,11/02/2023,Deposit,11405178AS827380H,04 PAYPAL GENERAL UNRESTR,Subject: GeneralPageTransaction ID: 11405178AS827380Hhttps://www.paypal.com/activity/payment/11405178AS827380H,PayPal Bank 3,--,$100.00,"$77,992.06"
Donations directed by individuals,11/02/2023,Deposit,11405178AS827380H,04 PAYPAL GENERAL UNRESTR,Support Ukraine - Support Ukraine,Contributed income:Donations directed by individuals,PayPal Bank 3,$102.53,"$78,094.59"
PayPal Fees,11/02/2023,Deposit,11405178AS827380H,04 PAYPAL GENERAL UNRESTR,PayPal fees,OFFICE/GENERAL ADMINISTRATIVE EXPENSES:PayPal Fees,PayPal Bank 3,$2.53,"$78,097.12"
PayPal Bank 3,11/02/2023,Deposit,9R0615312F741005G,07 1000 DRONES RESTR,Subject: 1000DRONESTransaction ID: 9R0615312F741005Ghttps://www.paypal.com/activity/payment/9R0615312F741005G,PayPal Bank 3,--,$100.00,"$78,197.12"
Donations directed by individuals,11/02/2023,Deposit,9R0615312F741005G,07 1000 DRONES RESTR,1000 DRONES FOR UKRAINE - 1000 DRONES FOR UKRAINE,Contributed income:Donations directed by individuals,PayPal Bank 3,$102.53,"$78,299.65"
PayPal Fees,11/02/2023,Deposit,9R0615312F741005G,07 1000 DRONES RESTR,PayPal fees,OFFICE/GENERAL ADMINISTRATIVE EXPENSES:PayPal Fees,PayPal Bank 3,$2.53,"$78,302.18"
PayPal Bank 3,11/02/2023,Deposit,84A42456N2972372U,04 PAYPAL GENERAL UNRESTR,Subject: Support UkraineTransaction ID: 84A42456N2972372Uhttps://www.paypal.com/activity/payment/84A42456N2972372U,PayPal Bank 3,--,$147.70,"$78,449.88"
Donations directed by individuals,11/02/2023,Deposit,84A42456N2972372U,04 PAYPAL GENERAL UNRESTR,Money in to PayPal,Contributed income:Donations directed by individuals,PayPal Bank 3,$153.55,"$78,603.43"
PayPal Fees,11/02/2023,Deposit,84A42456N2972372U,04 PAYPAL GENERAL UNRESTR,PayPal fees,OFFICE/GENERAL ADMINISTRATIVE EXPENSES:PayPal Fees,PayPal Bank 3,$5.85,"$78,609.28"
PayPal Bank 3,11/02/2023,Deposit,36253296VC918110Y,08 VICTORY DRONES RESTR,Subject: VICTORY DRONESTransaction ID: 36253296VC918110Yhttps://www.paypal.com/activity/payment/36253296VC918110Y,PayPal Bank 3,--,$2.97,"$78,612.25"
Donations directed by individuals,11/02/2023,Deposit,36253296VC918110Y,08 VICTORY DRONES RESTR,Money in to PayPal,Contributed income:Donations directed by individuals,PayPal Bank 3,$3.59,"$78,615.84"
PayPal Fees,11/02/2023,Deposit,36253296VC918110Y,08 VICTORY DRONES RESTR,PayPal fees,OFFICE/GENERAL ADMINISTRATIVE EXPENSES:PayPal Fees,PayPal Bank 3,$0.62,"$78,616.46"
PayPal Bank 3,11/02/2023,Deposit,9C394123XV8991240,04 PAYPAL GENERAL UNRESTR,Subject: GeneralPageTransaction ID: 9C394123XV8991240https://www.paypal.com/activity/payment/9C394123XV8991240,PayPal Bank 3,--,$49.23,"$78,665.69"
Donations directed by individuals,11/02/2023,Deposit,9C394123XV8991240,04 PAYPAL GENERAL UNRESTR,Support Ukraine - Support Ukraine,Contributed income:Donations directed by individuals,PayPal Bank 3,$51.52,"$78,717.21"
PayPal Fees,11/02/2023,Deposit,9C394123XV8991240,04 PAYPAL GENERAL UNRESTR,PayPal fees,OFFICE/GENERAL ADMINISTRATIVE EXPENSES:PayPal Fees,PayPal Bank 3,$2.29,"$78,719.50"
PayPal Bank 3,11/02/2023,Deposit,6W747868VH4692535,08 VICTORY DRONES RESTR,Subject: VictoryDronesTransaction ID: 6W747868VH4692535https://www.paypal.com/activity/payment/6W747868VH4692535,PayPal Bank 3,--,$19.69,"$78,739.19"
Donations directed by individuals,11/02/2023,Deposit,6W747868VH4692535,08 VICTORY DRONES RESTR,VICTORY DRONES - VICTORY DRONES,Contributed income:Donations directed by individuals,PayPal Bank 3,$20.91,"$78,760.10"
PayPal Fees,11/02/2023,Deposit,6W747868VH4692535,08 VICTORY DRONES RESTR,PayPal fees,OFFICE/GENERAL ADMINISTRATIVE EXPENSES:PayPal Fees,PayPal Bank 3,$1.22,"$78,761.32"
PayPal Bank 3,11/02/2023,Deposit,5R3705296L531130Y,04 PAYPAL GENERAL UNRESTR,Subject: Support UkraineTransaction ID: 5R3705296L531130Yhttps://www.paypal.com/activity/payment/5R3705296L531130Y,PayPal Bank 3,--,$298.14,"$79,059.46"
Donations directed by individuals,11/02/2023,Deposit,5R3705296L531130Y,04 PAYPAL GENERAL UNRESTR,Money in to PayPal,Contributed income:Donations directed by individuals,PayPal Bank 3,$309.43,"$79,368.89"
PayPal Fees,11/02/2023,Deposit,5R3705296L531130Y,04 PAYPAL GENERAL UNRESTR,PayPal fees,OFFICE/GENERAL ADMINISTRATIVE EXPENSES:PayPal Fees,PayPal Bank 3,$11.29,"$79,380.18"
PayPal Bank 3,11/02/2023,Deposit,99L85929UL764450D,04 PAYPAL GENERAL UNRESTR,Subject: GeneralPageTransaction ID: 99L85929UL764450Dhttps://www.paypal.com/activity/payment/99L85929UL764450D,PayPal Bank 3,--,$19.69,"$79,399.87"
Donations directed by individuals,11/02/2023,Deposit,99L85929UL764450D,04 PAYPAL GENERAL UNRESTR,Support Ukraine - Support Ukraine,Contributed income:Donations directed by individuals,PayPal Bank 3,$20.91,"$79,420.78"
PayPal Fees,11/02/2023,Deposit,99L85929UL764450D,04 PAYPAL GENERAL UNRESTR,PayPal fees,OFFICE/GENERAL ADMINISTRATIVE EXPENSES:PayPal Fees,PayPal Bank 3,$1.22,"$79,422.00"
PayPal Bank 3,11/02/2023,Deposit,22626981UK710471X,10 Flight to Recovery RESTR,Subject: Flight to RecoveryTransaction ID: 22626981UK710471Xhttps://www.paypal.com/activity/payment/22626981UK710471X,PayPal Bank 3,--,$50.00,"$79,472.00"
Donations directed by individuals,11/02/2023,Deposit,22626981UK710471X,10 Flight to Recovery RESTR,Money in to PayPal,Contributed income:Donations directed by individuals,PayPal Bank 3,$51.52,"$79,523.52"
PayPal Fees,11/02/2023,Deposit,22626981UK710471X,10 Flight to Recovery RESTR,PayPal fees,OFFICE/GENERAL ADMINISTRATIVE EXPENSES:PayPal Fees,PayPal Bank 3,$1.52,"$79,525.04"
PayPal Bank 3,11/02/2023,Deposit,7NW50380PC3874337,04 PAYPAL GENERAL UNRESTR,Subject: GeneralPageTransaction ID: 7NW50380PC3874337https://www.paypal.com/activity/payment/7NW50380PC3874337,PayPal Bank 3,--,$47.76,"$79,572.80"
Donations directed by individuals,11/02/2023,Deposit,7NW50380PC3874337,04 PAYPAL GENERAL UNRESTR,Support Ukraine - Support Ukraine,Contributed income:Donations directed by individuals,PayPal Bank 3,$50.00,"$79,622.80"
PayPal Fees,11/02/2023,Deposit,7NW50380PC3874337,04 PAYPAL GENERAL UNRESTR,PayPal fees,OFFICE/GENERAL ADMINISTRATIVE EXPENSES:PayPal Fees,PayPal Bank 3,$2.24,"$79,625.04"
PayPal Bank 3,11/02/2023,Deposit,70P94210Y0915791P,04 PAYPAL GENERAL UNRESTR,Subject: GeneralPageTransaction ID: 70P94210Y0915791Phttps://www.paypal.com/activity/payment/70P94210Y0915791P,PayPal Bank 3,--,$18.81,"$79,643.85"
Donations directed by individuals,11/02/2023,Deposit,70P94210Y0915791P,04 PAYPAL GENERAL UNRESTR,Support Ukraine - Support Ukraine,Contributed income:Donations directed by individuals,PayPal Bank 3,$20.00,"$79,663.85"
PayPal Fees,11/02/2023,Deposit,70P94210Y0915791P,04 PAYPAL GENERAL UNRESTR,PayPal fees,OFFICE/GENERAL ADMINISTRATIVE EXPENSES:PayPal Fees,PayPal Bank 3,$1.19,"$79,665.04"
PayPal Bank 3,11/02/2023,Deposit,53844687A44085127,07 1000 DRONES RESTR,Subject: 1000DRONESTransaction ID: 53844687A44085127https://www.paypal.com/activity/payment/53844687A44085127,PayPal Bank 3,--,$23.64,"$79,688.68"
Donations directed by individuals,11/02/2023,Deposit,53844687A44085127,07 1000 DRONES RESTR,1000 DRONES FOR UKRAINE - 1000 DRONES FOR UKRAINE,Contributed income:Donations directed by individuals,PayPal Bank 3,$25.00,"$79,713.68"
PayPal Fees,11/02/2023,Deposit,53844687A44085127,07 1000 DRONES RESTR,PayPal fees,OFFICE/GENERAL ADMINISTRATIVE EXPENSES:PayPal Fees,PayPal Bank 3,$1.36,"$79,715.04"
PayPal Bank 3,11/02/2023,Deposit,01713437UM936963Y,04 PAYPAL GENERAL UNRESTR,Subject: GeneralPageTransaction ID: 01713437UM936963Yhttps://www.paypal.com/activity/payment/01713437UM936963Y,PayPal Bank 3,--,$30.00,"$79,745.04"
Donations directed by individuals,11/02/2023,Deposit,01713437UM936963Y,04 PAYPAL GENERAL UNRESTR,Support Ukraine - Support Ukraine,Contributed income:Donations directed by individuals,PayPal Bank 3,$31.11,"$79,776.15"
PayPal Fees,11/02/2023,Deposit,01713437UM936963Y,04 PAYPAL GENERAL UNRESTR,PayPal fees,OFFICE/GENERAL ADMINISTRATIVE EXPENSES:PayPal Fees,PayPal Bank 3,$1.11,"$79,777.26"
PayPal Bank 3,11/02/2023,Deposit,031518192E966164N,04 PAYPAL GENERAL UNRESTR,Subject: GeneralPageTransaction ID: 031518192E966164Nhttps://www.paypal.com/activity/payment/031518192E966164N,PayPal Bank 3,--,$50.00,"$79,827.26"
Donations directed by individuals,11/02/2023,Deposit,031518192E966164N,04 PAYPAL GENERAL UNRESTR,Support Ukraine - Support Ukraine,Contributed income:Donations directed by individuals,PayPal Bank 3,$51.52,"$79,878.78"
PayPal Fees,11/02/2023,Deposit,031518192E966164N,04 PAYPAL GENERAL UNRESTR,PayPal fees,OFFICE/GENERAL ADMINISTRATIVE EXPENSES:PayPal Fees,PayPal Bank 3,$1.52,"$79,880.30"
PayPal Bank 3,11/02/2023,Deposit,1YW15096XL2693809,04 PAYPAL GENERAL UNRESTR,Subject: GeneralPageTransaction ID: 1YW15096XL2693809https://www.paypal.com/activity/payment/1YW15096XL2693809,PayPal Bank 3,--,$196.93,"$80,077.23"
Donations directed by individuals,11/02/2023,Deposit,1YW15096XL2693809,04 PAYPAL GENERAL UNRESTR,Support Ukraine - Support Ukraine,Contributed income:Donations directed by individuals,PayPal Bank 3,$204.56,"$80,281.79"
PayPal Fees,11/02/2023,Deposit,1YW15096XL2693809,04 PAYPAL GENERAL UNRESTR,PayPal fees,OFFICE/GENERAL ADMINISTRATIVE EXPENSES:PayPal Fees,PayPal Bank 3,$7.63,"$80,289.42"
PayPal Bank 3,11/02/2023,Deposit,1WG06791MA036190Y,08 VICTORY DRONES RESTR,Subject: VICTORY DRONESTransaction ID: 1WG06791MA036190Yhttps://www.paypal.com/activity/payment/1WG06791MA036190Y,PayPal Bank 3,--,$100.93,"$80,390.35"
Donations directed by individuals,11/02/2023,Deposit,1WG06791MA036190Y,08 VICTORY DRONES RESTR,Money in to PayPal,Contributed income:Donations directed by individuals,PayPal Bank 3,$103.48,"$80,493.83"
PayPal Fees,11/02/2023,Deposit,1WG06791MA036190Y,08 VICTORY DRONES RESTR,PayPal fees,OFFICE/GENERAL ADMINISTRATIVE EXPENSES:PayPal Fees,PayPal Bank 3,$2.55,"$80,496.38"
PayPal Bank 3,11/02/2023,Deposit,2W906350VU789682A,04 PAYPAL GENERAL UNRESTR,Subject: GeneralPageNote: HB Yulya SaganTransaction ID: 2W906350VU789682Ahttps://www.paypal.com/activity/payment/2W906350VU789682A,PayPal Bank 3,--,$28.91,"$80,525.29"
Donations directed by individuals,11/02/2023,Deposit,2W906350VU789682A,04 PAYPAL GENERAL UNRESTR,Support Ukraine - Support Ukraine,Contributed income:Donations directed by individuals,PayPal Bank 3,$30.00,"$80,555.29"
PayPal Fees,11/02/2023,Deposit,2W906350VU789682A,04 PAYPAL GENERAL UNRESTR,PayPal fees,OFFICE/GENERAL ADMINISTRATIVE EXPENSES:PayPal Fees,PayPal Bank 3,$1.09,"$80,556.38"
PayPal Bank 3,11/02/2023,Deposit,7U661067KJ601931P,04 PAYPAL GENERAL UNRESTR,Transaction ID: 7U661067KJ601931Phttps://www.paypal.com/activity/payment/7U661067KJ601931P,PayPal Bank 3,--,$9.26,"$80,565.64"
Donations directed by individuals,11/02/2023,Deposit,7U661067KJ601931P,04 PAYPAL GENERAL UNRESTR,Money in to PayPal,Contributed income:Donations directed by individuals,PayPal Bank 3,$10.10,"$80,575.74"
PayPal Fees,11/02/2023,Deposit,7U661067KJ601931P,04 PAYPAL GENERAL UNRESTR,PayPal fees,OFFICE/GENERAL ADMINISTRATIVE EXPENSES:PayPal Fees,PayPal Bank 3,$0.84,"$80,576.58"
PayPal Bank 3,11/02/2023,Deposit,4YW63917R52770155,04 PAYPAL GENERAL UNRESTR,Subject: GeneralPageTransaction ID: 4YW63917R52770155https://www.paypal.com/activity/payment/4YW63917R52770155,PayPal Bank 3,--,$49.23,"$80,625.81"
Donations directed by individuals,11/02/2023,Deposit,4YW63917R52770155,04 PAYPAL GENERAL UNRESTR,Support Ukraine - Support Ukraine,Contributed income:Donations directed by individuals,PayPal Bank 3,$51.52,"$80,677.33"
PayPal Fees,11/02/2023,Deposit,4YW63917R52770155,04 PAYPAL GENERAL UNRESTR,PayPal fees,OFFICE/GENERAL ADMINISTRATIVE EXPENSES:PayPal Fees,PayPal Bank 3,$2.29,"$80,679.62"
PayPal Bank 3,11/02/2023,Deposit,15N77228GU3923625,04 PAYPAL GENERAL UNRESTR,Subject: Support UkraineTransaction ID: 15N77228GU3923625https://www.paypal.com/activity/payment/15N77228GU3923625,PayPal Bank 3,--,$24.84,"$80,704.46"
Donations directed by individuals,11/02/2023,Deposit,15N77228GU3923625,04 PAYPAL GENERAL UNRESTR,Money in to PayPal,Contributed income:Donations directed by individuals,PayPal Bank 3,$26.25,"$80,730.71"
PayPal Fees,11/02/2023,Deposit,15N77228GU3923625,04 PAYPAL GENERAL UNRESTR,PayPal fees,OFFICE/GENERAL ADMINISTRATIVE EXPENSES:PayPal Fees,PayPal Bank 3,$1.41,"$80,732.12"
PayPal Bank 3,11/02/2023,Deposit,7YK59961TH5386249,04 PAYPAL GENERAL UNRESTR,Subject: Support UkraineTransaction ID: 7YK59961TH5386249https://www.paypal.com/activity/payment/7YK59961TH5386249,PayPal Bank 3,--,$9.93,"$80,742.05"
Donations directed by individuals,11/02/2023,Deposit,7YK59961TH5386249,04 PAYPAL GENERAL UNRESTR,Money in to PayPal,Contributed income:Donations directed by individuals,PayPal Bank 3,$10.80,"$80,752.85"
PayPal Fees,11/02/2023,Deposit,7YK59961TH5386249,04 PAYPAL GENERAL UNRESTR,PayPal fees,OFFICE/GENERAL ADMINISTRATIVE EXPENSES:PayPal Fees,PayPal Bank 3,$0.87,"$80,753.72"
PayPal Bank 3,11/02/2023,Deposit,85S717470H4882246,04 PAYPAL GENERAL UNRESTR,Subject: Support UkraineTransaction ID: 85S717470H4882246https://www.paypal.com/activity/payment/85S717470H4882246,PayPal Bank 3,--,$4.96,"$80,758.68"
Donations directed by individuals,11/02/2023,Deposit,85S717470H4882246,04 PAYPAL GENERAL UNRESTR,Money in to PayPal,Contributed income:Donations directed by individuals,PayPal Bank 3,$5.65,"$80,764.33"
PayPal Fees,11/02/2023,Deposit,85S717470H4882246,04 PAYPAL GENERAL UNRESTR,PayPal fees,OFFICE/GENERAL ADMINISTRATIVE EXPENSES:PayPal Fees,PayPal Bank 3,$0.69,"$80,765.02"
PayPal Bank 3,11/02/2023,Deposit,99R56875GM1784203,04 PAYPAL GENERAL UNRESTR,Subject: Support UkraineTransaction ID: 99R56875GM1784203https://www.paypal.com/activity/payment/99R56875GM1784203,PayPal Bank 3,--,$149.07,"$80,914.09"
Donations directed by individuals,11/02/2023,Deposit,99R56875GM1784203,04 PAYPAL GENERAL UNRESTR,Money in to PayPal,Contributed income:Donations directed by individuals,PayPal Bank 3,$154.97,"$81,069.06"
PayPal Fees,11/02/2023,Deposit,99R56875GM1784203,04 PAYPAL GENERAL UNRESTR,PayPal fees,OFFICE/GENERAL ADMINISTRATIVE EXPENSES:PayPal Fees,PayPal Bank 3,$5.90,"$81,074.96"
PayPal Bank 3,11/02/2023,Deposit,3L929648J9033535X,04 PAYPAL GENERAL UNRESTR,Subject: Support UkraineTransaction ID: 3L929648J9033535Xhttps://www.paypal.com/activity/payment/3L929648J9033535X,PayPal Bank 3,--,$50.47,"$81,125.43"
Donations directed by individuals,11/02/2023,Deposit,3L929648J9033535X,04 PAYPAL GENERAL UNRESTR,Money in to PayPal,Contributed income:Donations directed by individuals,PayPal Bank 3,$51.99,"$81,177.42"
PayPal Fees,11/02/2023,Deposit,3L929648J9033535X,04 PAYPAL GENERAL UNRESTR,PayPal fees,OFFICE/GENERAL ADMINISTRATIVE EXPENSES:PayPal Fees,PayPal Bank 3,$1.52,"$81,178.94"
PayPal Bank 3,11/02/2023,Deposit,5GK352464J189104X,09 MSU RESTR,Subject: MobileShowersTransaction ID: 5GK352464J189104Xhttps://www.paypal.com/activity/payment/5GK352464J189104X,PayPal Bank 3,--,$23.64,"$81,202.58"
Donations directed by individuals,11/02/2023,Deposit,5GK352464J189104X,09 MSU RESTR,Mobile Shower/Laundry Units - Mobile Shower/Laundry Units,Contributed income:Donations directed by individuals,PayPal Bank 3,$25.00,"$81,227.58"
PayPal Fees,11/02/2023,Deposit,5GK352464J189104X,09 MSU RESTR,PayPal fees,OFFICE/GENERAL ADMINISTRATIVE EXPENSES:PayPal Fees,PayPal Bank 3,$1.36,"$81,228.94"
PayPal Bank 3,11/02/2023,Deposit,1C634948SX448522N,10 Flight to Recovery RESTR,Subject: FlightToRecoveryTransaction ID: 1C634948SX448522Nhttps://www.paypal.com/activity/payment/1C634948SX448522N,PayPal Bank 3,--,$23.64,"$81,252.58"
Donations directed by individuals,11/02/2023,Deposit,1C634948SX448522N,10 Flight to Recovery RESTR,Flight to Recovery - Flight to Recovery,Contributed income:Donations directed by individuals,PayPal Bank 3,$25.00,"$81,277.58"
PayPal Fees,11/02/2023,Deposit,1C634948SX448522N,10 Flight to Recovery RESTR,PayPal fees,OFFICE/GENERAL ADMINISTRATIVE EXPENSES:PayPal Fees,PayPal Bank 3,$1.36,"$81,278.94"
PayPal Bank 3,11/02/2023,Deposit,72K60194K1937301F,07 1000 DRONES RESTR,Subject: 1000DRONESTransaction ID: 72K60194K1937301Fhttps://www.paypal.com/activity/payment/72K60194K1937301F,PayPal Bank 3,--,$18.81,"$81,297.75"
Donations directed by individuals,11/02/2023,Deposit,72K60194K1937301F,07 1000 DRONES RESTR,1000 DRONES FOR UKRAINE - 1000 DRONES FOR UKRAINE,Contributed income:Donations directed by individuals,PayPal Bank 3,$20.00,"$81,317.75"
PayPal Fees,11/02/2023,Deposit,72K60194K1937301F,07 1000 DRONES RESTR,PayPal fees,OFFICE/GENERAL ADMINISTRATIVE EXPENSES:PayPal Fees,PayPal Bank 3,$1.19,"$81,318.94"
PayPal Bank 3,11/02/2023,Deposit,6EH70229TY5439641,04 PAYPAL GENERAL UNRESTR,Subject: GeneralPageTransaction ID: 6EH70229TY5439641https://www.paypal.com/activity/payment/6EH70229TY5439641,PayPal Bank 3,--,$9.84,"$81,328.78"
Donations directed by individuals,11/02/2023,Deposit,6EH70229TY5439641,04 PAYPAL GENERAL UNRESTR,Support Ukraine - Support Ukraine,Contributed income:Donations directed by individuals,PayPal Bank 3,$10.70,"$81,339.48"
PayPal Fees,11/02/2023,Deposit,6EH70229TY5439641,04 PAYPAL GENERAL UNRESTR,PayPal fees,OFFICE/GENERAL ADMINISTRATIVE EXPENSES:PayPal Fees,PayPal Bank 3,$0.86,"$81,340.34"
PayPal Bank 3,11/02/2023,Deposit,3C335750BD6566450,04 PAYPAL GENERAL UNRESTR,Subject: Support UkraineTransaction ID: 3C335750BD6566450https://www.paypal.com/activity/payment/3C335750BD6566450,PayPal Bank 3,--,$99.38,"$81,439.72"
Donations directed by individuals,11/02/2023,Deposit,3C335750BD6566450,04 PAYPAL GENERAL UNRESTR,Money in to PayPal,Contributed income:Donations directed by individuals,PayPal Bank 3,$103.48,"$81,543.20"
PayPal Fees,11/02/2023,Deposit,3C335750BD6566450,04 PAYPAL GENERAL UNRESTR,PayPal fees,OFFICE/GENERAL ADMINISTRATIVE EXPENSES:PayPal Fees,PayPal Bank 3,$4.10,"$81,547.30"
PayPal Bank 3,11/02/2023,Deposit,9DB28584D5741060E,07 1000 DRONES RESTR,Subject: 1000DRONESTransaction ID: 9DB28584D5741060Ehttps://www.paypal.com/activity/payment/9DB28584D5741060E,PayPal Bank 3,--,$73.84,"$81,621.14"
Donations directed by individuals,11/02/2023,Deposit,9DB28584D5741060E,07 1000 DRONES RESTR,1000 DRONES FOR UKRAINE - 1000 DRONES FOR UKRAINE,Contributed income:Donations directed by individuals,PayPal Bank 3,$77.02,"$81,698.16"
PayPal Fees,11/02/2023,Deposit,9DB28584D5741060E,07 1000 DRONES RESTR,PayPal fees,OFFICE/GENERAL ADMINISTRATIVE EXPENSES:PayPal Fees,PayPal Bank 3,$3.18,"$81,701.34"
PayPal Bank 3,11/02/2023,Deposit,8VK47016YK379483K,04 PAYPAL GENERAL UNRESTR,Subject: Support UkraineTransaction ID: 8VK47016YK379483Khttps://www.paypal.com/activity/payment/8VK47016YK379483K,PayPal Bank 3,--,$9.84,"$81,711.18"
Donations directed by individuals,11/02/2023,Deposit,8VK47016YK379483K,04 PAYPAL GENERAL UNRESTR,Money in to PayPal,Contributed income:Donations directed by individuals,PayPal Bank 3,$10.70,"$81,721.88"
PayPal Fees,11/02/2023,Deposit,8VK47016YK379483K,04 PAYPAL GENERAL UNRESTR,PayPal fees,OFFICE/GENERAL ADMINISTRATIVE EXPENSES:PayPal Fees,PayPal Bank 3,$0.86,"$81,722.74"
PayPal Bank 3,10/31/2023,Transfer,--,--,ORIG CO NAME:PAYPAL ORIG ID:PAYPALSD11 DESC DATE:231030 CO ENTRY DESCR:TRANSFER SEC:PPD TRACE#:091000010304157 EED:231031 IND ID: IND NAME:DIGNITAS UKRAINE TRN: XXXXXX4157TC,PayPal Bank 3,CHASE ENDING IN 5315,"-$13,800.00","$67,922.74"
CHASE ENDING IN 5315,10/31/2023,Transfer,--,--,ORIG CO NAME:PAYPAL ORIG ID:PAYPALSD11 DESC DATE:231030 CO ENTRY DESCR:TRANSFER SEC:PPD TRACE#:091000010304157 EED:231031 IND ID: IND NAME:DIGNITAS UKRAINE TRN: XXXXXX4157TC,CHASE ENDING IN 5315,PayPal Bank 3,"$13,800.00","$81,722.74"
FIDELITY INVESTMENTS,10/31/2023,Journal Entry,2,--,--,FIDELITY INVESTMENTS,--,$536.35,"$82,259.09"
DIVIDENT RECEIVED FIDELITY,10/31/2023,Journal Entry,2,--,--,Investment income:DIVIDENT RECEIVED FIDELITY,--,$536.35,"$82,795.44"
FIDELITY INVESTMENTS,10/31/2023,Journal Entry,3,--,--,FIDELITY INVESTMENTS,--,"$1,242.65","$84,038.09"
DIVIDENT RECEIVED FIDELITY,10/31/2023,Journal Entry,3,--,--,Investment income:DIVIDENT RECEIVED FIDELITY,--,"$1,242.65","$85,280.74"
In-kind donations,10/31/2023,Journal Entry,11,--,A.BOYCHUK AMAZON WISH LIST,Contributed income:In-kind donations,--,$537.07,"$85,817.81"
IN-KIND DONATION DISTRIBUTIONS,10/31/2023,Journal Entry,11,--,A.BOYCHUK AMAZON WISH LIST,PROGRAM EXPENSES:IN-KIND DONATION DISTRIBUTIONS,--,$537.07,"$86,354.88"
FIVE % FOR ADMIN EXPENSES,10/31/2023,Journal Entry,13,--,--,Contributed income:FIVE % FOR ADMIN EXPENSES,--,"-$58,311.00","$28,043.88"
FIVE % FOR ADMIN EXPENSES,10/31/2023,Journal Entry,13,--,--,Contributed income:FIVE % FOR ADMIN EXPENSES,--,"$58,311.00","$86,354.88"
FIVE % FOR ADMIN EXPENSES,10/31/2023,Journal Entry,13,--,--,Contributed income:FIVE % FOR ADMIN EXPENSES,--,-$388.85,"$85,966.03"
FIVE % FOR ADMIN EXPENSES,10/31/2023,Journal Entry,13,--,--,Contributed income:FIVE % FOR ADMIN EXPENSES,--,$388.85,"$86,354.88"
FIVE % FOR ADMIN EXPENSES,10/31/2023,Journal Entry,13,--,--,Contributed income:FIVE % FOR ADMIN EXPENSES,--,"-$3,905.22","$82,449.66"
FIVE % FOR ADMIN EXPENSES,10/31/2023,Journal Entry,13,--,--,Contributed income:FIVE % FOR ADMIN EXPENSES,--,"$3,905.22","$86,354.88"
FIVE % FOR ADMIN EXPENSES,10/31/2023,Journal Entry,13,--,--,Contributed income:FIVE % FOR ADMIN EXPENSES,--,-$67.88,"$86,287.00"
FIVE % FOR ADMIN EXPENSES,10/31/2023,Journal Entry,13,--,--,Contributed income:FIVE % FOR ADMIN EXPENSES,--,$67.88,"$86,354.88"
FIVE % FOR ADMIN EXPENSES,10/31/2023,Journal Entry,13,--,--,Contributed income:FIVE % FOR ADMIN EXPENSES,--,$0.00,"$86,354.88"
FIVE % FOR ADMIN EXPENSES,10/31/2023,Journal Entry,13,--,--,Contributed income:FIVE % FOR ADMIN EXPENSES,--,$0.00,"$86,354.88"
FIVE % FOR ADMIN EXPENSES,10/31/2023,Journal Entry,13,--,--,Contributed income:FIVE % FOR ADMIN EXPENSES,--,-$681.00,"$85,673.88"
FIVE % FOR ADMIN EXPENSES,10/31/2023,Journal Entry,13,--,--,Contributed income:FIVE % FOR ADMIN EXPENSES,--,$681.00,"$86,354.88"
FIVE % FOR ADMIN EXPENSES,10/31/2023,Journal Entry,13,--,--,Contributed income:FIVE % FOR ADMIN EXPENSES,--,"-$17,679.00","$68,675.88"
FIVE % FOR ADMIN EXPENSES,10/31/2023,Journal Entry,13,--,--,Contributed income:FIVE % FOR ADMIN EXPENSES,--,"$17,679.00","$86,354.88"
FIVE % FOR ADMIN EXPENSES,10/31/2023,Journal Entry,13,--,--,Contributed income:FIVE % FOR ADMIN EXPENSES,--,-$44.00,"$86,310.88"
FIVE % FOR ADMIN EXPENSES,10/31/2023,Journal Entry,13,--,--,Contributed income:FIVE % FOR ADMIN EXPENSES,--,$44.00,"$86,354.88"
FIVE % FOR ADMIN EXPENSES,10/31/2023,Journal Entry,13,--,--,Contributed income:FIVE % FOR ADMIN EXPENSES,--,-$46.07,"$86,308.81"
FIVE % FOR ADMIN EXPENSES,10/31/2023,Journal Entry,13,--,--,Contributed income:FIVE % FOR ADMIN EXPENSES,--,$46.07,"$86,354.88"
FIVE % FOR ADMIN EXPENSES,10/31/2023,Journal Entry,13,--,--,Contributed income:FIVE % FOR ADMIN EXPENSES,--,-$41.00,"$86,313.88"
FIVE % FOR ADMIN EXPENSES,10/31/2023,Journal Entry,13,--,--,Contributed income:FIVE % FOR ADMIN EXPENSES,--,$41.00,"$86,354.88"
CHASE ENDING IN 5315,10/25/2023,Expense,--,01 ADMINISTRATIVE ACCOUNT,Zelle payment to Dmitri Zakhalyavko XXXXXXX1345,CHASE ENDING IN 5315,MALING AND DELIVERY,-$194.00,"$86,160.88"
MALING AND DELIVERY,10/25/2023,Expense,--,01 ADMINISTRATIVE ACCOUNT,Zelle payment to Dmitri Zakhalyavko XXXXXXX1345,OFFICE/GENERAL ADMINISTRATIVE EXPENSES:MALING AND DELIVERY,CHASE ENDING IN 5315,$194.00,"$86,354.88"
CHASE ENDING IN 5315,10/25/2023,Expense,--,03 FUNDRASING EVENTS UNRESTR,Zelle payment to Inna Collins JPM99a42sjyi,CHASE ENDING IN 5315,LODGING,"-$1,192.29","$85,162.59"
LODGING,10/25/2023,Expense,--,03 FUNDRASING EVENTS UNRESTR,Zelle payment to Inna Collins JPM99a42sjyi,FUNDRAISING EVENTS:LODGING,CHASE ENDING IN 5315,"$1,192.29","$86,354.88"
CHASE ENDING IN 5315,10/23/2023,Expense,--,08 VICTORY DRONES RESTR,ONLINE INTERNATIONAL WIRE TRANSFER A/C: JSC CB PRIVATBANK DNEPROPETROVSK UKRAINE X9094- UA REF: GRANT TRANCHE 1 PER OCT 23 AGREEMENT GIFT OR DONATION TRN: 36138 X3296ES 10/23,CHASE ENDING IN 5315,GRANTS,"-$238,000.00","-$151,645.12"
GRANTS,10/23/2023,Expense,--,08 VICTORY DRONES RESTR,ONLINE INTERNATIONAL WIRE TRANSFER A/C: JSC CB PRIVATBANK DNEPROPETROVSK UKRAINE X9094- UA REF: GRANT TRANCHE 1 PER OCT 23 AGREEMENT GIFT OR DONATION TRN: 36138 X3296ES 10/23,PROGRAM EXPENSES:GRANTS,CHASE ENDING IN 5315,"$238,000.00","$86,354.88"
FIDELITY INVESTMENTS,10/21/2023,Transfer,--,--,ORIG CO NAME:FID BKG SVC LLC ORIG ID:0368504603 DESC DATE:231023 CO ENTRY DESCR:MONEYLINE SEC:PPD TRACE#:091000017684992 EED:231023 IND ID: IND NAME:DIGNITAS UK RAINE INC TRN: XXXXXX4992 TC,FIDELITY INVESTMENTS,CHASE ENDING IN 5315,"-$200,000.00","-$113,645.12"
CHASE ENDING IN 5315,10/21/2023,Transfer,--,--,ORIG CO NAME:FID BKG SVC LLC ORIG ID:0368504603 DESC DATE:231023 CO ENTRY DESCR:MONEYLINE SEC:PPD TRACE#:091000017684992 EED:231023 IND ID: IND NAME:DIGNITAS UK RAINE INC TRN: XXXXXX4992 TC,CHASE ENDING IN 5315,FIDELITY INVESTMENTS,"$200,000.00","$86,354.88"
CHASE ENDING IN 5315,10/19/2023,Expense,--,07 1000 DRONES RESTR,"ONLINE DOMESTIC WIRE TRANSFER VIA: AMERANT BANK, N.A./XXXXXXXXX A/C: DRONE NERDS INC FT. LAUDERDALE FL XXXXX US REF: INV. ESTXXXXXXXXX AS OF XX/XX/23 - 50 CP.MA .XXXXXXXX.XX DJI MAVIC X PR O (DJI RC) (NA) IMAD: XXXXMMQFMPXKXXXXXX TRN: XXXXXXXXXXES 10/19",CHASE ENDING IN 5315,DRONE PURCHASES,"-$95,000.00","-$8,645.12"
DRONE PURCHASES,10/19/2023,Expense,--,07 1000 DRONES RESTR,"ONLINE DOMESTIC WIRE TRANSFER VIA: AMERANT BANK, N.A./XXXXXXXXX A/C: DRONE NERDS INC FT. LAUDERDALE FL XXXXX US REF: INV. ESTXXXXXXXXX AS OF XX/XX/23 - 50 CP.MA .XXXXXXXX.XX DJI MAVIC X PR O (DJI RC) (NA) IMAD: XXXXMMQFMPXKXXXXXX TRN: XXXXXXXXXXES 10/19",PROGRAM EXPENSES:DRONE PURCHASES,CHASE ENDING IN 5315,"$95,000.00","$86,354.88"
CHASE ENDING IN 5315,10/19/2023,Deposit,1,02 GENERAL BANK URESTR,REMOTE ONLINE DEPOSIT # 1,CHASE ENDING IN 5315,Donations directed by individuals,$222.50,"$86,577.38"
Donations directed by individuals,10/19/2023,Deposit,1,02 GENERAL BANK URESTR,REMOTE ONLINE DEPOSIT # 1,Contributed income:Donations directed by individuals,CHASE ENDING IN 5315,$222.50,"$86,799.88"
CHASE ENDING IN 5315,10/19/2023,Deposit,1,02 GENERAL BANK URESTR,REMOTE ONLINE DEPOSIT # 1,CHASE ENDING IN 5315,Donations directed by individuals,$300.00,"$87,099.88"
Donations directed by individuals,10/19/2023,Deposit,1,02 GENERAL BANK URESTR,REMOTE ONLINE DEPOSIT # 1,Contributed income:Donations directed by individuals,CHASE ENDING IN 5315,$300.00,"$87,399.88"
TRANSFERS DIRECTED BY BOARD,10/19/2023,Journal Entry,17,--,--,Contributed income:TRANSFERS DIRECTED BY BOARD,--,"-$95,000.00","-$7,600.12"
TRANSFERS DIRECTED BY BOARD,10/19/2023,Journal Entry,17,--,--,Contributed income:TRANSFERS DIRECTED BY BOARD,--,"$95,000.00","$87,399.88"
CHASE ENDING IN 5315,10/17/2023,Expense,--,08 VICTORY DRONES RESTR,ONLINE INTERNATIONAL WIRE TRANSFER VIA: DEUTSCHE BANK TRUST COMPANY/XXXX A/C: UNIVERSAL BANK JSC KIEV UKRAINE X4114 UA BEN: CO CHARITABLE FOUNDATION DIGNITAS KY IV UA REF: TECHNOLOGY GRANT FROM DIGNITAS UKRAINE INC GIFT OR DONATION SSN: XXXXXXX TRN: XXXXXXXXXXES 10/17,CHASE ENDING IN 5315,GRANTS,"-$333,000.00","-$245,600.12"
GRANTS,10/17/2023,Expense,--,08 VICTORY DRONES RESTR,ONLINE INTERNATIONAL WIRE TRANSFER VIA: DEUTSCHE BANK TRUST COMPANY/XXXX A/C: UNIVERSAL BANK JSC KIEV UKRAINE X4114 UA BEN: CO CHARITABLE FOUNDATION DIGNITAS KY IV UA REF: TECHNOLOGY GRANT FROM DIGNITAS UKRAINE INC GIFT OR DONATION SSN: XXXXXXX TRN: XXXXXXXXXXES 10/17,PROGRAM EXPENSES:GRANTS,CHASE ENDING IN 5315,"$333,000.00","$87,399.88"
TRANSFERS DIRECTED BY BOARD,10/17/2023,Journal Entry,18,--,--,Contributed income:TRANSFERS DIRECTED BY BOARD,--,"-$333,000.00","-$245,600.12"
TRANSFERS DIRECTED BY BOARD,10/17/2023,Journal Entry,18,--,--,Contributed income:TRANSFERS DIRECTED BY BOARD,--,"$333,000.00","$87,399.88"
CHASE ENDING IN 5315,10/15/2023,Deposit,--,02 GENERAL BANK URESTR,Zelle payment from OLEKSIY PIKHMANETS XXXXXXX2688,CHASE ENDING IN 5315,Donations directed by individuals,$100.00,"$87,499.88"
Donations directed by individuals,10/15/2023,Deposit,--,02 GENERAL BANK URESTR,Zelle payment from OLEKSIY PIKHMANETS XXXXXXX2688,Contributed income:Donations directed by individuals,CHASE ENDING IN 5315,$100.00,"$87,599.88"
CHASE ENDING IN 5315,10/13/2023,Expense,--,QuickBooks Payments,ORIG CO NAME:INTUIT * ORIG ID:XXXXXXXXXX DESC DATE:XXXXXX CO ENTRY DESCR:QBooks OnlSEC:CCD TRACE#:XXXXXXXXXXXXXXX EED:XXXXXX IND ID:XXX8632 IND NAME:DIGNITAS UK RAINE INC XXX-XXX-XXXX TRN: XXXXXX8121TC,CHASE ENDING IN 5315,Software & apps,-$85.00,"$87,514.88"
Software & apps,10/13/2023,Expense,--,QuickBooks Payments,ORIG CO NAME:INTUIT * ORIG ID:XXXXXXXXXX DESC DATE:XXXXXX CO ENTRY DESCR:QBooks OnlSEC:CCD TRACE#:XXXXXXXXXXXXXXX EED:XXXXXX IND ID:XXX8632 IND NAME:DIGNITAS UK RAINE INC XXX-XXX-XXXX TRN: XXXXXX8121TC,OFFICE/GENERAL ADMINISTRATIVE EXPENSES:Software & apps,CHASE ENDING IN 5315,$85.00,"$87,599.88"
CHASE ENDING IN 5315,10/12/2023,Deposit,--,08 VICTORY DRONES RESTR,"FEDWIRE CREDIT VIA: WELLS FARGO BANK, N.A./XXXXXXXXX B/O: SCHWAB CHARITABLE FUND SAN FRANCISCO CA X4105/US/REF: CHASE NYC/CTR/BNF=DIGNITAS UKRAINE INC CRANFORD NJ XXXXX-XXXX US/AC-XX XXXXXXXXXX RFB=XXXXXXXXXXXXX OBI=SC HWAB CHARITABLE FUND VICTORY DRON E S PROJECT BBI=/CHGS/USDX,XX/CHGS/US DX,XX/OCMT/USDX IMAD: XXXXIXBXXXXRXXXXXX TRN: XXXXXX0285FF",CHASE ENDING IN 5315,Donations directed by individuals,"$350,000.00","$437,599.88"
Donations directed by individuals,10/12/2023,Deposit,--,08 VICTORY DRONES RESTR,"FEDWIRE CREDIT VIA: WELLS FARGO BANK, N.A./XXXXXXXXX B/O: SCHWAB CHARITABLE FUND SAN FRANCISCO CA X4105/US/REF: CHASE NYC/CTR/BNF=DIGNITAS UKRAINE INC CRANFORD NJ XXXXX-XXXX US/AC-XX XXXXXXXXXX RFB=XXXXXXXXXXXXX OBI=SC HWAB CHARITABLE FUND VICTORY DRON E S PROJECT BBI=/CHGS/USDX,XX/CHGS/US DX,XX/OCMT/USDX IMAD: XXXXIXBXXXXRXXXXXX TRN: XXXXXX0285FF",Contributed income:Donations directed by individuals,CHASE ENDING IN 5315,"$350,000.00","$787,599.88"
CHASE ENDING IN 5315,10/12/2023,Transfer,--,--,ORIG CO NAME:FID BKG SVC LLC ORIG ID:XXXXXXXXXX DESC DATE:XXXXXX CO ENTRY DESCR:MONEYLINE SEC:PPD TRACE#:XXXXXXXXXXXXXXX EED:XX1012 IND ID: IND NAME:DIGNITAS UK RAINE INC TRN: XXXXXX9483TC,CHASE ENDING IN 5315,FIDELITY INVESTMENTS,"-$200,000.00","$587,599.88"
FIDELITY INVESTMENTS,10/12/2023,Transfer,--,--,ORIG CO NAME:FID BKG SVC LLC ORIG ID:XXXXXXXXXX DESC DATE:XXXXXX CO ENTRY DESCR:MONEYLINE SEC:PPD TRACE#:XXXXXXXXXXXXXXX EED:XX1012 IND ID: IND NAME:DIGNITAS UK RAINE INC TRN: XXXXXX9483TC,FIDELITY INVESTMENTS,CHASE ENDING IN 5315,"$200,000.00","$787,599.88"
CHASE ENDING IN 5315,10/12/2023,Deposit,--,02 GENERAL BANK URESTR,Zelle payment from VIKTORIYA SUKMANOVA BACk4eea03d6,CHASE ENDING IN 5315,Donations directed by individuals,"$3,000.00","$790,599.88"
Donations directed by individuals,10/12/2023,Deposit,--,02 GENERAL BANK URESTR,Zelle payment from VIKTORIYA SUKMANOVA BACk4eea03d6,Contributed income:Donations directed by individuals,CHASE ENDING IN 5315,"$3,000.00","$793,599.88"
CHASE ENDING IN 5315,10/10/2023,Transfer,--,--,ORIG CO NAME:FID BKG SVC LLC ORIG ID:XXXXXXXXXX DESC DATE:XXXXXX CO ENTRY DESCR:MONEYLINE SEC:PPD TRACE#:XXXXXXXXXXXXXXX EED:XX1010 IND ID: IND NAME:DIGNITAS UK RAINE INC TRN: XXXXXX6952TC,CHASE ENDING IN 5315,FIDELITY INVESTMENTS,"-$250,000.00","$543,599.88"
FIDELITY INVESTMENTS,10/10/2023,Transfer,--,--,ORIG CO NAME:FID BKG SVC LLC ORIG ID:XXXXXXXXXX DESC DATE:XXXXXX CO ENTRY DESCR:MONEYLINE SEC:PPD TRACE#:XXXXXXXXXXXXXXX EED:XX1010 IND ID: IND NAME:DIGNITAS UK RAINE INC TRN: XXXXXX6952TC,FIDELITY INVESTMENTS,CHASE ENDING IN 5315,"$250,000.00","$793,599.88"
PayPal Bank 3,10/09/2023,Deposit,49914332AA4286211,04 PAYPAL GENERAL UNRESTR,"Subject: GeneralPage
Transaction ID: 49914332AA4286211
https://www.paypal.com/activity/payment/49914332AA4286211",PayPal Bank 3,--,$50.00,"$793,649.88"
Donations directed by individuals,10/09/2023,Deposit,49914332AA4286211,04 PAYPAL GENERAL UNRESTR,Support Ukraine - Support Ukraine,Contributed income:Donations directed by individuals,PayPal Bank 3,$51.52,"$793,701.40"
PayPal Fees,10/09/2023,Deposit,49914332AA4286211,04 PAYPAL GENERAL UNRESTR,PayPal fees,OFFICE/GENERAL ADMINISTRATIVE EXPENSES:PayPal Fees,PayPal Bank 3,$1.52,"$793,702.92"
PayPal Bank 3,10/09/2023,Deposit,72D21145VH751883H,04 PAYPAL GENERAL UNRESTR,"Subject: GeneralPage
Transaction ID: 72D21145VH751883H
https://www.paypal.com/activity/payment/72D21145VH751883H",PayPal Bank 3,--,$49.23,"$793,752.15"
Donations directed by individuals,10/09/2023,Deposit,72D21145VH751883H,04 PAYPAL GENERAL UNRESTR,Support Ukraine - Support Ukraine,Contributed income:Donations directed by individuals,PayPal Bank 3,$51.52,"$793,803.67"
PayPal Fees,10/09/2023,Deposit,72D21145VH751883H,04 PAYPAL GENERAL UNRESTR,PayPal fees,OFFICE/GENERAL ADMINISTRATIVE EXPENSES:PayPal Fees,PayPal Bank 3,$2.29,"$793,805.96"
PayPal Bank 3,10/09/2023,Deposit,9P883830TX7239227,04 PAYPAL GENERAL UNRESTR,"Subject: Support Ukraine
Transaction ID: 9P883830TX7239227
https://www.paypal.com/activity/payment/9P883830TX7239227",PayPal Bank 3,--,$4.34,"$793,810.30"
Donations directed by individuals,10/09/2023,Deposit,9P883830TX7239227,04 PAYPAL GENERAL UNRESTR,Money in to PayPal,Contributed income:Donations directed by individuals,PayPal Bank 3,$5.00,"$793,815.30"
PayPal Fees,10/09/2023,Deposit,9P883830TX7239227,04 PAYPAL GENERAL UNRESTR,PayPal fees,OFFICE/GENERAL ADMINISTRATIVE EXPENSES:PayPal Fees,PayPal Bank 3,$0.66,"$793,815.96"
PayPal Bank 3,10/09/2023,Deposit,7YF22952RS173584L,04 PAYPAL GENERAL UNRESTR,"Subject: GeneralPage
Transaction ID: 7YF22952RS173584L
https://www.paypal.com/activity/payment/7YF22952RS173584L",PayPal Bank 3,--,$4.34,"$793,820.30"
Donations directed by individuals,10/09/2023,Deposit,7YF22952RS173584L,04 PAYPAL GENERAL UNRESTR,Support Ukraine - Support Ukraine,Contributed income:Donations directed by individuals,PayPal Bank 3,$5.00,"$793,825.30"
PayPal Fees,10/09/2023,Deposit,7YF22952RS173584L,04 PAYPAL GENERAL UNRESTR,PayPal fees,OFFICE/GENERAL ADMINISTRATIVE EXPENSES:PayPal Fees,PayPal Bank 3,$0.66,"$793,825.96"
PayPal Bank 3,10/09/2023,Deposit,3A538931GE813994V,04 PAYPAL GENERAL UNRESTR,"Subject: GeneralPage
Transaction ID: 3A538931GE813994V
https://www.paypal.com/activity/payment/3A538931GE813994V",PayPal Bank 3,--,$50.00,"$793,875.96"
Donations directed by individuals,10/09/2023,Deposit,3A538931GE813994V,04 PAYPAL GENERAL UNRESTR,Support Ukraine - Support Ukraine,Contributed income:Donations directed by individuals,PayPal Bank 3,$51.52,"$793,927.48"
PayPal Fees,10/09/2023,Deposit,3A538931GE813994V,04 PAYPAL GENERAL UNRESTR,PayPal fees,OFFICE/GENERAL ADMINISTRATIVE EXPENSES:PayPal Fees,PayPal Bank 3,$1.52,"$793,929.00"
PayPal Bank 3,10/06/2023,Deposit,13371471XW630393P,04 PAYPAL GENERAL UNRESTR,"Subject: Support Ukraine
Transaction ID: 13371471XW630393P
https://www.paypal.com/activity/payment/13371471XW630393P",PayPal Bank 3,--,$149.07,"$794,078.07"
Donations directed by individuals,10/06/2023,Deposit,13371471XW630393P,04 PAYPAL GENERAL UNRESTR,Money in to PayPal,Contributed income:Donations directed by individuals,PayPal Bank 3,$154.97,"$794,233.04"
PayPal Fees,10/06/2023,Deposit,13371471XW630393P,04 PAYPAL GENERAL UNRESTR,PayPal fees,OFFICE/GENERAL ADMINISTRATIVE EXPENSES:PayPal Fees,PayPal Bank 3,$5.90,"$794,238.94"
PayPal Bank 3,10/06/2023,Deposit,2YB50501K7466601E,04 PAYPAL GENERAL UNRESTR,"Subject: Support Ukraine
Transaction ID: 2YB50501K7466601E
https://www.paypal.com/activity/payment/2YB50501K7466601E",PayPal Bank 3,--,$99.38,"$794,338.32"
Donations directed by individuals,10/06/2023,Deposit,2YB50501K7466601E,04 PAYPAL GENERAL UNRESTR,Money in to PayPal,Contributed income:Donations directed by individuals,PayPal Bank 3,$103.48,"$794,441.80"
PayPal Fees,10/06/2023,Deposit,2YB50501K7466601E,04 PAYPAL GENERAL UNRESTR,PayPal fees,OFFICE/GENERAL ADMINISTRATIVE EXPENSES:PayPal Fees,PayPal Bank 3,$4.10,"$794,445.90"
PayPal Bank 3,10/06/2023,Deposit,8TA99837R83648149,04 PAYPAL GENERAL UNRESTR,"Subject: GeneralPage
Transaction ID: 8TA99837R83648149
https://www.paypal.com/activity/payment/8TA99837R83648149",PayPal Bank 3,--,$96.02,"$794,541.92"
Donations directed by individuals,10/06/2023,Deposit,8TA99837R83648149,04 PAYPAL GENERAL UNRESTR,Support Ukraine - Support Ukraine,Contributed income:Donations directed by individuals,PayPal Bank 3,$100.00,"$794,641.92"
PayPal Fees,10/06/2023,Deposit,8TA99837R83648149,04 PAYPAL GENERAL UNRESTR,PayPal fees,OFFICE/GENERAL ADMINISTRATIVE EXPENSES:PayPal Fees,PayPal Bank 3,$3.98,"$794,645.90"
PayPal Bank 3,10/06/2023,Deposit,3WP790486K383190A,04 PAYPAL GENERAL UNRESTR,"Subject: GeneralPage
Note: Fron Darius, Diana, Ingrid ( Lökholmens camping)
Transaction ID: 3WP790486K383190A
https://www.paypal.com/activity/payment/3WP790486K383190A",PayPal Bank 3,--,$9.16,"$794,655.06"
Donations directed by individuals,10/06/2023,Deposit,3WP790486K383190A,04 PAYPAL GENERAL UNRESTR,Support Ukraine - Support Ukraine,Contributed income:Donations directed by individuals,PayPal Bank 3,$10.00,"$794,665.06"
PayPal Fees,10/06/2023,Deposit,3WP790486K383190A,04 PAYPAL GENERAL UNRESTR,PayPal fees,OFFICE/GENERAL ADMINISTRATIVE EXPENSES:PayPal Fees,PayPal Bank 3,$0.84,"$794,665.90"
PayPal Bank 3,10/06/2023,Deposit,41U5260073657862W,04 PAYPAL GENERAL UNRESTR,"Subject: GeneralPage
Transaction ID: 41U5260073657862W
https://www.paypal.com/activity/payment/41U5260073657862W",PayPal Bank 3,--,$9.84,"$794,675.74"
Donations directed by individuals,10/06/2023,Deposit,41U5260073657862W,04 PAYPAL GENERAL UNRESTR,Support Ukraine - Support Ukraine,Contributed income:Donations directed by individuals,PayPal Bank 3,$10.70,"$794,686.44"
PayPal Fees,10/06/2023,Deposit,41U5260073657862W,04 PAYPAL GENERAL UNRESTR,PayPal fees,OFFICE/GENERAL ADMINISTRATIVE EXPENSES:PayPal Fees,PayPal Bank 3,$0.86,"$794,687.30"
PayPal Bank 3,10/06/2023,Deposit,1WT66652GL233633T,04 PAYPAL GENERAL UNRESTR,"Subject: Support Ukraine
Transaction ID: 1WT66652GL233633T
https://www.paypal.com/activity/payment/1WT66652GL233633T",PayPal Bank 3,--,$195.53,"$794,882.83"
Donations directed by individuals,10/06/2023,Deposit,1WT66652GL233633T,04 PAYPAL GENERAL UNRESTR,Money in to PayPal,Contributed income:Donations directed by individuals,PayPal Bank 3,$200.00,"$795,082.83"
PayPal Fees,10/06/2023,Deposit,1WT66652GL233633T,04 PAYPAL GENERAL UNRESTR,PayPal fees,OFFICE/GENERAL ADMINISTRATIVE EXPENSES:PayPal Fees,PayPal Bank 3,$4.47,"$795,087.30"
PayPal Bank 3,10/06/2023,Deposit,1M5621673X3210631,04 PAYPAL GENERAL UNRESTR,"Subject: GeneralPage
Transaction ID: 1M5621673X3210631
https://www.paypal.com/activity/payment/1M5621673X3210631",PayPal Bank 3,--,$14.76,"$795,102.06"
Donations directed by individuals,10/06/2023,Deposit,1M5621673X3210631,04 PAYPAL GENERAL UNRESTR,Support Ukraine - Support Ukraine,Contributed income:Donations directed by individuals,PayPal Bank 3,$15.80,"$795,117.86"
PayPal Fees,10/06/2023,Deposit,1M5621673X3210631,04 PAYPAL GENERAL UNRESTR,PayPal fees,OFFICE/GENERAL ADMINISTRATIVE EXPENSES:PayPal Fees,PayPal Bank 3,$1.04,"$795,118.90"
PayPal Bank 3,10/06/2023,Deposit,1YB664012B5073058,07 1000 DRONES RESTR,"Subject: 1000 DRONES FOR UKRAINE
Transaction ID: 1YB664012B5073058
https://www.paypal.com/activity/payment/1YB664012B5073058",PayPal Bank 3,--,$24.84,"$795,143.74"
Donations directed by individuals,10/06/2023,Deposit,1YB664012B5073058,07 1000 DRONES RESTR,Money in to PayPal,Contributed income:Donations directed by individuals,PayPal Bank 3,$26.25,"$795,169.99"
PayPal Fees,10/06/2023,Deposit,1YB664012B5073058,07 1000 DRONES RESTR,PayPal fees,OFFICE/GENERAL ADMINISTRATIVE EXPENSES:PayPal Fees,PayPal Bank 3,$1.41,"$795,171.40"
PayPal Bank 3,10/06/2023,Deposit,0G0631147K014701R,04 PAYPAL GENERAL UNRESTR,"Subject: GeneralPage
Transaction ID: 0G0631147K014701R
https://www.paypal.com/activity/payment/0G0631147K014701R",PayPal Bank 3,--,$24.61,"$795,196.01"
Donations directed by individuals,10/06/2023,Deposit,0G0631147K014701R,04 PAYPAL GENERAL UNRESTR,Support Ukraine - Support Ukraine,Contributed income:Donations directed by individuals,PayPal Bank 3,$26.01,"$795,222.02"
PayPal Fees,10/06/2023,Deposit,0G0631147K014701R,04 PAYPAL GENERAL UNRESTR,PayPal fees,OFFICE/GENERAL ADMINISTRATIVE EXPENSES:PayPal Fees,PayPal Bank 3,$1.40,"$795,223.42"
PayPal Bank 3,10/06/2023,Deposit,29B68876P1835363X,04 PAYPAL GENERAL UNRESTR,"Subject: GeneralPage
Transaction ID: 29B68876P1835363X
https://www.paypal.com/activity/payment/29B68876P1835363X",PayPal Bank 3,--,$115.32,"$795,338.74"
Donations directed by individuals,10/06/2023,Deposit,29B68876P1835363X,04 PAYPAL GENERAL UNRESTR,Support Ukraine - Support Ukraine,Contributed income:Donations directed by individuals,PayPal Bank 3,$120.00,"$795,458.74"
PayPal Fees,10/06/2023,Deposit,29B68876P1835363X,04 PAYPAL GENERAL UNRESTR,PayPal fees,OFFICE/GENERAL ADMINISTRATIVE EXPENSES:PayPal Fees,PayPal Bank 3,$4.68,"$795,463.42"
PayPal Bank 3,10/06/2023,Deposit,3VD53658HT7684012,04 PAYPAL GENERAL UNRESTR,"Subject: GeneralPage
Transaction ID: 3VD53658HT7684012
https://www.paypal.com/activity/payment/3VD53658HT7684012",PayPal Bank 3,--,$4.91,"$795,468.33"
Donations directed by individuals,10/06/2023,Deposit,3VD53658HT7684012,04 PAYPAL GENERAL UNRESTR,Support Ukraine - Support Ukraine,Contributed income:Donations directed by individuals,PayPal Bank 3,$5.60,"$795,473.93"
PayPal Fees,10/06/2023,Deposit,3VD53658HT7684012,04 PAYPAL GENERAL UNRESTR,PayPal fees,OFFICE/GENERAL ADMINISTRATIVE EXPENSES:PayPal Fees,PayPal Bank 3,$0.69,"$795,474.62"
PayPal Bank 3,10/06/2023,Deposit,3MF06902BN644390H,10 Flight to Recovery RESTR,"Subject: FlightToRecovery
Note: СЛАВА УКРАЇНІ!
Transaction ID: 3MF06902BN644390H
https://www.paypal.com/activity/payment/3MF06902BN644390H",PayPal Bank 3,--,$20.00,"$795,494.62"
Donations directed by individuals,10/06/2023,Deposit,3MF06902BN644390H,10 Flight to Recovery RESTR,Flight to Recovery - Flight to Recovery,Contributed income:Donations directed by individuals,PayPal Bank 3,$20.91,"$795,515.53"
PayPal Fees,10/06/2023,Deposit,3MF06902BN644390H,10 Flight to Recovery RESTR,PayPal fees,OFFICE/GENERAL ADMINISTRATIVE EXPENSES:PayPal Fees,PayPal Bank 3,$0.91,"$795,516.44"
PayPal Bank 3,10/06/2023,Deposit,64U393605P607673C,09 MSU RESTR,"Subject: MobileShowers
Note: СЛАВА УКРАЇНІ
Transaction ID: 64U393605P607673C
https://www.paypal.com/activity/payment/64U393605P607673C",PayPal Bank 3,--,$20.00,"$795,536.44"
Donations directed by individuals,10/06/2023,Deposit,64U393605P607673C,09 MSU RESTR,Mobile Shower/Laundry Units - Mobile Shower/Laundry Units,Contributed income:Donations directed by individuals,PayPal Bank 3,$20.91,"$795,557.35"
PayPal Fees,10/06/2023,Deposit,64U393605P607673C,09 MSU RESTR,PayPal fees,OFFICE/GENERAL ADMINISTRATIVE EXPENSES:PayPal Fees,PayPal Bank 3,$0.91,"$795,558.26"
PayPal Bank 3,10/06/2023,Deposit,2FS369040T8671054,04 PAYPAL GENERAL UNRESTR,"Subject: GeneralPage
Transaction ID: 2FS369040T8671054
https://www.paypal.com/activity/payment/2FS369040T8671054",PayPal Bank 3,--,$9.84,"$795,568.10"
Donations directed by individuals,10/06/2023,Deposit,2FS369040T8671054,04 PAYPAL GENERAL UNRESTR,Support Ukraine - Support Ukraine,Contributed income:Donations directed by individuals,PayPal Bank 3,$10.70,"$795,578.80"
PayPal Fees,10/06/2023,Deposit,2FS369040T8671054,04 PAYPAL GENERAL UNRESTR,PayPal fees,OFFICE/GENERAL ADMINISTRATIVE EXPENSES:PayPal Fees,PayPal Bank 3,$0.86,"$795,579.66"
PayPal Bank 3,10/06/2023,Deposit,6N5554683N991981B,04 PAYPAL GENERAL UNRESTR,"Subject: GeneralPage
Transaction ID: 6N5554683N991981B
https://www.paypal.com/activity/payment/6N5554683N991981B",PayPal Bank 3,--,$30.00,"$795,609.66"
Donations directed by individuals,10/06/2023,Deposit,6N5554683N991981B,04 PAYPAL GENERAL UNRESTR,Support Ukraine - Support Ukraine,Contributed income:Donations directed by individuals,PayPal Bank 3,$31.11,"$795,640.77"
PayPal Fees,10/06/2023,Deposit,6N5554683N991981B,04 PAYPAL GENERAL UNRESTR,PayPal fees,OFFICE/GENERAL ADMINISTRATIVE EXPENSES:PayPal Fees,PayPal Bank 3,$1.11,"$795,641.88"
PayPal Bank 3,10/06/2023,Deposit,8FK84065J7757604N,08 VICTORY DRONES RESTR,"Subject: VictoryDrones
Transaction ID: 8FK84065J7757604N
https://www.paypal.com/activity/payment/8FK84065J7757604N",PayPal Bank 3,--,$73.36,"$795,715.24"
Donations directed by individuals,10/06/2023,Deposit,8FK84065J7757604N,08 VICTORY DRONES RESTR,VICTORY DRONES - VICTORY DRONES,Contributed income:Donations directed by individuals,PayPal Bank 3,$76.52,"$795,791.76"
PayPal Fees,10/06/2023,Deposit,8FK84065J7757604N,08 VICTORY DRONES RESTR,PayPal fees,OFFICE/GENERAL ADMINISTRATIVE EXPENSES:PayPal Fees,PayPal Bank 3,$3.16,"$795,794.92"
PayPal Bank 3,10/06/2023,Deposit,9079734432947634P,04 PAYPAL GENERAL UNRESTR,"Subject: GeneralPage
Transaction ID: 9079734432947634P
https://www.paypal.com/activity/payment/9079734432947634P",PayPal Bank 3,--,$39.38,"$795,834.30"
Donations directed by individuals,10/06/2023,Deposit,9079734432947634P,04 PAYPAL GENERAL UNRESTR,Support Ukraine - Support Ukraine,Contributed income:Donations directed by individuals,PayPal Bank 3,$41.31,"$795,875.61"
PayPal Fees,10/06/2023,Deposit,9079734432947634P,04 PAYPAL GENERAL UNRESTR,PayPal fees,OFFICE/GENERAL ADMINISTRATIVE EXPENSES:PayPal Fees,PayPal Bank 3,$1.93,"$795,877.54"
PayPal Bank 3,10/06/2023,Deposit,3HF44206FF592251E,04 PAYPAL GENERAL UNRESTR,"Subject: GeneralPage
Transaction ID: 3HF44206FF592251E
https://www.paypal.com/activity/payment/3HF44206FF592251E",PayPal Bank 3,--,$25.00,"$795,902.54"
Donations directed by individuals,10/06/2023,Deposit,3HF44206FF592251E,04 PAYPAL GENERAL UNRESTR,Support Ukraine - Support Ukraine,Contributed income:Donations directed by individuals,PayPal Bank 3,$26.01,"$795,928.55"
PayPal Fees,10/06/2023,Deposit,3HF44206FF592251E,04 PAYPAL GENERAL UNRESTR,PayPal fees,OFFICE/GENERAL ADMINISTRATIVE EXPENSES:PayPal Fees,PayPal Bank 3,$1.01,"$795,929.56"
PayPal Bank 3,10/06/2023,Deposit,0UA81861TJ921284B,04 PAYPAL GENERAL UNRESTR,"Subject: GeneralPage
Transaction ID: 0UA81861TJ921284B
https://www.paypal.com/activity/payment/0UA81861TJ921284B",PayPal Bank 3,--,$25.00,"$795,954.56"
Donations directed by individuals,10/06/2023,Deposit,0UA81861TJ921284B,04 PAYPAL GENERAL UNRESTR,Support Ukraine - Support Ukraine,Contributed income:Donations directed by individuals,PayPal Bank 3,$26.01,"$795,980.57"
PayPal Fees,10/06/2023,Deposit,0UA81861TJ921284B,04 PAYPAL GENERAL UNRESTR,PayPal fees,OFFICE/GENERAL ADMINISTRATIVE EXPENSES:PayPal Fees,PayPal Bank 3,$1.01,"$795,981.58"
PayPal Bank 3,10/06/2023,Deposit,8Y564603EG284122W,04 PAYPAL GENERAL UNRESTR,"Subject: GeneralPage
Transaction ID: 8Y564603EG284122W
https://www.paypal.com/activity/payment/8Y564603EG284122W",PayPal Bank 3,--,$9.84,"$795,991.42"
Donations directed by individuals,10/06/2023,Deposit,8Y564603EG284122W,04 PAYPAL GENERAL UNRESTR,Support Ukraine - Support Ukraine,Contributed income:Donations directed by individuals,PayPal Bank 3,$10.70,"$796,002.12"
PayPal Fees,10/06/2023,Deposit,8Y564603EG284122W,04 PAYPAL GENERAL UNRESTR,PayPal fees,OFFICE/GENERAL ADMINISTRATIVE EXPENSES:PayPal Fees,PayPal Bank 3,$0.86,"$796,002.98"
PayPal Bank 3,10/06/2023,Deposit,70711173HX5878602,07 1000 DRONES RESTR,"Subject: 1000 DRONES FOR UKRAINE
Transaction ID: 70711173HX5878602
https://www.paypal.com/activity/payment/70711173HX5878602",PayPal Bank 3,--,$10.93,"$796,013.91"
Donations directed by individuals,10/06/2023,Deposit,70711173HX5878602,07 1000 DRONES RESTR,Money in to PayPal,Contributed income:Donations directed by individuals,PayPal Bank 3,$11.83,"$796,025.74"
PayPal Fees,10/06/2023,Deposit,70711173HX5878602,07 1000 DRONES RESTR,PayPal fees,OFFICE/GENERAL ADMINISTRATIVE EXPENSES:PayPal Fees,PayPal Bank 3,$0.90,"$796,026.64"
PayPal Bank 3,10/06/2023,Deposit,9HD47019FN445034S,04 PAYPAL GENERAL UNRESTR,"Subject: Support Ukraine
Transaction ID: 9HD47019FN445034S
https://www.paypal.com/activity/payment/9HD47019FN445034S",PayPal Bank 3,--,$11.92,"$796,038.56"
Donations directed by individuals,10/06/2023,Deposit,9HD47019FN445034S,04 PAYPAL GENERAL UNRESTR,Money in to PayPal,Contributed income:Donations directed by individuals,PayPal Bank 3,$12.86,"$796,051.42"
PayPal Fees,10/06/2023,Deposit,9HD47019FN445034S,04 PAYPAL GENERAL UNRESTR,PayPal fees,OFFICE/GENERAL ADMINISTRATIVE EXPENSES:PayPal Fees,PayPal Bank 3,$0.94,"$796,052.36"
PayPal Bank 3,10/06/2023,Deposit,7CG63270BC895810W,04 PAYPAL GENERAL UNRESTR,"Subject: GeneralPage
Transaction ID: 7CG63270BC895810W
https://www.paypal.com/activity/payment/7CG63270BC895810W",PayPal Bank 3,--,$73.84,"$796,126.20"
Donations directed by individuals,10/06/2023,Deposit,7CG63270BC895810W,04 PAYPAL GENERAL UNRESTR,Support Ukraine - Support Ukraine,Contributed income:Donations directed by individuals,PayPal Bank 3,$77.02,"$796,203.22"
PayPal Fees,10/06/2023,Deposit,7CG63270BC895810W,04 PAYPAL GENERAL UNRESTR,PayPal fees,OFFICE/GENERAL ADMINISTRATIVE EXPENSES:PayPal Fees,PayPal Bank 3,$3.18,"$796,206.40"
PayPal Bank 3,10/06/2023,Deposit,60F70806L3230683H,04 PAYPAL GENERAL UNRESTR,"Subject: GeneralPage
Transaction ID: 60F70806L3230683H
https://www.paypal.com/activity/payment/60F70806L3230683H",PayPal Bank 3,--,$24.61,"$796,231.01"
Donations directed by individuals,10/06/2023,Deposit,60F70806L3230683H,04 PAYPAL GENERAL UNRESTR,Support Ukraine - Support Ukraine,Contributed income:Donations directed by individuals,PayPal Bank 3,$26.01,"$796,257.02"
PayPal Fees,10/06/2023,Deposit,60F70806L3230683H,04 PAYPAL GENERAL UNRESTR,PayPal fees,OFFICE/GENERAL ADMINISTRATIVE EXPENSES:PayPal Fees,PayPal Bank 3,$1.40,"$796,258.42"
PayPal Bank 3,10/06/2023,Deposit,0Y979730AK376702X,07 1000 DRONES RESTR,"Subject: 1000DRONES
Transaction ID: 0Y979730AK376702X
https://www.paypal.com/activity/payment/0Y979730AK376702X",PayPal Bank 3,--,$59.08,"$796,317.50"
Donations directed by individuals,10/06/2023,Deposit,0Y979730AK376702X,07 1000 DRONES RESTR,1000 DRONES FOR UKRAINE - 1000 DRONES FOR UKRAINE,Contributed income:Donations directed by individuals,PayPal Bank 3,$61.72,"$796,379.22"
PayPal Fees,10/06/2023,Deposit,0Y979730AK376702X,07 1000 DRONES RESTR,PayPal fees,OFFICE/GENERAL ADMINISTRATIVE EXPENSES:PayPal Fees,PayPal Bank 3,$2.64,"$796,381.86"
PayPal Bank 3,10/06/2023,Deposit,07L17239C11267153,04 PAYPAL GENERAL UNRESTR,"Subject: Support Ukraine
Transaction ID: 07L17239C11267153
https://www.paypal.com/activity/payment/07L17239C11267153",PayPal Bank 3,--,$98.46,"$796,480.32"
Donations directed by individuals,10/06/2023,Deposit,07L17239C11267153,04 PAYPAL GENERAL UNRESTR,Money in to PayPal,Contributed income:Donations directed by individuals,PayPal Bank 3,$102.53,"$796,582.85"
PayPal Fees,10/06/2023,Deposit,07L17239C11267153,04 PAYPAL GENERAL UNRESTR,PayPal fees,OFFICE/GENERAL ADMINISTRATIVE EXPENSES:PayPal Fees,PayPal Bank 3,$4.07,"$796,586.92"
PayPal Bank 3,10/06/2023,Deposit,81K10605TX798593C,04 PAYPAL GENERAL UNRESTR,"Subject: Support Ukraine
Transaction ID: 81K10605TX798593C
https://www.paypal.com/activity/payment/81K10605TX798593C",PayPal Bank 3,--,$50.00,"$796,636.92"
Donations directed by individuals,10/06/2023,Deposit,81K10605TX798593C,04 PAYPAL GENERAL UNRESTR,Money in to PayPal,Contributed income:Donations directed by individuals,PayPal Bank 3,$51.52,"$796,688.44"
PayPal Fees,10/06/2023,Deposit,81K10605TX798593C,04 PAYPAL GENERAL UNRESTR,PayPal fees,OFFICE/GENERAL ADMINISTRATIVE EXPENSES:PayPal Fees,PayPal Bank 3,$1.52,"$796,689.96"
PayPal Bank 3,10/06/2023,Deposit,2JY17594YE816890E,04 PAYPAL GENERAL UNRESTR,"Subject: Support Ukraine
Transaction ID: 2JY17594YE816890E
https://www.paypal.com/activity/payment/2JY17594YE816890E",PayPal Bank 3,--,$29.81,"$796,719.77"
Donations directed by individuals,10/06/2023,Deposit,2JY17594YE816890E,04 PAYPAL GENERAL UNRESTR,Money in to PayPal,Contributed income:Donations directed by individuals,PayPal Bank 3,$31.40,"$796,751.17"
PayPal Fees,10/06/2023,Deposit,2JY17594YE816890E,04 PAYPAL GENERAL UNRESTR,PayPal fees,OFFICE/GENERAL ADMINISTRATIVE EXPENSES:PayPal Fees,PayPal Bank 3,$1.59,"$796,752.76"
PayPal Bank 3,10/06/2023,Deposit,95227448BU160871B,04 PAYPAL GENERAL UNRESTR,"Subject: GeneralPage
Transaction ID: 95227448BU160871B
https://www.paypal.com/activity/payment/95227448BU160871B",PayPal Bank 3,--,$49.23,"$796,801.99"
Donations directed by individuals,10/06/2023,Deposit,95227448BU160871B,04 PAYPAL GENERAL UNRESTR,Support Ukraine - Support Ukraine,Contributed income:Donations directed by individuals,PayPal Bank 3,$51.52,"$796,853.51"
PayPal Fees,10/06/2023,Deposit,95227448BU160871B,04 PAYPAL GENERAL UNRESTR,PayPal fees,OFFICE/GENERAL ADMINISTRATIVE EXPENSES:PayPal Fees,PayPal Bank 3,$2.29,"$796,855.80"
PayPal Bank 3,10/06/2023,Deposit,2HY73635J7523481F,10 Flight to Recovery RESTR,"Subject: Dignitas Ukraine Flight to Recovery
Transaction ID: 2HY73635J7523481F
https://www.paypal.com/activity/payment/2HY73635J7523481F",PayPal Bank 3,--,$99.38,"$796,955.18"
Donations directed by individuals,10/06/2023,Deposit,2HY73635J7523481F,10 Flight to Recovery RESTR,Money in to PayPal,Contributed income:Donations directed by individuals,PayPal Bank 3,$103.48,"$797,058.66"
PayPal Fees,10/06/2023,Deposit,2HY73635J7523481F,10 Flight to Recovery RESTR,PayPal fees,OFFICE/GENERAL ADMINISTRATIVE EXPENSES:PayPal Fees,PayPal Bank 3,$4.10,"$797,062.76"
PayPal Bank 3,10/06/2023,Deposit,8TN91901YV958901S,08 VICTORY DRONES RESTR,"Subject: VICTORY DRONES
Transaction ID: 8TN91901YV958901S
https://www.paypal.com/activity/payment/8TN91901YV958901S",PayPal Bank 3,--,$99.38,"$797,162.14"
Donations directed by individuals,10/06/2023,Deposit,8TN91901YV958901S,08 VICTORY DRONES RESTR,Money in to PayPal,Contributed income:Donations directed by individuals,PayPal Bank 3,$103.48,"$797,265.62"
PayPal Fees,10/06/2023,Deposit,8TN91901YV958901S,08 VICTORY DRONES RESTR,PayPal fees,OFFICE/GENERAL ADMINISTRATIVE EXPENSES:PayPal Fees,PayPal Bank 3,$4.10,"$797,269.72"
PayPal Bank 3,10/06/2023,Deposit,1TL88269D20726502,10 Flight to Recovery RESTR,"Subject: Dignitas Ukraine Flight to Recovery
Transaction ID: 1TL88269D20726502
https://www.paypal.com/activity/payment/1TL88269D20726502",PayPal Bank 3,--,$50.47,"$797,320.19"
Donations directed by individuals,10/06/2023,Deposit,1TL88269D20726502,10 Flight to Recovery RESTR,Money in to PayPal,Contributed income:Donations directed by individuals,PayPal Bank 3,$51.99,"$797,372.18"
PayPal Fees,10/06/2023,Deposit,1TL88269D20726502,10 Flight to Recovery RESTR,PayPal fees,OFFICE/GENERAL ADMINISTRATIVE EXPENSES:PayPal Fees,PayPal Bank 3,$1.52,"$797,373.70"
PayPal Bank 3,10/06/2023,Deposit,7SN816120S185782D,04 PAYPAL GENERAL UNRESTR,"Subject: GeneralPage
Transaction ID: 7SN816120S185782D
https://www.paypal.com/activity/payment/7SN816120S185782D",PayPal Bank 3,--,$9.16,"$797,382.86"
Donations directed by individuals,10/06/2023,Deposit,7SN816120S185782D,04 PAYPAL GENERAL UNRESTR,Support Ukraine - Support Ukraine,Contributed income:Donations directed by individuals,PayPal Bank 3,$10.00,"$797,392.86"
PayPal Fees,10/06/2023,Deposit,7SN816120S185782D,04 PAYPAL GENERAL UNRESTR,PayPal fees,OFFICE/GENERAL ADMINISTRATIVE EXPENSES:PayPal Fees,PayPal Bank 3,$0.84,"$797,393.70"
PayPal Bank 3,10/06/2023,Deposit,5L103940S93154639,07 1000 DRONES RESTR,"Subject: 1000DRONES
Transaction ID: 5L103940S93154639
https://www.paypal.com/activity/payment/5L103940S93154639",PayPal Bank 3,--,$157.55,"$797,551.25"
Donations directed by individuals,10/06/2023,Deposit,5L103940S93154639,07 1000 DRONES RESTR,1000 DRONES FOR UKRAINE - 1000 DRONES FOR UKRAINE,Contributed income:Donations directed by individuals,PayPal Bank 3,$163.75,"$797,715.00"
PayPal Fees,10/06/2023,Deposit,5L103940S93154639,07 1000 DRONES RESTR,PayPal fees,OFFICE/GENERAL ADMINISTRATIVE EXPENSES:PayPal Fees,PayPal Bank 3,$6.20,"$797,721.20"
PayPal Bank 3,10/06/2023,Deposit,0V235272S0047003D,07 1000 DRONES RESTR,"Subject: 1000DRONES
Note: Thank you ALL! Keep up the support!
Transaction ID: 0V235272S0047003D
https://www.paypal.com/activity/payment/0V235272S0047003D",PayPal Bank 3,--,$146.52,"$797,867.72"
Donations directed by individuals,10/06/2023,Deposit,0V235272S0047003D,07 1000 DRONES RESTR,1000 DRONES FOR UKRAINE - 1000 DRONES FOR UKRAINE,Contributed income:Donations directed by individuals,PayPal Bank 3,$150.00,"$798,017.72"
PayPal Fees,10/06/2023,Deposit,0V235272S0047003D,07 1000 DRONES RESTR,PayPal fees,OFFICE/GENERAL ADMINISTRATIVE EXPENSES:PayPal Fees,PayPal Bank 3,$3.48,"$798,021.20"
PayPal Bank 3,10/06/2023,Deposit,49B50059KD722792P,04 PAYPAL GENERAL UNRESTR,Subject: GeneralPageTransaction ID: 49B50059KD722792Phttps://www.paypal.com/activity/payment/49B50059KD722792P,PayPal Bank 3,--,$25.00,"$798,046.20"
Donations directed by individuals,10/06/2023,Deposit,49B50059KD722792P,04 PAYPAL GENERAL UNRESTR,Support Ukraine - Support Ukraine,Contributed income:Donations directed by individuals,PayPal Bank 3,$26.01,"$798,072.21"
PayPal Fees,10/06/2023,Deposit,49B50059KD722792P,04 PAYPAL GENERAL UNRESTR,PayPal fees,OFFICE/GENERAL ADMINISTRATIVE EXPENSES:PayPal Fees,PayPal Bank 3,$1.01,"$798,073.22"
CHASE ENDING IN 5315,10/06/2023,Transfer,--,--,ORIG CO NAME:FID BKG SVC LLC ORIG ID:XXXXXXXXXX DESC DATE:XXXXXX CO ENTRY DESCR:MONEYLINE SEC:PPD TRACE#:XXXXXXXXXXXXXXX EED:XX1006 IND ID: IND NAME:DIGNITAS UK RAINE INC TRN: XXXXXX7570TC,CHASE ENDING IN 5315,FIDELITY INVESTMENTS,"-$250,000.00","$548,073.22"
FIDELITY INVESTMENTS,10/06/2023,Transfer,--,--,ORIG CO NAME:FID BKG SVC LLC ORIG ID:XXXXXXXXXX DESC DATE:XXXXXX CO ENTRY DESCR:MONEYLINE SEC:PPD TRACE#:XXXXXXXXXXXXXXX EED:XX1006 IND ID: IND NAME:DIGNITAS UK RAINE INC TRN: XXXXXX7570TC,FIDELITY INVESTMENTS,CHASE ENDING IN 5315,"$250,000.00","$798,073.22"
CHASE ENDING IN 5315,10/05/2023,Deposit,--,02 GENERAL BANK URESTR,Zelle payment from GENNADIY ARNAUTOV TDP0HYMFG136,CHASE ENDING IN 5315,Donations directed by individuals,$25.00,"$798,098.22"
Donations directed by individuals,10/05/2023,Deposit,--,02 GENERAL BANK URESTR,Zelle payment from GENNADIY ARNAUTOV TDP0HYMFG136,Contributed income:Donations directed by individuals,CHASE ENDING IN 5315,$25.00,"$798,123.22"
PayPal Bank 3,10/04/2023,Deposit,8UB77367SK7916420,04 PAYPAL GENERAL UNRESTR,"Subject: GeneralPage
Transaction ID: 8UB77367SK7916420
https://www.paypal.com/activity/payment/8UB77367SK7916420",PayPal Bank 3,--,$98.46,"$798,221.68"
Donations directed by individuals,10/04/2023,Deposit,8UB77367SK7916420,04 PAYPAL GENERAL UNRESTR,Support Ukraine - Support Ukraine,Contributed income:Donations directed by individuals,PayPal Bank 3,$102.53,"$798,324.21"
PayPal Fees,10/04/2023,Deposit,8UB77367SK7916420,04 PAYPAL GENERAL UNRESTR,PayPal fees,OFFICE/GENERAL ADMINISTRATIVE EXPENSES:PayPal Fees,PayPal Bank 3,$4.07,"$798,328.28"
PayPal Bank 3,10/04/2023,Deposit,2GL82116B84895933,04 PAYPAL GENERAL UNRESTR,"Subject: Support Ukraine
Transaction ID: 2GL82116B84895933
https://www.paypal.com/activity/payment/2GL82116B84895933",PayPal Bank 3,--,$19.87,"$798,348.15"
Donations directed by individuals,10/04/2023,Deposit,2GL82116B84895933,04 PAYPAL GENERAL UNRESTR,Money in to PayPal,Contributed income:Donations directed by individuals,PayPal Bank 3,$21.10,"$798,369.25"
PayPal Fees,10/04/2023,Deposit,2GL82116B84895933,04 PAYPAL GENERAL UNRESTR,PayPal fees,OFFICE/GENERAL ADMINISTRATIVE EXPENSES:PayPal Fees,PayPal Bank 3,$1.23,"$798,370.48"
PayPal Bank 3,10/04/2023,Deposit,1C847891668213910,08 VICTORY DRONES RESTR,"Subject: VICTORY DRONES
Transaction ID: 1C847891668213910
https://www.paypal.com/activity/payment/1C847891668213910",PayPal Bank 3,--,$100.93,"$798,471.41"
Donations directed by individuals,10/04/2023,Deposit,1C847891668213910,08 VICTORY DRONES RESTR,Money in to PayPal,Contributed income:Donations directed by individuals,PayPal Bank 3,$103.48,"$798,574.89"
PayPal Fees,10/04/2023,Deposit,1C847891668213910,08 VICTORY DRONES RESTR,PayPal fees,OFFICE/GENERAL ADMINISTRATIVE EXPENSES:PayPal Fees,PayPal Bank 3,$2.55,"$798,577.44"
PayPal Bank 3,10/04/2023,Deposit,31M82972VY684153P,04 PAYPAL GENERAL UNRESTR,"Subject: Support Ukraine
Transaction ID: 31M82972VY684153P
https://www.paypal.com/activity/payment/31M82972VY684153P",PayPal Bank 3,--,$9.93,"$798,587.37"
Donations directed by individuals,10/04/2023,Deposit,31M82972VY684153P,04 PAYPAL GENERAL UNRESTR,Money in to PayPal,Contributed income:Donations directed by individuals,PayPal Bank 3,$10.80,"$798,598.17"
PayPal Fees,10/04/2023,Deposit,31M82972VY684153P,04 PAYPAL GENERAL UNRESTR,PayPal fees,OFFICE/GENERAL ADMINISTRATIVE EXPENSES:PayPal Fees,PayPal Bank 3,$0.87,"$798,599.04"
PayPal Bank 3,10/04/2023,Deposit,3LG69821WL3915036,04 PAYPAL GENERAL UNRESTR,"Subject: Support Ukraine
Transaction ID: 3LG69821WL3915036
https://www.paypal.com/activity/payment/3LG69821WL3915036",PayPal Bank 3,--,$4.96,"$798,604.00"
Donations directed by individuals,10/04/2023,Deposit,3LG69821WL3915036,04 PAYPAL GENERAL UNRESTR,Money in to PayPal,Contributed income:Donations directed by individuals,PayPal Bank 3,$5.65,"$798,609.65"
PayPal Fees,10/04/2023,Deposit,3LG69821WL3915036,04 PAYPAL GENERAL UNRESTR,PayPal fees,OFFICE/GENERAL ADMINISTRATIVE EXPENSES:PayPal Fees,PayPal Bank 3,$0.69,"$798,610.34"
PayPal Bank 3,10/04/2023,Deposit,22W96765050430402,04 PAYPAL GENERAL UNRESTR,"Subject: Support Ukraine
Transaction ID: 22W96765050430402
https://www.paypal.com/activity/payment/22W96765050430402",PayPal Bank 3,--,$24.84,"$798,635.18"
Donations directed by individuals,10/04/2023,Deposit,22W96765050430402,04 PAYPAL GENERAL UNRESTR,Money in to PayPal,Contributed income:Donations directed by individuals,PayPal Bank 3,$26.25,"$798,661.43"
PayPal Fees,10/04/2023,Deposit,22W96765050430402,04 PAYPAL GENERAL UNRESTR,PayPal fees,OFFICE/GENERAL ADMINISTRATIVE EXPENSES:PayPal Fees,PayPal Bank 3,$1.41,"$798,662.84"
PayPal Bank 3,10/04/2023,Deposit,9YJ688102A636461U,04 PAYPAL GENERAL UNRESTR,"Subject: Support Ukraine
Transaction ID: 9YJ688102A636461U
https://www.paypal.com/activity/payment/9YJ688102A636461U",PayPal Bank 3,--,$50.47,"$798,713.31"
Donations directed by individuals,10/04/2023,Deposit,9YJ688102A636461U,04 PAYPAL GENERAL UNRESTR,Money in to PayPal,Contributed income:Donations directed by individuals,PayPal Bank 3,$51.99,"$798,765.30"
PayPal Fees,10/04/2023,Deposit,9YJ688102A636461U,04 PAYPAL GENERAL UNRESTR,PayPal fees,OFFICE/GENERAL ADMINISTRATIVE EXPENSES:PayPal Fees,PayPal Bank 3,$1.52,"$798,766.82"
PayPal Bank 3,09/29/2023,Transfer,--,--,ORIG CO NAME:PAYPAL ORIG ID:PAYPALSDXX DESC DATE:XXXXXX CO ENTRY DESCR:TRANSFER SEC:PPD TRACE#:XXXXXXXXXXXXXXX EED:XX0929 IND ID: IND NAME:DIGNITAS UKRAINE TRN: XXXXXX0912TC,PayPal Bank 3,CHASE ENDING IN 5315,"-$8,000.00","$790,766.82"
CHASE ENDING IN 5315,09/29/2023,Transfer,--,--,ORIG CO NAME:PAYPAL ORIG ID:PAYPALSDXX DESC DATE:XXXXXX CO ENTRY DESCR:TRANSFER SEC:PPD TRACE#:XXXXXXXXXXXXXXX EED:XX0929 IND ID: IND NAME:DIGNITAS UKRAINE TRN: XXXXXX0912TC,CHASE ENDING IN 5315,PayPal Bank 3,"$8,000.00","$798,766.82"
PayPal Bank 3,09/28/2023,Deposit,4FM8074579510841C,07 1000 DRONES RESTR,"Subject: 1000DRONES
Transaction ID: 4FM8074579510841C
https://www.paypal.com/activity/payment/4FM8074579510841C",PayPal Bank 3,--,$97.52,"$798,864.34"
Donations directed by individuals,09/28/2023,Deposit,4FM8074579510841C,07 1000 DRONES RESTR,1000 DRONES FOR UKRAINE - 1000 DRONES FOR UKRAINE,Contributed income:Donations directed by individuals,PayPal Bank 3,$100.00,"$798,964.34"
PayPal Fees,09/28/2023,Deposit,4FM8074579510841C,07 1000 DRONES RESTR,PayPal fees,OFFICE/GENERAL ADMINISTRATIVE EXPENSES:PayPal Fees,PayPal Bank 3,$2.48,"$798,966.82"
CHASE ENDING IN 5315,09/28/2023,Expense,--,02 GENERAL BANK URESTR,"ONLINE INTERNATIONAL WIRE TRANSFER A/C: FOREIGN CUR BUS ACCT BK X COLUMBUS NEWARK DE XXXXXXXXX US ORG: XXXXXXXXXXXXXXXXX DIGNITAS UKRAINE INC BEN:/LVXXPARXX0232 XXXXXXXX SIA RMAUTO REF: CAR FOR DIGNITAS INVOICE PAYMENT/OCMT/EURXXXX,XX/EXCH/X.XXXX/CNTR/XXXX XXXX/ACC/CAR FOR DIGNITAS TRN: XXXXXXXXXXRE 09/28",CHASE ENDING IN 5315,CAR PURCHASES,"-$6,474.59","$792,492.23"
CAR PURCHASES,09/28/2023,Expense,--,02 GENERAL BANK URESTR,"ONLINE INTERNATIONAL WIRE TRANSFER A/C: FOREIGN CUR BUS ACCT BK X COLUMBUS NEWARK DE XXXXXXXXX US ORG: XXXXXXXXXXXXXXXXX DIGNITAS UKRAINE INC BEN:/LVXXPARXX0232 XXXXXXXX SIA RMAUTO REF: CAR FOR DIGNITAS INVOICE PAYMENT/OCMT/EURXXXX,XX/EXCH/X.XXXX/CNTR/XXXX XXXX/ACC/CAR FOR DIGNITAS TRN: XXXXXXXXXXRE 09/28",PROGRAM EXPENSES:CAR PURCHASES,CHASE ENDING IN 5315,"$6,474.59","$798,966.82"
PayPal Bank 3,09/27/2023,Deposit,9TM37747X54100303,04 PAYPAL GENERAL UNRESTR,"Subject: GeneralPage
Transaction ID: 9TM37747X54100303
https://www.paypal.com/activity/payment/9TM37747X54100303",PayPal Bank 3,--,$4.91,"$798,971.73"
Donations directed by individuals,09/27/2023,Deposit,9TM37747X54100303,04 PAYPAL GENERAL UNRESTR,Support Ukraine - Support Ukraine,Contributed income:Donations directed by individuals,PayPal Bank 3,$5.60,"$798,977.33"
PayPal Fees,09/27/2023,Deposit,9TM37747X54100303,04 PAYPAL GENERAL UNRESTR,PayPal fees,OFFICE/GENERAL ADMINISTRATIVE EXPENSES:PayPal Fees,PayPal Bank 3,$0.69,"$798,978.02"
CHASE ENDING IN 5315,09/26/2023,Deposit,1,02 GENERAL BANK URESTR,REMOTE ONLINE DEPOSIT # 1,CHASE ENDING IN 5315,Donations directed by individuals,"$1,000.00","$799,978.02"
Donations directed by individuals,09/26/2023,Deposit,1,02 GENERAL BANK URESTR,REMOTE ONLINE DEPOSIT # 1,Contributed income:Donations directed by individuals,CHASE ENDING IN 5315,"$1,000.00","$800,978.02"
PayPal Bank 3,09/25/2023,Deposit,4XL61521SP408000J,09 MSU RESTR,"Subject: MobileShowers
Transaction ID: 4XL61521SP408000J
https://www.paypal.com/activity/payment/4XL61521SP408000J",PayPal Bank 3,--,$10.00,"$800,988.02"
Donations directed by individuals,09/25/2023,Deposit,4XL61521SP408000J,09 MSU RESTR,Mobile Shower/Laundry Units - Mobile Shower/Laundry Units,Contributed income:Donations directed by individuals,PayPal Bank 3,$10.70,"$800,998.72"
PayPal Fees,09/25/2023,Deposit,4XL61521SP408000J,09 MSU RESTR,PayPal fees,OFFICE/GENERAL ADMINISTRATIVE EXPENSES:PayPal Fees,PayPal Bank 3,$0.70,"$800,999.42"
CHASE ENDING IN 5315,09/25/2023,Deposit,1,02 GENERAL BANK URESTR,REMOTE ONLINE DEPOSIT # 1,CHASE ENDING IN 5315,Donations directed by individuals,"$15,000.00","$815,999.42"
Donations directed by individuals,09/25/2023,Deposit,1,02 GENERAL BANK URESTR,REMOTE ONLINE DEPOSIT # 1,Contributed income:Donations directed by individuals,CHASE ENDING IN 5315,"$15,000.00","$830,999.42"
CHASE ENDING IN 5315,09/25/2023,Deposit,1,02 GENERAL BANK URESTR,REMOTE ONLINE DEPOSIT # 1,CHASE ENDING IN 5315,Donations directed by individuals,$145.00,"$831,144.42"
Donations directed by individuals,09/25/2023,Deposit,1,02 GENERAL BANK URESTR,REMOTE ONLINE DEPOSIT # 1,Contributed income:Donations directed by individuals,CHASE ENDING IN 5315,$145.00,"$831,289.42"
CHASE ENDING IN 5315,09/25/2023,Deposit,1,02 GENERAL BANK URESTR,REMOTE ONLINE DEPOSIT # 1,CHASE ENDING IN 5315,Donations directed by individuals,$100.00,"$831,389.42"
Donations directed by individuals,09/25/2023,Deposit,1,02 GENERAL BANK URESTR,REMOTE ONLINE DEPOSIT # 1,Contributed income:Donations directed by individuals,CHASE ENDING IN 5315,$100.00,"$831,489.42"
PayPal Bank 3,09/24/2023,Deposit,7M796382MN365154A,10 Flight to Recovery RESTR,"Subject: Flight to Recovery
Transaction ID: 7M796382MN365154A
https://www.paypal.com/activity/payment/7M796382MN365154A",PayPal Bank 3,--,$50.00,"$831,539.42"
Donations directed by individuals,09/24/2023,Deposit,7M796382MN365154A,10 Flight to Recovery RESTR,Money in to PayPal,Contributed income:Donations directed by individuals,PayPal Bank 3,$51.52,"$831,590.94"
PayPal Fees,09/24/2023,Deposit,7M796382MN365154A,10 Flight to Recovery RESTR,PayPal fees,OFFICE/GENERAL ADMINISTRATIVE EXPENSES:PayPal Fees,PayPal Bank 3,$1.52,"$831,592.46"
PayPal Bank 3,09/24/2023,Deposit,8NE88802WA9924733,07 1000 DRONES RESTR,"Subject: 1000DRONES
Transaction ID: 8NE88802WA9924733
https://www.paypal.com/activity/payment/8NE88802WA9924733",PayPal Bank 3,--,$97.52,"$831,689.98"
Donations directed by individuals,09/24/2023,Deposit,8NE88802WA9924733,07 1000 DRONES RESTR,1000 DRONES FOR UKRAINE - 1000 DRONES FOR UKRAINE,Contributed income:Donations directed by individuals,PayPal Bank 3,$100.00,"$831,789.98"
PayPal Fees,09/24/2023,Deposit,8NE88802WA9924733,07 1000 DRONES RESTR,PayPal fees,OFFICE/GENERAL ADMINISTRATIVE EXPENSES:PayPal Fees,PayPal Bank 3,$2.48,"$831,792.46"
PayPal Bank 3,09/24/2023,Deposit,1UH573584J5864809,08 VICTORY DRONES RESTR,"Subject: VictoryDrones
Transaction ID: 1UH573584J5864809
https://www.paypal.com/activity/payment/1UH573584J5864809",PayPal Bank 3,--,$100.00,"$831,892.46"
Donations directed by individuals,09/24/2023,Deposit,1UH573584J5864809,08 VICTORY DRONES RESTR,VICTORY DRONES - VICTORY DRONES,Contributed income:Donations directed by individuals,PayPal Bank 3,$102.53,"$831,994.99"
PayPal Fees,09/24/2023,Deposit,1UH573584J5864809,08 VICTORY DRONES RESTR,PayPal fees,OFFICE/GENERAL ADMINISTRATIVE EXPENSES:PayPal Fees,PayPal Bank 3,$2.53,"$831,997.52"
PayPal Bank 3,09/24/2023,Deposit,0A817348YU943472D,07 1000 DRONES RESTR,"Subject: 1000DRONES
Note: Слава Україні !
Transaction ID: 0A817348YU943472D
https://www.paypal.com/activity/payment/0A817348YU943472D",PayPal Bank 3,--,$492.34,"$832,489.86"
Donations directed by individuals,09/24/2023,Deposit,0A817348YU943472D,07 1000 DRONES RESTR,1000 DRONES FOR UKRAINE - 1000 DRONES FOR UKRAINE,Contributed income:Donations directed by individuals,PayPal Bank 3,$510.65,"$833,000.51"
PayPal Fees,09/24/2023,Deposit,0A817348YU943472D,07 1000 DRONES RESTR,PayPal fees,OFFICE/GENERAL ADMINISTRATIVE EXPENSES:PayPal Fees,PayPal Bank 3,$18.31,"$833,018.82"
PayPal Bank 3,09/24/2023,Deposit,3BS11949HT7609146,04 PAYPAL GENERAL UNRESTR,"Subject: GeneralPage
Transaction ID: 3BS11949HT7609146
https://www.paypal.com/activity/payment/3BS11949HT7609146",PayPal Bank 3,--,$300.00,"$833,318.82"
Donations directed by individuals,09/24/2023,Deposit,3BS11949HT7609146,04 PAYPAL GENERAL UNRESTR,Support Ukraine - Support Ukraine,Contributed income:Donations directed by individuals,PayPal Bank 3,$306.59,"$833,625.41"
PayPal Fees,09/24/2023,Deposit,3BS11949HT7609146,04 PAYPAL GENERAL UNRESTR,PayPal fees,OFFICE/GENERAL ADMINISTRATIVE EXPENSES:PayPal Fees,PayPal Bank 3,$6.59,"$833,632.00"
PayPal Bank 3,09/24/2023,Deposit,3KP38498MG0543408,11 VETERANIUS RESTR,"Subject: Veteranius
Transaction ID: 3KP38498MG0543408
https://www.paypal.com/activity/payment/3KP38498MG0543408",PayPal Bank 3,--,$29.53,"$833,661.53"
Donations directed by individuals,09/24/2023,Deposit,3KP38498MG0543408,11 VETERANIUS RESTR,Veteranius - helping veterans to learn and gain experience in IT. - Veteranius - helping veterans to learn and gain experience in IT.,Contributed income:Donations directed by individuals,PayPal Bank 3,$31.11,"$833,692.64"
PayPal Fees,09/24/2023,Deposit,3KP38498MG0543408,11 VETERANIUS RESTR,PayPal fees,OFFICE/GENERAL ADMINISTRATIVE EXPENSES:PayPal Fees,PayPal Bank 3,$1.58,"$833,694.22"
CHASE ENDING IN 5315,09/24/2023,Expense,--,02 GENERAL BANK URESTR,Zelle payment to Gadzhi Kuliev JPM99a2kmzdd,CHASE ENDING IN 5315,TRANSPORTATION AND PARKING,-$134.00,"$833,560.22"
TRANSPORTATION AND PARKING,09/24/2023,Expense,--,02 GENERAL BANK URESTR,Zelle payment to Gadzhi Kuliev JPM99a2kmzdd,FUNDRAISING EVENTS:TRANSPORTATION AND PARKING,CHASE ENDING IN 5315,$134.00,"$833,694.22"
CHASE ENDING IN 5315,09/24/2023,Expense,--,02 GENERAL BANK URESTR,Zelle payment to Maryna Akatova XXXXXXX1512,CHASE ENDING IN 5315,--,-$262.27,"$833,431.95"
EVENTS PARTICIPATION EXPENSES,09/24/2023,Expense,--,02 GENERAL BANK URESTR,Zelle payment to Maryna Akatova XXXXXXX1512,FUNDRAISING EVENTS:EVENTS PARTICIPATION EXPENSES,CHASE ENDING IN 5315,$210.00,"$833,641.95"
SUPPLIES AND MATERIALS,09/24/2023,Expense,--,02 GENERAL BANK URESTR,Zelle payment to Maryna Akatova XXXXXXX1512,FUNDRAISING EVENTS:SUPPLIES AND MATERIALS,CHASE ENDING IN 5315,$52.27,"$833,694.22"
CHASE ENDING IN 5315,09/24/2023,Expense,--,02 GENERAL BANK URESTR,Zelle payment to Oksana Patrina XXXXXXX9663,CHASE ENDING IN 5315,--,-$552.87,"$833,141.35"
SUPPLIES AND MATERIALS,09/24/2023,Expense,--,02 GENERAL BANK URESTR,Serduchka Hat  Zelle payment to Oksana Patrina XXXXXXX9663,FUNDRAISING EVENTS:SUPPLIES AND MATERIALS,CHASE ENDING IN 5315,$502.00,"$833,643.35"
SUPPLIES AND MATERIALS,09/24/2023,Expense,--,02 GENERAL BANK URESTR,Flyers Zelle payment to Oksana Patrina XXXXXXX9663,FUNDRAISING EVENTS:SUPPLIES AND MATERIALS,CHASE ENDING IN 5315,$50.87,"$833,694.22"
CHASE ENDING IN 5315,09/24/2023,Expense,--,02 GENERAL BANK URESTR,Zelle payment to Oksana Patrina XXXXXXX9494,CHASE ENDING IN 5315,--,-$275.24,"$833,418.98"
SUPPLIES AND MATERIALS,09/24/2023,Expense,--,02 GENERAL BANK URESTR,Ukrainian Flags and American Flag Postcards,FUNDRAISING EVENTS:SUPPLIES AND MATERIALS,CHASE ENDING IN 5315,$58.70,"$833,477.68"
Software & apps,09/24/2023,Expense,--,02 GENERAL BANK URESTR,Quickbooks June & July 202392,OFFICE/GENERAL ADMINISTRATIVE EXPENSES:Software & apps,CHASE ENDING IN 5315,$92.54,"$833,570.22"
MALING AND DELIVERY,09/24/2023,Expense,--,02 GENERAL BANK URESTR,P.O. Box in Brooklyn Zelle payment to Oksana Patrina XXXXXXX9494,OFFICE/GENERAL ADMINISTRATIVE EXPENSES:MALING AND DELIVERY,CHASE ENDING IN 5315,$124.00,"$833,694.22"
CHASE ENDING IN 5315,09/24/2023,Expense,--,02 GENERAL BANK URESTR,Zelle payment to Yuliya O'Connell XXXXXXX6718,CHASE ENDING IN 5315,SUPPLIES AND MATERIALS,"-$1,316.61","$832,377.61"
SUPPLIES AND MATERIALS,09/24/2023,Expense,--,02 GENERAL BANK URESTR,Zelle payment to Yuliya O'Connell XXXXXXX6718,FUNDRAISING EVENTS:SUPPLIES AND MATERIALS,CHASE ENDING IN 5315,"$1,316.61","$833,694.22"
PayPal Bank 3,09/23/2023,Deposit,3UP18969128368342,04 PAYPAL GENERAL UNRESTR,"Subject: GeneralPage
Transaction ID: 3UP18969128368342
https://www.paypal.com/activity/payment/3UP18969128368342",PayPal Bank 3,--,$25.00,"$833,719.22"
Donations directed by individuals,09/23/2023,Deposit,3UP18969128368342,04 PAYPAL GENERAL UNRESTR,Support Ukraine - Support Ukraine,Contributed income:Donations directed by individuals,PayPal Bank 3,$26.25,"$833,745.47"
PayPal Fees,09/23/2023,Deposit,3UP18969128368342,04 PAYPAL GENERAL UNRESTR,PayPal fees,OFFICE/GENERAL ADMINISTRATIVE EXPENSES:PayPal Fees,PayPal Bank 3,$1.25,"$833,746.72"
PayPal Bank 3,09/23/2023,Deposit,3GN92325HE000703N,08 VICTORY DRONES RESTR,"Subject: VictoryDrones
Transaction ID: 3GN92325HE000703N
https://www.paypal.com/activity/payment/3GN92325HE000703N",PayPal Bank 3,--,$9.84,"$833,756.56"
Donations directed by individuals,09/23/2023,Deposit,3GN92325HE000703N,08 VICTORY DRONES RESTR,VICTORY DRONES - VICTORY DRONES,Contributed income:Donations directed by individuals,PayPal Bank 3,$10.80,"$833,767.36"
PayPal Fees,09/23/2023,Deposit,3GN92325HE000703N,08 VICTORY DRONES RESTR,PayPal fees,OFFICE/GENERAL ADMINISTRATIVE EXPENSES:PayPal Fees,PayPal Bank 3,$0.96,"$833,768.32"
PayPal Bank 3,09/23/2023,Deposit,6WL49013TG5650535,04 PAYPAL GENERAL UNRESTR,"Subject: GeneralPage
Transaction ID: 6WL49013TG5650535
https://www.paypal.com/activity/payment/6WL49013TG5650535",PayPal Bank 3,--,$209.85,"$833,978.17"
Donations directed by individuals,09/23/2023,Deposit,6WL49013TG5650535,04 PAYPAL GENERAL UNRESTR,Support Ukraine - Support Ukraine,Contributed income:Donations directed by individuals,PayPal Bank 3,$220.00,"$834,198.17"
PayPal Fees,09/23/2023,Deposit,6WL49013TG5650535,04 PAYPAL GENERAL UNRESTR,PayPal fees,OFFICE/GENERAL ADMINISTRATIVE EXPENSES:PayPal Fees,PayPal Bank 3,$10.15,"$834,208.32"
PayPal Bank 3,09/23/2023,Deposit,6SJ99472LV630953D,04 PAYPAL GENERAL UNRESTR,"Subject: GeneralPage
Transaction ID: 6SJ99472LV630953D
https://www.paypal.com/activity/payment/6SJ99472LV630953D",PayPal Bank 3,--,$10.00,"$834,218.32"
Donations directed by individuals,09/23/2023,Deposit,6SJ99472LV630953D,04 PAYPAL GENERAL UNRESTR,Support Ukraine - Support Ukraine,Contributed income:Donations directed by individuals,PayPal Bank 3,$10.80,"$834,229.12"
PayPal Fees,09/23/2023,Deposit,6SJ99472LV630953D,04 PAYPAL GENERAL UNRESTR,PayPal fees,OFFICE/GENERAL ADMINISTRATIVE EXPENSES:PayPal Fees,PayPal Bank 3,$0.80,"$834,229.92"
PayPal Bank 3,09/23/2023,Deposit,69D4654124493931E,04 PAYPAL GENERAL UNRESTR,"Subject: GeneralPage
Transaction ID: 69D4654124493931E
https://www.paypal.com/activity/payment/69D4654124493931E",PayPal Bank 3,--,$2.38,"$834,232.30"
Donations directed by individuals,09/23/2023,Deposit,69D4654124493931E,04 PAYPAL GENERAL UNRESTR,Support Ukraine - Support Ukraine,Contributed income:Donations directed by individuals,PayPal Bank 3,$3.00,"$834,235.30"
PayPal Fees,09/23/2023,Deposit,69D4654124493931E,04 PAYPAL GENERAL UNRESTR,PayPal fees,OFFICE/GENERAL ADMINISTRATIVE EXPENSES:PayPal Fees,PayPal Bank 3,$0.62,"$834,235.92"
PayPal Bank 3,09/23/2023,Deposit,46U34802MG248864U,04 PAYPAL GENERAL UNRESTR,"Transaction ID: 46U34802MG248864U
https://www.paypal.com/activity/payment/46U34802MG248864U",PayPal Bank 3,--,$4.78,"$834,240.70"
Donations directed by individuals,09/23/2023,Deposit,46U34802MG248864U,04 PAYPAL GENERAL UNRESTR,Money in to PayPal,Contributed income:Donations directed by individuals,PayPal Bank 3,$5.00,"$834,245.70"
PayPal Fees,09/23/2023,Deposit,46U34802MG248864U,04 PAYPAL GENERAL UNRESTR,PayPal fees,OFFICE/GENERAL ADMINISTRATIVE EXPENSES:PayPal Fees,PayPal Bank 3,$0.22,"$834,245.92"
PayPal Bank 3,09/23/2023,Deposit,3AC82357XC312483A,04 PAYPAL GENERAL UNRESTR,"Subject: GeneralPage
Note: Charitable donation to Ukrainian military
Transaction ID: 3AC82357XC312483A
https://www.paypal.com/activity/payment/3AC82357XC312483A",PayPal Bank 3,--,$147.68,"$834,393.60"
Donations directed by individuals,09/23/2023,Deposit,3AC82357XC312483A,04 PAYPAL GENERAL UNRESTR,Support Ukraine - Support Ukraine,Contributed income:Donations directed by individuals,PayPal Bank 3,$154.97,"$834,548.57"
PayPal Fees,09/23/2023,Deposit,3AC82357XC312483A,04 PAYPAL GENERAL UNRESTR,PayPal fees,OFFICE/GENERAL ADMINISTRATIVE EXPENSES:PayPal Fees,PayPal Bank 3,$7.29,"$834,555.86"
PayPal Bank 3,09/23/2023,Deposit,21B17863Y1597791L,07 1000 DRONES RESTR,"Subject: 1000DRONES
Transaction ID: 21B17863Y1597791L
https://www.paypal.com/activity/payment/21B17863Y1597791L",PayPal Bank 3,--,$100.00,"$834,655.86"
Donations directed by individuals,09/23/2023,Deposit,21B17863Y1597791L,07 1000 DRONES RESTR,1000 DRONES FOR UKRAINE - 1000 DRONES FOR UKRAINE,Contributed income:Donations directed by individuals,PayPal Bank 3,$103.48,"$834,759.34"
PayPal Fees,09/23/2023,Deposit,21B17863Y1597791L,07 1000 DRONES RESTR,PayPal fees,OFFICE/GENERAL ADMINISTRATIVE EXPENSES:PayPal Fees,PayPal Bank 3,$3.48,"$834,762.82"
PayPal Bank 3,09/23/2023,Deposit,8R021585R7699960A,04 PAYPAL GENERAL UNRESTR,"Subject: GeneralPage
Transaction ID: 8R021585R7699960A
https://www.paypal.com/activity/payment/8R021585R7699960A",PayPal Bank 3,--,$14.76,"$834,777.58"
Donations directed by individuals,09/23/2023,Deposit,8R021585R7699960A,04 PAYPAL GENERAL UNRESTR,Support Ukraine - Support Ukraine,Contributed income:Donations directed by individuals,PayPal Bank 3,$15.95,"$834,793.53"
PayPal Fees,09/23/2023,Deposit,8R021585R7699960A,04 PAYPAL GENERAL UNRESTR,PayPal fees,OFFICE/GENERAL ADMINISTRATIVE EXPENSES:PayPal Fees,PayPal Bank 3,$1.19,"$834,794.72"
PayPal Bank 3,09/23/2023,Deposit,7E355680R3840503A,04 PAYPAL GENERAL UNRESTR,"Subject: GeneralPage
Transaction ID: 7E355680R3840503A
https://www.paypal.com/activity/payment/7E355680R3840503A",PayPal Bank 3,--,$70.00,"$834,864.72"
Donations directed by individuals,09/23/2023,Deposit,7E355680R3840503A,04 PAYPAL GENERAL UNRESTR,Support Ukraine - Support Ukraine,Contributed income:Donations directed by individuals,PayPal Bank 3,$72.59,"$834,937.31"
PayPal Fees,09/23/2023,Deposit,7E355680R3840503A,04 PAYPAL GENERAL UNRESTR,PayPal fees,OFFICE/GENERAL ADMINISTRATIVE EXPENSES:PayPal Fees,PayPal Bank 3,$2.59,"$834,939.90"
PayPal Bank 3,09/23/2023,Deposit,1RF75633TC162325B,04 PAYPAL GENERAL UNRESTR,"Subject: GeneralPage
Transaction ID: 1RF75633TC162325B
https://www.paypal.com/activity/payment/1RF75633TC162325B",PayPal Bank 3,--,$25.00,"$834,964.90"
Donations directed by individuals,09/23/2023,Deposit,1RF75633TC162325B,04 PAYPAL GENERAL UNRESTR,Support Ukraine - Support Ukraine,Contributed income:Donations directed by individuals,PayPal Bank 3,$26.25,"$834,991.15"
PayPal Fees,09/23/2023,Deposit,1RF75633TC162325B,04 PAYPAL GENERAL UNRESTR,PayPal fees,OFFICE/GENERAL ADMINISTRATIVE EXPENSES:PayPal Fees,PayPal Bank 3,$1.25,"$834,992.40"
PayPal Bank 3,09/23/2023,Deposit,0FN80305486194315,04 PAYPAL GENERAL UNRESTR,"Subject: GeneralPage
Transaction ID: 0FN80305486194315
https://www.paypal.com/activity/payment/0FN80305486194315",PayPal Bank 3,--,$477.56,"$835,469.96"
Donations directed by individuals,09/23/2023,Deposit,0FN80305486194315,04 PAYPAL GENERAL UNRESTR,Support Ukraine - Support Ukraine,Contributed income:Donations directed by individuals,PayPal Bank 3,$500.00,"$835,969.96"
PayPal Fees,09/23/2023,Deposit,0FN80305486194315,04 PAYPAL GENERAL UNRESTR,PayPal fees,OFFICE/GENERAL ADMINISTRATIVE EXPENSES:PayPal Fees,PayPal Bank 3,$22.44,"$835,992.40"
PayPal Bank 3,09/23/2023,Deposit,55P436038B209180R,04 PAYPAL GENERAL UNRESTR,"Subject: Support Ukraine
Transaction ID: 55P436038B209180R
https://www.paypal.com/activity/payment/55P436038B209180R",PayPal Bank 3,--,$29.53,"$836,021.93"
Donations directed by individuals,09/23/2023,Deposit,55P436038B209180R,04 PAYPAL GENERAL UNRESTR,Money in to PayPal,Contributed income:Donations directed by individuals,PayPal Bank 3,$31.40,"$836,053.33"
PayPal Fees,09/23/2023,Deposit,55P436038B209180R,04 PAYPAL GENERAL UNRESTR,PayPal fees,OFFICE/GENERAL ADMINISTRATIVE EXPENSES:PayPal Fees,PayPal Bank 3,$1.87,"$836,055.20"
PayPal Bank 3,09/23/2023,Deposit,7EJ10983UP137745A,04 PAYPAL GENERAL UNRESTR,"Subject: GeneralPage
Transaction ID: 7EJ10983UP137745A
https://www.paypal.com/activity/payment/7EJ10983UP137745A",PayPal Bank 3,--,$18.63,"$836,073.83"
Donations directed by individuals,09/23/2023,Deposit,7EJ10983UP137745A,04 PAYPAL GENERAL UNRESTR,Support Ukraine - Support Ukraine,Contributed income:Donations directed by individuals,PayPal Bank 3,$20.00,"$836,093.83"
PayPal Fees,09/23/2023,Deposit,7EJ10983UP137745A,04 PAYPAL GENERAL UNRESTR,PayPal fees,OFFICE/GENERAL ADMINISTRATIVE EXPENSES:PayPal Fees,PayPal Bank 3,$1.37,"$836,095.20"
PayPal Bank 3,09/23/2023,Deposit,290889795V280824N,04 PAYPAL GENERAL UNRESTR,"Subject: GeneralPage
Transaction ID: 290889795V280824N
https://www.paypal.com/activity/payment/290889795V280824N",PayPal Bank 3,--,$397.66,"$836,492.86"
Donations directed by individuals,09/23/2023,Deposit,290889795V280824N,04 PAYPAL GENERAL UNRESTR,Support Ukraine - Support Ukraine,Contributed income:Donations directed by individuals,PayPal Bank 3,$410.00,"$836,902.86"
PayPal Fees,09/23/2023,Deposit,290889795V280824N,04 PAYPAL GENERAL UNRESTR,PayPal fees,OFFICE/GENERAL ADMINISTRATIVE EXPENSES:PayPal Fees,PayPal Bank 3,$12.34,"$836,915.20"
PayPal Bank 3,09/23/2023,Deposit,06603290RE9463611,04 PAYPAL GENERAL UNRESTR,"Subject: GeneralPage
Transaction ID: 06603290RE9463611
https://www.paypal.com/activity/payment/06603290RE9463611",PayPal Bank 3,--,$39.37,"$836,954.57"
Donations directed by individuals,09/23/2023,Deposit,06603290RE9463611,04 PAYPAL GENERAL UNRESTR,Support Ukraine - Support Ukraine,Contributed income:Donations directed by individuals,PayPal Bank 3,$41.69,"$836,996.26"
PayPal Fees,09/23/2023,Deposit,06603290RE9463611,04 PAYPAL GENERAL UNRESTR,PayPal fees,OFFICE/GENERAL ADMINISTRATIVE EXPENSES:PayPal Fees,PayPal Bank 3,$2.32,"$836,998.58"
PayPal Bank 3,09/23/2023,Deposit,990951073G3350639,07 1000 DRONES RESTR,"Subject: 1000DRONES
Transaction ID: 990951073G3350639
https://www.paypal.com/activity/payment/990951073G3350639",PayPal Bank 3,--,$50.00,"$837,048.58"
Donations directed by individuals,09/23/2023,Deposit,990951073G3350639,07 1000 DRONES RESTR,1000 DRONES FOR UKRAINE - 1000 DRONES FOR UKRAINE,Contributed income:Donations directed by individuals,PayPal Bank 3,$51.99,"$837,100.57"
PayPal Fees,09/23/2023,Deposit,990951073G3350639,07 1000 DRONES RESTR,PayPal fees,OFFICE/GENERAL ADMINISTRATIVE EXPENSES:PayPal Fees,PayPal Bank 3,$1.99,"$837,102.56"
PayPal Bank 3,09/23/2023,Deposit,2UM61030UF0951632,07 1000 DRONES RESTR,"Subject: 1000DRONES
Transaction ID: 2UM61030UF0951632
https://www.paypal.com/activity/payment/2UM61030UF0951632",PayPal Bank 3,--,$18.63,"$837,121.19"
Donations directed by individuals,09/23/2023,Deposit,2UM61030UF0951632,07 1000 DRONES RESTR,1000 DRONES FOR UKRAINE - 1000 DRONES FOR UKRAINE,Contributed income:Donations directed by individuals,PayPal Bank 3,$20.00,"$837,141.19"
PayPal Fees,09/23/2023,Deposit,2UM61030UF0951632,07 1000 DRONES RESTR,PayPal fees,OFFICE/GENERAL ADMINISTRATIVE EXPENSES:PayPal Fees,PayPal Bank 3,$1.37,"$837,142.56"
PayPal Bank 3,09/23/2023,Deposit,66L69202LD6818352,07 1000 DRONES RESTR,"Subject: GeneralPage
Note: На люті пташки���
Transaction ID: 66L69202LD6818352
https://www.paypal.com/activity/payment/66L69202LD6818352",PayPal Bank 3,--,$95.12,"$837,237.68"
Donations directed by individuals,09/23/2023,Deposit,66L69202LD6818352,07 1000 DRONES RESTR,Support Ukraine - Support Ukraine,Contributed income:Donations directed by individuals,PayPal Bank 3,$100.00,"$837,337.68"
PayPal Fees,09/23/2023,Deposit,66L69202LD6818352,07 1000 DRONES RESTR,PayPal fees,OFFICE/GENERAL ADMINISTRATIVE EXPENSES:PayPal Fees,PayPal Bank 3,$4.88,"$837,342.56"
PayPal Bank 3,09/23/2023,Deposit,3M837784BL983715T,04 PAYPAL GENERAL UNRESTR,"Subject: GeneralPage
Transaction ID: 3M837784BL983715T
https://www.paypal.com/activity/payment/3M837784BL983715T",PayPal Bank 3,--,$18.63,"$837,361.19"
Donations directed by individuals,09/23/2023,Deposit,3M837784BL983715T,04 PAYPAL GENERAL UNRESTR,Support Ukraine - Support Ukraine,Contributed income:Donations directed by individuals,PayPal Bank 3,$20.00,"$837,381.19"
PayPal Fees,09/23/2023,Deposit,3M837784BL983715T,04 PAYPAL GENERAL UNRESTR,PayPal fees,OFFICE/GENERAL ADMINISTRATIVE EXPENSES:PayPal Fees,PayPal Bank 3,$1.37,"$837,382.56"
PayPal Bank 3,09/23/2023,Deposit,13487489GA0073815,10 Flight to Recovery RESTR,"Subject: Dignitas Ukraine Flight to Recovery
Transaction ID: 13487489GA0073815
https://www.paypal.com/activity/payment/13487489GA0073815",PayPal Bank 3,--,$98.45,"$837,481.01"
Donations directed by individuals,09/23/2023,Deposit,13487489GA0073815,10 Flight to Recovery RESTR,Money in to PayPal,Contributed income:Donations directed by individuals,PayPal Bank 3,$103.48,"$837,584.49"
PayPal Fees,09/23/2023,Deposit,13487489GA0073815,10 Flight to Recovery RESTR,PayPal fees,OFFICE/GENERAL ADMINISTRATIVE EXPENSES:PayPal Fees,PayPal Bank 3,$5.03,"$837,589.52"
PayPal Bank 3,09/23/2023,Deposit,0P957377CJ324634M,08 VICTORY DRONES RESTR,"Subject: VICTORY DRONES
Transaction ID: 0P957377CJ324634M
https://www.paypal.com/activity/payment/0P957377CJ324634M",PayPal Bank 3,--,$98.45,"$837,687.97"
Donations directed by individuals,09/23/2023,Deposit,0P957377CJ324634M,08 VICTORY DRONES RESTR,Money in to PayPal,Contributed income:Donations directed by individuals,PayPal Bank 3,$103.48,"$837,791.45"
PayPal Fees,09/23/2023,Deposit,0P957377CJ324634M,08 VICTORY DRONES RESTR,PayPal fees,OFFICE/GENERAL ADMINISTRATIVE EXPENSES:PayPal Fees,PayPal Bank 3,$5.03,"$837,796.48"
PayPal Bank 3,09/23/2023,Deposit,0UD55820KM201731V,04 PAYPAL GENERAL UNRESTR,"Subject: GeneralPage
Transaction ID: 0UD55820KM201731V
https://www.paypal.com/activity/payment/0UD55820KM201731V",PayPal Bank 3,--,$984.54,"$838,781.02"
Donations directed by individuals,09/23/2023,Deposit,0UD55820KM201731V,04 PAYPAL GENERAL UNRESTR,Support Ukraine - Support Ukraine,Contributed income:Donations directed by individuals,PayPal Bank 3,"$1,030.26","$839,811.28"
PayPal Fees,09/23/2023,Deposit,0UD55820KM201731V,04 PAYPAL GENERAL UNRESTR,PayPal fees,OFFICE/GENERAL ADMINISTRATIVE EXPENSES:PayPal Fees,PayPal Bank 3,$45.72,"$839,857.00"
PayPal Bank 3,09/23/2023,Deposit,545273715P3882818,04 PAYPAL GENERAL UNRESTR,"Subject: GeneralPage
Transaction ID: 545273715P3882818
https://www.paypal.com/activity/payment/545273715P3882818",PayPal Bank 3,--,$18.63,"$839,875.63"
Donations directed by individuals,09/23/2023,Deposit,545273715P3882818,04 PAYPAL GENERAL UNRESTR,Support Ukraine - Support Ukraine,Contributed income:Donations directed by individuals,PayPal Bank 3,$20.00,"$839,895.63"
PayPal Fees,09/23/2023,Deposit,545273715P3882818,04 PAYPAL GENERAL UNRESTR,PayPal fees,OFFICE/GENERAL ADMINISTRATIVE EXPENSES:PayPal Fees,PayPal Bank 3,$1.37,"$839,897.00"
PayPal Bank 3,09/23/2023,Deposit,87696919H27814213,09 MSU RESTR,"Subject: Dignitas Ukraine Flight to Recovery
Transaction ID: 87696919H27814213
https://www.paypal.com/activity/payment/87696919H27814213",PayPal Bank 3,--,$50.00,"$839,947.00"
Donations directed by individuals,09/23/2023,Deposit,87696919H27814213,09 MSU RESTR,Money in to PayPal,Contributed income:Donations directed by individuals,PayPal Bank 3,$51.99,"$839,998.99"
PayPal Fees,09/23/2023,Deposit,87696919H27814213,09 MSU RESTR,PayPal fees,OFFICE/GENERAL ADMINISTRATIVE EXPENSES:PayPal Fees,PayPal Bank 3,$1.99,"$840,000.98"
PayPal Bank 3,09/23/2023,Deposit,0PG03801L30768224,08 VICTORY DRONES RESTR,"Subject: VictoryDrones
Transaction ID: 0PG03801L30768224
https://www.paypal.com/activity/payment/0PG03801L30768224",PayPal Bank 3,--,$100.00,"$840,100.98"
Donations directed by individuals,09/23/2023,Deposit,0PG03801L30768224,08 VICTORY DRONES RESTR,VICTORY DRONES - VICTORY DRONES,Contributed income:Donations directed by individuals,PayPal Bank 3,$103.48,"$840,204.46"
PayPal Fees,09/23/2023,Deposit,0PG03801L30768224,08 VICTORY DRONES RESTR,PayPal fees,OFFICE/GENERAL ADMINISTRATIVE EXPENSES:PayPal Fees,PayPal Bank 3,$3.48,"$840,207.94"
PayPal Bank 3,09/23/2023,Deposit,55F66519NV265735R,07 1000 DRONES RESTR,"Subject: 1000DRONES
Transaction ID: 55F66519NV265735R
https://www.paypal.com/activity/payment/55F66519NV265735R",PayPal Bank 3,--,$48.06,"$840,256.00"
Donations directed by individuals,09/23/2023,Deposit,55F66519NV265735R,07 1000 DRONES RESTR,1000 DRONES FOR UKRAINE - 1000 DRONES FOR UKRAINE,Contributed income:Donations directed by individuals,PayPal Bank 3,$50.00,"$840,306.00"
PayPal Fees,09/23/2023,Deposit,55F66519NV265735R,07 1000 DRONES RESTR,PayPal fees,OFFICE/GENERAL ADMINISTRATIVE EXPENSES:PayPal Fees,PayPal Bank 3,$1.94,"$840,307.94"
PayPal Bank 3,09/23/2023,Deposit,2HP01481S8513282K,10 Flight to Recovery RESTR,"Subject: MobileShowers
Transaction ID: 2HP01481S8513282K
https://www.paypal.com/activity/payment/2HP01481S8513282K",PayPal Bank 3,--,$50.00,"$840,357.94"
Donations directed by individuals,09/23/2023,Deposit,2HP01481S8513282K,10 Flight to Recovery RESTR,Mobile Shower/Laundry Units - Mobile Shower/Laundry Units,Contributed income:Donations directed by individuals,PayPal Bank 3,$51.99,"$840,409.93"
PayPal Fees,09/23/2023,Deposit,2HP01481S8513282K,10 Flight to Recovery RESTR,PayPal fees,OFFICE/GENERAL ADMINISTRATIVE EXPENSES:PayPal Fees,PayPal Bank 3,$1.99,"$840,411.92"
PayPal Bank 3,09/23/2023,Deposit,0RB00006G3649351G,11 VETERANIUS RESTR,"Subject: Veteranius
Transaction ID: 0RB00006G3649351G
https://www.paypal.com/activity/payment/0RB00006G3649351G",PayPal Bank 3,--,$51.00,"$840,462.92"
Donations directed by individuals,09/23/2023,Deposit,0RB00006G3649351G,11 VETERANIUS RESTR,Veteranius - helping veterans to learn and gain experience in IT. - Veteranius - helping veterans to learn and gain experience in IT.,Contributed income:Donations directed by individuals,PayPal Bank 3,$53.02,"$840,515.94"
PayPal Fees,09/23/2023,Deposit,0RB00006G3649351G,11 VETERANIUS RESTR,PayPal fees,OFFICE/GENERAL ADMINISTRATIVE EXPENSES:PayPal Fees,PayPal Bank 3,$2.02,"$840,517.96"
PayPal Bank 3,09/23/2023,Deposit,1X56207853018610B,04 PAYPAL GENERAL UNRESTR,"Subject: GeneralPage
Transaction ID: 1X56207853018610B
https://www.paypal.com/activity/payment/1X56207853018610B",PayPal Bank 3,--,$100.00,"$840,617.96"
Donations directed by individuals,09/23/2023,Deposit,1X56207853018610B,04 PAYPAL GENERAL UNRESTR,Support Ukraine - Support Ukraine,Contributed income:Donations directed by individuals,PayPal Bank 3,$103.48,"$840,721.44"
PayPal Fees,09/23/2023,Deposit,1X56207853018610B,04 PAYPAL GENERAL UNRESTR,PayPal fees,OFFICE/GENERAL ADMINISTRATIVE EXPENSES:PayPal Fees,PayPal Bank 3,$3.48,"$840,724.92"
PayPal Bank 3,09/23/2023,Deposit,3YY73431HJ848463Y,04 PAYPAL GENERAL UNRESTR,"Subject: GeneralPage
Transaction ID: 3YY73431HJ848463Y
https://www.paypal.com/activity/payment/3YY73431HJ848463Y",PayPal Bank 3,--,$49.22,"$840,774.14"
Donations directed by individuals,09/23/2023,Deposit,3YY73431HJ848463Y,04 PAYPAL GENERAL UNRESTR,Support Ukraine - Support Ukraine,Contributed income:Donations directed by individuals,PayPal Bank 3,$51.99,"$840,826.13"
PayPal Fees,09/23/2023,Deposit,3YY73431HJ848463Y,04 PAYPAL GENERAL UNRESTR,PayPal fees,OFFICE/GENERAL ADMINISTRATIVE EXPENSES:PayPal Fees,PayPal Bank 3,$2.77,"$840,828.90"
PayPal Bank 3,09/23/2023,Deposit,7338726109854425U,07 1000 DRONES RESTR,"Subject: GeneralPage
Note: Люті пташки�
Transaction ID: 7338726109854425U
https://www.paypal.com/activity/payment/7338726109854425U",PayPal Bank 3,--,$50.00,"$840,878.90"
Donations directed by individuals,09/23/2023,Deposit,7338726109854425U,07 1000 DRONES RESTR,Support Ukraine - Support Ukraine,Contributed income:Donations directed by individuals,PayPal Bank 3,$51.99,"$840,930.89"
PayPal Fees,09/23/2023,Deposit,7338726109854425U,07 1000 DRONES RESTR,PayPal fees,OFFICE/GENERAL ADMINISTRATIVE EXPENSES:PayPal Fees,PayPal Bank 3,$1.99,"$840,932.88"
PayPal Bank 3,09/23/2023,Deposit,4LX9193921784391G,04 PAYPAL GENERAL UNRESTR,"Subject: GeneralPage
Transaction ID: 4LX9193921784391G
https://www.paypal.com/activity/payment/4LX9193921784391G",PayPal Bank 3,--,$18.63,"$840,951.51"
Donations directed by individuals,09/23/2023,Deposit,4LX9193921784391G,04 PAYPAL GENERAL UNRESTR,Support Ukraine - Support Ukraine,Contributed income:Donations directed by individuals,PayPal Bank 3,$20.00,"$840,971.51"
PayPal Fees,09/23/2023,Deposit,4LX9193921784391G,04 PAYPAL GENERAL UNRESTR,PayPal fees,OFFICE/GENERAL ADMINISTRATIVE EXPENSES:PayPal Fees,PayPal Bank 3,$1.37,"$840,972.88"
PayPal Bank 3,09/23/2023,Deposit,7GV826784V6369926,04 PAYPAL GENERAL UNRESTR,"Subject: GeneralPage
Transaction ID: 7GV826784V6369926
https://www.paypal.com/activity/payment/7GV826784V6369926",PayPal Bank 3,--,$34.46,"$841,007.34"
Donations directed by individuals,09/23/2023,Deposit,7GV826784V6369926,04 PAYPAL GENERAL UNRESTR,Support Ukraine - Support Ukraine,Contributed income:Donations directed by individuals,PayPal Bank 3,$36.55,"$841,043.89"
PayPal Fees,09/23/2023,Deposit,7GV826784V6369926,04 PAYPAL GENERAL UNRESTR,PayPal fees,OFFICE/GENERAL ADMINISTRATIVE EXPENSES:PayPal Fees,PayPal Bank 3,$2.09,"$841,045.98"
PayPal Bank 3,09/23/2023,Deposit,1TS73153U1151683N,04 PAYPAL GENERAL UNRESTR,"Subject: GeneralPage
Transaction ID: 1TS73153U1151683N
https://www.paypal.com/activity/payment/1TS73153U1151683N",PayPal Bank 3,--,$19.68,"$841,065.66"
Donations directed by individuals,09/23/2023,Deposit,1TS73153U1151683N,04 PAYPAL GENERAL UNRESTR,Support Ukraine - Support Ukraine,Contributed income:Donations directed by individuals,PayPal Bank 3,$21.10,"$841,086.76"
PayPal Fees,09/23/2023,Deposit,1TS73153U1151683N,04 PAYPAL GENERAL UNRESTR,PayPal fees,OFFICE/GENERAL ADMINISTRATIVE EXPENSES:PayPal Fees,PayPal Bank 3,$1.42,"$841,088.18"
PayPal Bank 3,09/23/2023,Deposit,75624969NP341482Y,04 PAYPAL GENERAL UNRESTR,"Subject: GeneralPage
Transaction ID: 75624969NP341482Y
https://www.paypal.com/activity/payment/75624969NP341482Y",PayPal Bank 3,--,$29.53,"$841,117.71"
Donations directed by individuals,09/23/2023,Deposit,75624969NP341482Y,04 PAYPAL GENERAL UNRESTR,Support Ukraine - Support Ukraine,Contributed income:Donations directed by individuals,PayPal Bank 3,$31.40,"$841,149.11"
PayPal Fees,09/23/2023,Deposit,75624969NP341482Y,04 PAYPAL GENERAL UNRESTR,PayPal fees,OFFICE/GENERAL ADMINISTRATIVE EXPENSES:PayPal Fees,PayPal Bank 3,$1.87,"$841,150.98"
PayPal Bank 3,09/23/2023,Deposit,6LC22109DS786890T,07 1000 DRONES RESTR,"Subject: 1000DRONES
Transaction ID: 6LC22109DS786890T
https://www.paypal.com/activity/payment/6LC22109DS786890T",PayPal Bank 3,--,$98.45,"$841,249.43"
Donations directed by individuals,09/23/2023,Deposit,6LC22109DS786890T,07 1000 DRONES RESTR,1000 DRONES FOR UKRAINE - 1000 DRONES FOR UKRAINE,Contributed income:Donations directed by individuals,PayPal Bank 3,$103.48,"$841,352.91"
PayPal Fees,09/23/2023,Deposit,6LC22109DS786890T,07 1000 DRONES RESTR,PayPal fees,OFFICE/GENERAL ADMINISTRATIVE EXPENSES:PayPal Fees,PayPal Bank 3,$5.03,"$841,357.94"
PayPal Bank 3,09/23/2023,Deposit,8JU1864953532481E,04 PAYPAL GENERAL UNRESTR,"Subject: Support Ukraine
Transaction ID: 8JU1864953532481E
https://www.paypal.com/activity/payment/8JU1864953532481E",PayPal Bank 3,--,$4.29,"$841,362.23"
Donations directed by individuals,09/23/2023,Deposit,8JU1864953532481E,04 PAYPAL GENERAL UNRESTR,Money in to PayPal,Contributed income:Donations directed by individuals,PayPal Bank 3,$5.00,"$841,367.23"
PayPal Fees,09/23/2023,Deposit,8JU1864953532481E,04 PAYPAL GENERAL UNRESTR,PayPal fees,OFFICE/GENERAL ADMINISTRATIVE EXPENSES:PayPal Fees,PayPal Bank 3,$0.71,"$841,367.94"
PayPal Bank 3,09/23/2023,Deposit,3YT156715G838070F,04 PAYPAL GENERAL UNRESTR,"Subject: GeneralPage
Transaction ID: 3YT156715G838070F
https://www.paypal.com/activity/payment/3YT156715G838070F",PayPal Bank 3,--,$96.62,"$841,464.56"
Donations directed by individuals,09/23/2023,Deposit,3YT156715G838070F,04 PAYPAL GENERAL UNRESTR,Support Ukraine - Support Ukraine,Contributed income:Donations directed by individuals,PayPal Bank 3,$100.00,"$841,564.56"
PayPal Fees,09/23/2023,Deposit,3YT156715G838070F,04 PAYPAL GENERAL UNRESTR,PayPal fees,OFFICE/GENERAL ADMINISTRATIVE EXPENSES:PayPal Fees,PayPal Bank 3,$3.38,"$841,567.94"
PayPal Bank 3,09/23/2023,Deposit,2G772791CS9567322,04 PAYPAL GENERAL UNRESTR,"Subject: GeneralPage
Transaction ID: 2G772791CS9567322
https://www.paypal.com/activity/payment/2G772791CS9567322",PayPal Bank 3,--,$29.53,"$841,597.47"
Donations directed by individuals,09/23/2023,Deposit,2G772791CS9567322,04 PAYPAL GENERAL UNRESTR,Support Ukraine - Support Ukraine,Contributed income:Donations directed by individuals,PayPal Bank 3,$31.40,"$841,628.87"
PayPal Fees,09/23/2023,Deposit,2G772791CS9567322,04 PAYPAL GENERAL UNRESTR,PayPal fees,OFFICE/GENERAL ADMINISTRATIVE EXPENSES:PayPal Fees,PayPal Bank 3,$1.87,"$841,630.74"
PayPal Bank 3,09/23/2023,Deposit,2H173609DJ6741336,07 1000 DRONES RESTR,"Subject: 1000DRONES
Transaction ID: 2H173609DJ6741336
https://www.paypal.com/activity/payment/2H173609DJ6741336",PayPal Bank 3,--,$196.91,"$841,827.65"
Donations directed by individuals,09/23/2023,Deposit,2H173609DJ6741336,07 1000 DRONES RESTR,1000 DRONES FOR UKRAINE - 1000 DRONES FOR UKRAINE,Contributed income:Donations directed by individuals,PayPal Bank 3,$206.46,"$842,034.11"
PayPal Fees,09/23/2023,Deposit,2H173609DJ6741336,07 1000 DRONES RESTR,PayPal fees,OFFICE/GENERAL ADMINISTRATIVE EXPENSES:PayPal Fees,PayPal Bank 3,$9.55,"$842,043.66"
PayPal Bank 3,09/23/2023,Deposit,8JJ667856F822760R,04 PAYPAL GENERAL UNRESTR,"Subject: GeneralPage
Transaction ID: 8JJ667856F822760R
https://www.paypal.com/activity/payment/8JJ667856F822760R",PayPal Bank 3,--,$98.45,"$842,142.11"
Donations directed by individuals,09/23/2023,Deposit,8JJ667856F822760R,04 PAYPAL GENERAL UNRESTR,Support Ukraine - Support Ukraine,Contributed income:Donations directed by individuals,PayPal Bank 3,$103.48,"$842,245.59"
PayPal Fees,09/23/2023,Deposit,8JJ667856F822760R,04 PAYPAL GENERAL UNRESTR,PayPal fees,OFFICE/GENERAL ADMINISTRATIVE EXPENSES:PayPal Fees,PayPal Bank 3,$5.03,"$842,250.62"
PayPal Bank 3,09/23/2023,Deposit,4980327441588930X,04 PAYPAL GENERAL UNRESTR,"Subject: GeneralPage
Transaction ID: 4980327441588930X
https://www.paypal.com/activity/payment/4980327441588930X",PayPal Bank 3,--,$492.26,"$842,742.88"
Donations directed by individuals,09/23/2023,Deposit,4980327441588930X,04 PAYPAL GENERAL UNRESTR,Support Ukraine - Support Ukraine,Contributed income:Donations directed by individuals,PayPal Bank 3,$515.38,"$843,258.26"
PayPal Fees,09/23/2023,Deposit,4980327441588930X,04 PAYPAL GENERAL UNRESTR,PayPal fees,OFFICE/GENERAL ADMINISTRATIVE EXPENSES:PayPal Fees,PayPal Bank 3,$23.12,"$843,281.38"
PayPal Bank 3,09/23/2023,Deposit,2N452540WE0710112,04 PAYPAL GENERAL UNRESTR,"Subject: Support Ukraine
Transaction ID: 2N452540WE0710112
https://www.paypal.com/activity/payment/2N452540WE0710112",PayPal Bank 3,--,$68.35,"$843,349.73"
Donations directed by individuals,09/23/2023,Deposit,2N452540WE0710112,04 PAYPAL GENERAL UNRESTR,Money in to PayPal,Contributed income:Donations directed by individuals,PayPal Bank 3,$72.00,"$843,421.73"
PayPal Fees,09/23/2023,Deposit,2N452540WE0710112,04 PAYPAL GENERAL UNRESTR,PayPal fees,OFFICE/GENERAL ADMINISTRATIVE EXPENSES:PayPal Fees,PayPal Bank 3,$3.65,"$843,425.38"
PayPal Bank 3,09/23/2023,Deposit,1MC338694E646300A,04 PAYPAL GENERAL UNRESTR,"Subject: GeneralPage
Transaction ID: 1MC338694E646300A
https://www.paypal.com/activity/payment/1MC338694E646300A",PayPal Bank 3,--,$18.63,"$843,444.01"
Donations directed by individuals,09/23/2023,Deposit,1MC338694E646300A,04 PAYPAL GENERAL UNRESTR,Support Ukraine - Support Ukraine,Contributed income:Donations directed by individuals,PayPal Bank 3,$20.00,"$843,464.01"
PayPal Fees,09/23/2023,Deposit,1MC338694E646300A,04 PAYPAL GENERAL UNRESTR,PayPal fees,OFFICE/GENERAL ADMINISTRATIVE EXPENSES:PayPal Fees,PayPal Bank 3,$1.37,"$843,465.38"
PayPal Bank 3,09/23/2023,Deposit,1FG45592EE1637307,04 PAYPAL GENERAL UNRESTR,"Subject: GeneralPage
Transaction ID: 1FG45592EE1637307
https://www.paypal.com/activity/payment/1FG45592EE1637307",PayPal Bank 3,--,$9.84,"$843,475.22"
Donations directed by individuals,09/23/2023,Deposit,1FG45592EE1637307,04 PAYPAL GENERAL UNRESTR,Support Ukraine - Support Ukraine,Contributed income:Donations directed by individuals,PayPal Bank 3,$10.80,"$843,486.02"
PayPal Fees,09/23/2023,Deposit,1FG45592EE1637307,04 PAYPAL GENERAL UNRESTR,PayPal fees,OFFICE/GENERAL ADMINISTRATIVE EXPENSES:PayPal Fees,PayPal Bank 3,$0.96,"$843,486.98"
PayPal Bank 3,09/23/2023,Deposit,5M354627576369410,04 PAYPAL GENERAL UNRESTR,"Subject: GeneralPage
Transaction ID: 5M354627576369410
https://www.paypal.com/activity/payment/5M354627576369410",PayPal Bank 3,--,$10.00,"$843,496.98"
Donations directed by individuals,09/23/2023,Deposit,5M354627576369410,04 PAYPAL GENERAL UNRESTR,Support Ukraine - Support Ukraine,Contributed income:Donations directed by individuals,PayPal Bank 3,$10.80,"$843,507.78"
PayPal Fees,09/23/2023,Deposit,5M354627576369410,04 PAYPAL GENERAL UNRESTR,PayPal fees,OFFICE/GENERAL ADMINISTRATIVE EXPENSES:PayPal Fees,PayPal Bank 3,$0.80,"$843,508.58"
PayPal Bank 3,09/23/2023,Deposit,27V426915A739560P,04 PAYPAL GENERAL UNRESTR,"Subject: GeneralPage
Transaction ID: 27V426915A739560P
https://www.paypal.com/activity/payment/27V426915A739560P",PayPal Bank 3,--,$18.63,"$843,527.21"
Donations directed by individuals,09/23/2023,Deposit,27V426915A739560P,04 PAYPAL GENERAL UNRESTR,Support Ukraine - Support Ukraine,Contributed income:Donations directed by individuals,PayPal Bank 3,$20.00,"$843,547.21"
PayPal Fees,09/23/2023,Deposit,27V426915A739560P,04 PAYPAL GENERAL UNRESTR,PayPal fees,OFFICE/GENERAL ADMINISTRATIVE EXPENSES:PayPal Fees,PayPal Bank 3,$1.37,"$843,548.58"
PayPal Bank 3,09/23/2023,Deposit,3C618808AR2257040,04 PAYPAL GENERAL UNRESTR,"Subject: GeneralPage
Transaction ID: 3C618808AR2257040
https://www.paypal.com/activity/payment/3C618808AR2257040",PayPal Bank 3,--,$573.17,"$844,121.75"
Donations directed by individuals,09/23/2023,Deposit,3C618808AR2257040,04 PAYPAL GENERAL UNRESTR,Support Ukraine - Support Ukraine,Contributed income:Donations directed by individuals,PayPal Bank 3,$600.00,"$844,721.75"
PayPal Fees,09/23/2023,Deposit,3C618808AR2257040,04 PAYPAL GENERAL UNRESTR,PayPal fees,OFFICE/GENERAL ADMINISTRATIVE EXPENSES:PayPal Fees,PayPal Bank 3,$26.83,"$844,748.58"
PayPal Bank 3,09/23/2023,Deposit,6LA926130F772364F,04 PAYPAL GENERAL UNRESTR,"Subject: Support Ukraine
Transaction ID: 6LA926130F772364F
https://www.paypal.com/activity/payment/6LA926130F772364F",PayPal Bank 3,--,$25.00,"$844,773.58"
Donations directed by individuals,09/23/2023,Deposit,6LA926130F772364F,04 PAYPAL GENERAL UNRESTR,Money in to PayPal,Contributed income:Donations directed by individuals,PayPal Bank 3,$26.25,"$844,799.83"
PayPal Fees,09/23/2023,Deposit,6LA926130F772364F,04 PAYPAL GENERAL UNRESTR,PayPal fees,OFFICE/GENERAL ADMINISTRATIVE EXPENSES:PayPal Fees,PayPal Bank 3,$1.25,"$844,801.08"
PayPal Bank 3,09/23/2023,Deposit,7TC55803EU842452E,04 PAYPAL GENERAL UNRESTR,"Subject: GeneralPage
Transaction ID: 7TC55803EU842452E
https://www.paypal.com/activity/payment/7TC55803EU842452E",PayPal Bank 3,--,$10.00,"$844,811.08"
Donations directed by individuals,09/23/2023,Deposit,7TC55803EU842452E,04 PAYPAL GENERAL UNRESTR,Support Ukraine - Support Ukraine,Contributed income:Donations directed by individuals,PayPal Bank 3,$10.80,"$844,821.88"
PayPal Fees,09/23/2023,Deposit,7TC55803EU842452E,04 PAYPAL GENERAL UNRESTR,PayPal fees,OFFICE/GENERAL ADMINISTRATIVE EXPENSES:PayPal Fees,PayPal Bank 3,$0.80,"$844,822.68"
PayPal Bank 3,09/23/2023,Deposit,87A864119M7028831,09 MSU RESTR,"Subject: MobileShowers
Transaction ID: 87A864119M7028831
https://www.paypal.com/activity/payment/87A864119M7028831",PayPal Bank 3,--,$50.00,"$844,872.68"
Donations directed by individuals,09/23/2023,Deposit,87A864119M7028831,09 MSU RESTR,Mobile Shower/Laundry Units - Mobile Shower/Laundry Units,Contributed income:Donations directed by individuals,PayPal Bank 3,$51.99,"$844,924.67"
PayPal Fees,09/23/2023,Deposit,87A864119M7028831,09 MSU RESTR,PayPal fees,OFFICE/GENERAL ADMINISTRATIVE EXPENSES:PayPal Fees,PayPal Bank 3,$1.99,"$844,926.66"
PayPal Bank 3,09/23/2023,Deposit,41M87093N3869842C,04 PAYPAL GENERAL UNRESTR,"Subject: GeneralPage
Note: Перемоги!
Transaction ID: 41M87093N3869842C
https://www.paypal.com/activity/payment/41M87093N3869842C",PayPal Bank 3,--,$96.62,"$845,023.28"
Donations directed by individuals,09/23/2023,Deposit,41M87093N3869842C,04 PAYPAL GENERAL UNRESTR,Support Ukraine - Support Ukraine,Contributed income:Donations directed by individuals,PayPal Bank 3,$100.00,"$845,123.28"
PayPal Fees,09/23/2023,Deposit,41M87093N3869842C,04 PAYPAL GENERAL UNRESTR,PayPal fees,OFFICE/GENERAL ADMINISTRATIVE EXPENSES:PayPal Fees,PayPal Bank 3,$3.38,"$845,126.66"
PayPal Bank 3,09/23/2023,Deposit,3SP39270C71594228,04 PAYPAL GENERAL UNRESTR,"Subject: GeneralPage
Transaction ID: 3SP39270C71594228
https://www.paypal.com/activity/payment/3SP39270C71594228",PayPal Bank 3,--,$98.45,"$845,225.11"
Donations directed by individuals,09/23/2023,Deposit,3SP39270C71594228,04 PAYPAL GENERAL UNRESTR,Support Ukraine - Support Ukraine,Contributed income:Donations directed by individuals,PayPal Bank 3,$103.48,"$845,328.59"
PayPal Fees,09/23/2023,Deposit,3SP39270C71594228,04 PAYPAL GENERAL UNRESTR,PayPal fees,OFFICE/GENERAL ADMINISTRATIVE EXPENSES:PayPal Fees,PayPal Bank 3,$5.03,"$845,333.62"
PayPal Bank 3,09/23/2023,Deposit,3Y654211L40021317,04 PAYPAL GENERAL UNRESTR,"Subject: GeneralPage
Transaction ID: 3Y654211L40021317
https://www.paypal.com/activity/payment/3Y654211L40021317",PayPal Bank 3,--,$984.54,"$846,318.16"
Donations directed by individuals,09/23/2023,Deposit,3Y654211L40021317,04 PAYPAL GENERAL UNRESTR,Support Ukraine - Support Ukraine,Contributed income:Donations directed by individuals,PayPal Bank 3,"$1,030.26","$847,348.42"
PayPal Fees,09/23/2023,Deposit,3Y654211L40021317,04 PAYPAL GENERAL UNRESTR,PayPal fees,OFFICE/GENERAL ADMINISTRATIVE EXPENSES:PayPal Fees,PayPal Bank 3,$45.72,"$847,394.14"
PayPal Bank 3,09/23/2023,Deposit,15G722802H1349144,04 PAYPAL GENERAL UNRESTR,"Subject: GeneralPage
Transaction ID: 15G722802H1349144
https://www.paypal.com/activity/payment/15G722802H1349144",PayPal Bank 3,--,$47.31,"$847,441.45"
Donations directed by individuals,09/23/2023,Deposit,15G722802H1349144,04 PAYPAL GENERAL UNRESTR,Support Ukraine - Support Ukraine,Contributed income:Donations directed by individuals,PayPal Bank 3,$50.00,"$847,491.45"
PayPal Fees,09/23/2023,Deposit,15G722802H1349144,04 PAYPAL GENERAL UNRESTR,PayPal fees,OFFICE/GENERAL ADMINISTRATIVE EXPENSES:PayPal Fees,PayPal Bank 3,$2.69,"$847,494.14"
PayPal Bank 3,09/23/2023,Deposit,5B9100439A804150B,04 PAYPAL GENERAL UNRESTR,"Subject: GeneralPage
Transaction ID: 5B9100439A804150B
https://www.paypal.com/activity/payment/5B9100439A804150B",PayPal Bank 3,--,$10.03,"$847,504.17"
Donations directed by individuals,09/23/2023,Deposit,5B9100439A804150B,04 PAYPAL GENERAL UNRESTR,Support Ukraine - Support Ukraine,Contributed income:Donations directed by individuals,PayPal Bank 3,$11.00,"$847,515.17"
PayPal Fees,09/23/2023,Deposit,5B9100439A804150B,04 PAYPAL GENERAL UNRESTR,PayPal fees,OFFICE/GENERAL ADMINISTRATIVE EXPENSES:PayPal Fees,PayPal Bank 3,$0.97,"$847,516.14"
PayPal Bank 3,09/23/2023,Deposit,6BG11488WG6022540,04 PAYPAL GENERAL UNRESTR,"Subject: GeneralPage
Transaction ID: 6BG11488WG6022540
https://www.paypal.com/activity/payment/6BG11488WG6022540",PayPal Bank 3,--,$100.00,"$847,616.14"
Donations directed by individuals,09/23/2023,Deposit,6BG11488WG6022540,04 PAYPAL GENERAL UNRESTR,Support Ukraine - Support Ukraine,Contributed income:Donations directed by individuals,PayPal Bank 3,$103.48,"$847,719.62"
PayPal Fees,09/23/2023,Deposit,6BG11488WG6022540,04 PAYPAL GENERAL UNRESTR,PayPal fees,OFFICE/GENERAL ADMINISTRATIVE EXPENSES:PayPal Fees,PayPal Bank 3,$3.48,"$847,723.10"
PayPal Bank 3,09/23/2023,Deposit,05G85339LU7645050,04 PAYPAL GENERAL UNRESTR,"Subject: GeneralPage
Transaction ID: 05G85339LU7645050
https://www.paypal.com/activity/payment/05G85339LU7645050",PayPal Bank 3,--,$9.84,"$847,732.94"
Donations directed by individuals,09/23/2023,Deposit,05G85339LU7645050,04 PAYPAL GENERAL UNRESTR,Support Ukraine - Support Ukraine,Contributed income:Donations directed by individuals,PayPal Bank 3,$10.80,"$847,743.74"
PayPal Fees,09/23/2023,Deposit,05G85339LU7645050,04 PAYPAL GENERAL UNRESTR,PayPal fees,OFFICE/GENERAL ADMINISTRATIVE EXPENSES:PayPal Fees,PayPal Bank 3,$0.96,"$847,744.70"
PayPal Bank 3,09/23/2023,Deposit,9P0181737J220641C,04 PAYPAL GENERAL UNRESTR,"Subject: Support Ukraine
Transaction ID: 9P0181737J220641C
https://www.paypal.com/activity/payment/9P0181737J220641C",PayPal Bank 3,--,$50.00,"$847,794.70"
Donations directed by individuals,09/23/2023,Deposit,9P0181737J220641C,04 PAYPAL GENERAL UNRESTR,Money in to PayPal,Contributed income:Donations directed by individuals,PayPal Bank 3,$51.99,"$847,846.69"
PayPal Fees,09/23/2023,Deposit,9P0181737J220641C,04 PAYPAL GENERAL UNRESTR,PayPal fees,OFFICE/GENERAL ADMINISTRATIVE EXPENSES:PayPal Fees,PayPal Bank 3,$1.99,"$847,848.68"
PayPal Bank 3,09/23/2023,Deposit,9CR412263F573374F,04 PAYPAL GENERAL UNRESTR,"Subject: GeneralPage
Transaction ID: 9CR412263F573374F
https://www.paypal.com/activity/payment/9CR412263F573374F",PayPal Bank 3,--,$47.31,"$847,895.99"
Donations directed by individuals,09/23/2023,Deposit,9CR412263F573374F,04 PAYPAL GENERAL UNRESTR,Support Ukraine - Support Ukraine,Contributed income:Donations directed by individuals,PayPal Bank 3,$50.00,"$847,945.99"
PayPal Fees,09/23/2023,Deposit,9CR412263F573374F,04 PAYPAL GENERAL UNRESTR,PayPal fees,OFFICE/GENERAL ADMINISTRATIVE EXPENSES:PayPal Fees,PayPal Bank 3,$2.69,"$847,948.68"
PayPal Bank 3,09/23/2023,Deposit,2L017920J00394738,08 VICTORY DRONES RESTR,"Subject: VictoryDrones
Transaction ID: 2L017920J00394738
https://www.paypal.com/activity/payment/2L017920J00394738",PayPal Bank 3,--,$196.91,"$848,145.59"
Donations directed by individuals,09/23/2023,Deposit,2L017920J00394738,08 VICTORY DRONES RESTR,VICTORY DRONES - VICTORY DRONES,Contributed income:Donations directed by individuals,PayPal Bank 3,$206.46,"$848,352.05"
PayPal Fees,09/23/2023,Deposit,2L017920J00394738,08 VICTORY DRONES RESTR,PayPal fees,OFFICE/GENERAL ADMINISTRATIVE EXPENSES:PayPal Fees,PayPal Bank 3,$9.55,"$848,361.60"
PayPal Bank 3,09/23/2023,Deposit,6JE19580R09840036,04 PAYPAL GENERAL UNRESTR,"Subject: GeneralPage
Transaction ID: 6JE19580R09840036
https://www.paypal.com/activity/payment/6JE19580R09840036",PayPal Bank 3,--,$100.00,"$848,461.60"
Donations directed by individuals,09/23/2023,Deposit,6JE19580R09840036,04 PAYPAL GENERAL UNRESTR,Support Ukraine - Support Ukraine,Contributed income:Donations directed by individuals,PayPal Bank 3,$103.48,"$848,565.08"
PayPal Fees,09/23/2023,Deposit,6JE19580R09840036,04 PAYPAL GENERAL UNRESTR,PayPal fees,OFFICE/GENERAL ADMINISTRATIVE EXPENSES:PayPal Fees,PayPal Bank 3,$3.48,"$848,568.56"
PayPal Bank 3,09/23/2023,Deposit,6A756323KH1457520,07 1000 DRONES RESTR,"Subject: GeneralPage
Note: Люті пташки
Transaction ID: 6A756323KH1457520
https://www.paypal.com/activity/payment/6A756323KH1457520",PayPal Bank 3,--,$9.84,"$848,578.40"
Donations directed by individuals,09/23/2023,Deposit,6A756323KH1457520,07 1000 DRONES RESTR,Support Ukraine - Support Ukraine,Contributed income:Donations directed by individuals,PayPal Bank 3,$10.80,"$848,589.20"
PayPal Fees,09/23/2023,Deposit,6A756323KH1457520,07 1000 DRONES RESTR,PayPal fees,OFFICE/GENERAL ADMINISTRATIVE EXPENSES:PayPal Fees,PayPal Bank 3,$0.96,"$848,590.16"
PayPal Bank 3,09/23/2023,Deposit,9PE68180J0923350B,04 PAYPAL GENERAL UNRESTR,"Subject: GeneralPage
Transaction ID: 9PE68180J0923350B
https://www.paypal.com/activity/payment/9PE68180J0923350B",PayPal Bank 3,--,$47.31,"$848,637.47"
Donations directed by individuals,09/23/2023,Deposit,9PE68180J0923350B,04 PAYPAL GENERAL UNRESTR,Support Ukraine - Support Ukraine,Contributed income:Donations directed by individuals,PayPal Bank 3,$50.00,"$848,687.47"
PayPal Fees,09/23/2023,Deposit,9PE68180J0923350B,04 PAYPAL GENERAL UNRESTR,PayPal fees,OFFICE/GENERAL ADMINISTRATIVE EXPENSES:PayPal Fees,PayPal Bank 3,$2.69,"$848,690.16"
PayPal Bank 3,09/23/2023,Deposit,37664817VU871930P,04 PAYPAL GENERAL UNRESTR,"Subject: Support Ukraine
Transaction ID: 37664817VU871930P
https://www.paypal.com/activity/payment/37664817VU871930P",PayPal Bank 3,--,$29.53,"$848,719.69"
Donations directed by individuals,09/23/2023,Deposit,37664817VU871930P,04 PAYPAL GENERAL UNRESTR,Money in to PayPal,Contributed income:Donations directed by individuals,PayPal Bank 3,$31.40,"$848,751.09"
PayPal Fees,09/23/2023,Deposit,37664817VU871930P,04 PAYPAL GENERAL UNRESTR,PayPal fees,OFFICE/GENERAL ADMINISTRATIVE EXPENSES:PayPal Fees,PayPal Bank 3,$1.87,"$848,752.96"
PayPal Bank 3,09/23/2023,Deposit,03585559M35562807,04 PAYPAL GENERAL UNRESTR,"Subject: GeneralPage
Transaction ID: 03585559M35562807
https://www.paypal.com/activity/payment/03585559M35562807",PayPal Bank 3,--,$48.06,"$848,801.02"
Donations directed by individuals,09/23/2023,Deposit,03585559M35562807,04 PAYPAL GENERAL UNRESTR,Support Ukraine - Support Ukraine,Contributed income:Donations directed by individuals,PayPal Bank 3,$50.00,"$848,851.02"
PayPal Fees,09/23/2023,Deposit,03585559M35562807,04 PAYPAL GENERAL UNRESTR,PayPal fees,OFFICE/GENERAL ADMINISTRATIVE EXPENSES:PayPal Fees,PayPal Bank 3,$1.94,"$848,852.96"
PayPal Bank 3,09/23/2023,Deposit,9RG15468123476822,04 PAYPAL GENERAL UNRESTR,"Subject: GeneralPage
Transaction ID: 9RG15468123476822
https://www.paypal.com/activity/payment/9RG15468123476822",PayPal Bank 3,--,$47.31,"$848,900.27"
Donations directed by individuals,09/23/2023,Deposit,9RG15468123476822,04 PAYPAL GENERAL UNRESTR,Support Ukraine - Support Ukraine,Contributed income:Donations directed by individuals,PayPal Bank 3,$50.00,"$848,950.27"
PayPal Fees,09/23/2023,Deposit,9RG15468123476822,04 PAYPAL GENERAL UNRESTR,PayPal fees,OFFICE/GENERAL ADMINISTRATIVE EXPENSES:PayPal Fees,PayPal Bank 3,$2.69,"$848,952.96"
PayPal Bank 3,09/23/2023,Deposit,207491312J495750Y,04 PAYPAL GENERAL UNRESTR,"Subject: GeneralPage
Note: Happy birthday, Marianna
Transaction ID: 207491312J495750Y
https://www.paypal.com/activity/payment/207491312J495750Y",PayPal Bank 3,--,$72.00,"$849,024.96"
Donations directed by individuals,09/23/2023,Deposit,207491312J495750Y,04 PAYPAL GENERAL UNRESTR,Support Ukraine - Support Ukraine,Contributed income:Donations directed by individuals,PayPal Bank 3,$74.65,"$849,099.61"
PayPal Fees,09/23/2023,Deposit,207491312J495750Y,04 PAYPAL GENERAL UNRESTR,PayPal fees,OFFICE/GENERAL ADMINISTRATIVE EXPENSES:PayPal Fees,PayPal Bank 3,$2.65,"$849,102.26"
PayPal Bank 3,09/23/2023,Deposit,081662594E7640217,04 PAYPAL GENERAL UNRESTR,"Subject: GeneralPage
Transaction ID: 081662594E7640217
https://www.paypal.com/activity/payment/081662594E7640217",PayPal Bank 3,--,$69.43,"$849,171.69"
Donations directed by individuals,09/23/2023,Deposit,081662594E7640217,04 PAYPAL GENERAL UNRESTR,Support Ukraine - Support Ukraine,Contributed income:Donations directed by individuals,PayPal Bank 3,$72.00,"$849,243.69"
PayPal Fees,09/23/2023,Deposit,081662594E7640217,04 PAYPAL GENERAL UNRESTR,PayPal fees,OFFICE/GENERAL ADMINISTRATIVE EXPENSES:PayPal Fees,PayPal Bank 3,$2.57,"$849,246.26"
PayPal Bank 3,09/23/2023,Deposit,8JW05024CY0969533,04 PAYPAL GENERAL UNRESTR,"Subject: GeneralPage
Note: Jaroslav Brodziuk donation
Transaction ID: 8JW05024CY0969533
https://www.paypal.com/activity/payment/8JW05024CY0969533",PayPal Bank 3,--,$71.22,"$849,317.48"
Donations directed by individuals,09/23/2023,Deposit,8JW05024CY0969533,04 PAYPAL GENERAL UNRESTR,Support Ukraine - Support Ukraine,Contributed income:Donations directed by individuals,PayPal Bank 3,$75.00,"$849,392.48"
PayPal Fees,09/23/2023,Deposit,8JW05024CY0969533,04 PAYPAL GENERAL UNRESTR,PayPal fees,OFFICE/GENERAL ADMINISTRATIVE EXPENSES:PayPal Fees,PayPal Bank 3,$3.78,"$849,396.26"
PayPal Bank 3,09/23/2023,Deposit,4VG38684JT042905G,09 MSU RESTR,"Subject: MobileShowers
Transaction ID: 4VG38684JT042905G
https://www.paypal.com/activity/payment/4VG38684JT042905G",PayPal Bank 3,--,$96.62,"$849,492.88"
Donations directed by individuals,09/23/2023,Deposit,4VG38684JT042905G,09 MSU RESTR,Mobile Shower/Laundry Units - Mobile Shower/Laundry Units,Contributed income:Donations directed by individuals,PayPal Bank 3,$100.00,"$849,592.88"
PayPal Fees,09/23/2023,Deposit,4VG38684JT042905G,09 MSU RESTR,PayPal fees,OFFICE/GENERAL ADMINISTRATIVE EXPENSES:PayPal Fees,PayPal Bank 3,$3.38,"$849,596.26"
PayPal Bank 3,09/23/2023,Deposit,95E83446LB4657205,04 PAYPAL GENERAL UNRESTR,"Subject: GeneralPage
Transaction ID: 95E83446LB4657205
https://www.paypal.com/activity/payment/95E83446LB4657205",PayPal Bank 3,--,$71.95,"$849,668.21"
Donations directed by individuals,09/23/2023,Deposit,95E83446LB4657205,04 PAYPAL GENERAL UNRESTR,Support Ukraine - Support Ukraine,Contributed income:Donations directed by individuals,PayPal Bank 3,$75.77,"$849,743.98"
PayPal Fees,09/23/2023,Deposit,95E83446LB4657205,04 PAYPAL GENERAL UNRESTR,PayPal fees,OFFICE/GENERAL ADMINISTRATIVE EXPENSES:PayPal Fees,PayPal Bank 3,$3.82,"$849,747.80"
PayPal Bank 3,09/23/2023,Deposit,4P268199SN602062L,04 PAYPAL GENERAL UNRESTR,"Subject: GeneralPage
Transaction ID: 4P268199SN602062L
https://www.paypal.com/activity/payment/4P268199SN602062L",PayPal Bank 3,--,$1.45,"$849,749.25"
Donations directed by individuals,09/23/2023,Deposit,4P268199SN602062L,04 PAYPAL GENERAL UNRESTR,Support Ukraine - Support Ukraine,Contributed income:Donations directed by individuals,PayPal Bank 3,$2.00,"$849,751.25"
PayPal Fees,09/23/2023,Deposit,4P268199SN602062L,04 PAYPAL GENERAL UNRESTR,PayPal fees,OFFICE/GENERAL ADMINISTRATIVE EXPENSES:PayPal Fees,PayPal Bank 3,$0.55,"$849,751.80"
PayPal Bank 3,09/23/2023,Deposit,8U86936893088584V,04 PAYPAL GENERAL UNRESTR,"Subject: GeneralPage
Transaction ID: 8U86936893088584V
https://www.paypal.com/activity/payment/8U86936893088584V",PayPal Bank 3,--,$50.00,"$849,801.80"
Donations directed by individuals,09/23/2023,Deposit,8U86936893088584V,04 PAYPAL GENERAL UNRESTR,Support Ukraine - Support Ukraine,Contributed income:Donations directed by individuals,PayPal Bank 3,$51.99,"$849,853.79"
PayPal Fees,09/23/2023,Deposit,8U86936893088584V,04 PAYPAL GENERAL UNRESTR,PayPal fees,OFFICE/GENERAL ADMINISTRATIVE EXPENSES:PayPal Fees,PayPal Bank 3,$1.99,"$849,855.78"
PayPal Bank 3,09/23/2023,Deposit,0N969317AG0359824,04 PAYPAL GENERAL UNRESTR,"Subject: GeneralPage
Transaction ID: 0N969317AG0359824
https://www.paypal.com/activity/payment/0N969317AG0359824",PayPal Bank 3,--,$9.07,"$849,864.85"
Donations directed by individuals,09/23/2023,Deposit,0N969317AG0359824,04 PAYPAL GENERAL UNRESTR,Support Ukraine - Support Ukraine,Contributed income:Donations directed by individuals,PayPal Bank 3,$10.00,"$849,874.85"
PayPal Fees,09/23/2023,Deposit,0N969317AG0359824,04 PAYPAL GENERAL UNRESTR,PayPal fees,OFFICE/GENERAL ADMINISTRATIVE EXPENSES:PayPal Fees,PayPal Bank 3,$0.93,"$849,875.78"
PayPal Bank 3,09/23/2023,Deposit,7WF56029GM4070053,04 PAYPAL GENERAL UNRESTR,"Subject: GeneralPage
Transaction ID: 7WF56029GM4070053
https://www.paypal.com/activity/payment/7WF56029GM4070053",PayPal Bank 3,--,$13.85,"$849,889.63"
Donations directed by individuals,09/23/2023,Deposit,7WF56029GM4070053,04 PAYPAL GENERAL UNRESTR,Support Ukraine - Support Ukraine,Contributed income:Donations directed by individuals,PayPal Bank 3,$15.00,"$849,904.63"
PayPal Fees,09/23/2023,Deposit,7WF56029GM4070053,04 PAYPAL GENERAL UNRESTR,PayPal fees,OFFICE/GENERAL ADMINISTRATIVE EXPENSES:PayPal Fees,PayPal Bank 3,$1.15,"$849,905.78"
PayPal Bank 3,09/23/2023,Deposit,50N321989A458870D,04 PAYPAL GENERAL UNRESTR,"Subject: Support Ukraine
Transaction ID: 50N321989A458870D
https://www.paypal.com/activity/payment/50N321989A458870D",PayPal Bank 3,--,$23.41,"$849,929.19"
Donations directed by individuals,09/23/2023,Deposit,50N321989A458870D,04 PAYPAL GENERAL UNRESTR,Money in to PayPal,Contributed income:Donations directed by individuals,PayPal Bank 3,$25.00,"$849,954.19"
PayPal Fees,09/23/2023,Deposit,50N321989A458870D,04 PAYPAL GENERAL UNRESTR,PayPal fees,OFFICE/GENERAL ADMINISTRATIVE EXPENSES:PayPal Fees,PayPal Bank 3,$1.59,"$849,955.78"
PayPal Bank 3,09/23/2023,Deposit,5C760368MC3329939,04 PAYPAL GENERAL UNRESTR,"Subject: Support Ukraine
Transaction ID: 5C760368MC3329939
https://www.paypal.com/activity/payment/5C760368MC3329939",PayPal Bank 3,--,$4.91,"$849,960.69"
Donations directed by individuals,09/23/2023,Deposit,5C760368MC3329939,04 PAYPAL GENERAL UNRESTR,Money in to PayPal,Contributed income:Donations directed by individuals,PayPal Bank 3,$5.65,"$849,966.34"
PayPal Fees,09/23/2023,Deposit,5C760368MC3329939,04 PAYPAL GENERAL UNRESTR,PayPal fees,OFFICE/GENERAL ADMINISTRATIVE EXPENSES:PayPal Fees,PayPal Bank 3,$0.74,"$849,967.08"
PayPal Bank 3,09/23/2023,Deposit,5R662146GU666393B,04 PAYPAL GENERAL UNRESTR,"Subject: Support Ukraine
Transaction ID: 5R662146GU666393B
https://www.paypal.com/activity/payment/5R662146GU666393B",PayPal Bank 3,--,$47.31,"$850,014.39"
Donations directed by individuals,09/23/2023,Deposit,5R662146GU666393B,04 PAYPAL GENERAL UNRESTR,Money in to PayPal,Contributed income:Donations directed by individuals,PayPal Bank 3,$50.00,"$850,064.39"
PayPal Fees,09/23/2023,Deposit,5R662146GU666393B,04 PAYPAL GENERAL UNRESTR,PayPal fees,OFFICE/GENERAL ADMINISTRATIVE EXPENSES:PayPal Fees,PayPal Bank 3,$2.69,"$850,067.08"
PayPal Bank 3,09/23/2023,Deposit,09J897853W000315S,04 PAYPAL GENERAL UNRESTR,"Subject: Support Ukraine
Transaction ID: 09J897853W000315S
https://www.paypal.com/activity/payment/09J897853W000315S",PayPal Bank 3,--,$18.63,"$850,085.71"
Donations directed by individuals,09/23/2023,Deposit,09J897853W000315S,04 PAYPAL GENERAL UNRESTR,Money in to PayPal,Contributed income:Donations directed by individuals,PayPal Bank 3,$20.00,"$850,105.71"
PayPal Fees,09/23/2023,Deposit,09J897853W000315S,04 PAYPAL GENERAL UNRESTR,PayPal fees,OFFICE/GENERAL ADMINISTRATIVE EXPENSES:PayPal Fees,PayPal Bank 3,$1.37,"$850,107.08"
PayPal Bank 3,09/23/2023,Deposit,5U8073034S135061Y,04 PAYPAL GENERAL UNRESTR,"Subject: GeneralPage
Note: Happy Birthday Inna Tuka! From, Natalia Lekh
Transaction ID: 5U8073034S135061Y
https://www.paypal.com/activity/payment/5U8073034S135061Y",PayPal Bank 3,--,$49.22,"$850,156.30"
Donations directed by individuals,09/23/2023,Deposit,5U8073034S135061Y,04 PAYPAL GENERAL UNRESTR,Support Ukraine - Support Ukraine,Contributed income:Donations directed by individuals,PayPal Bank 3,$51.99,"$850,208.29"
PayPal Fees,09/23/2023,Deposit,5U8073034S135061Y,04 PAYPAL GENERAL UNRESTR,PayPal fees,OFFICE/GENERAL ADMINISTRATIVE EXPENSES:PayPal Fees,PayPal Bank 3,$2.77,"$850,211.06"
PayPal Bank 3,09/23/2023,Deposit,4TH11042B5439180G,04 PAYPAL GENERAL UNRESTR,"Subject: GeneralPage
Transaction ID: 4TH11042B5439180G
https://www.paypal.com/activity/payment/4TH11042B5439180G",PayPal Bank 3,--,$9.07,"$850,220.13"
Donations directed by individuals,09/23/2023,Deposit,4TH11042B5439180G,04 PAYPAL GENERAL UNRESTR,Support Ukraine - Support Ukraine,Contributed income:Donations directed by individuals,PayPal Bank 3,$10.00,"$850,230.13"
PayPal Fees,09/23/2023,Deposit,4TH11042B5439180G,04 PAYPAL GENERAL UNRESTR,PayPal fees,OFFICE/GENERAL ADMINISTRATIVE EXPENSES:PayPal Fees,PayPal Bank 3,$0.93,"$850,231.06"
PayPal Bank 3,09/23/2023,Deposit,2UC04447XP4002048,04 PAYPAL GENERAL UNRESTR,"Subject: GeneralPage
Transaction ID: 2UC04447XP4002048
https://www.paypal.com/activity/payment/2UC04447XP4002048",PayPal Bank 3,--,$48.06,"$850,279.12"
Donations directed by individuals,09/23/2023,Deposit,2UC04447XP4002048,04 PAYPAL GENERAL UNRESTR,Support Ukraine - Support Ukraine,Contributed income:Donations directed by individuals,PayPal Bank 3,$50.00,"$850,329.12"
PayPal Fees,09/23/2023,Deposit,2UC04447XP4002048,04 PAYPAL GENERAL UNRESTR,PayPal fees,OFFICE/GENERAL ADMINISTRATIVE EXPENSES:PayPal Fees,PayPal Bank 3,$1.94,"$850,331.06"
PayPal Bank 3,09/23/2023,Deposit,2SE78293DW442571W,04 PAYPAL GENERAL UNRESTR,"Subject: Support Ukraine
Transaction ID: 2SE78293DW442571W
https://www.paypal.com/activity/payment/2SE78293DW442571W",PayPal Bank 3,--,$100.00,"$850,431.06"
Donations directed by individuals,09/23/2023,Deposit,2SE78293DW442571W,04 PAYPAL GENERAL UNRESTR,Money in to PayPal,Contributed income:Donations directed by individuals,PayPal Bank 3,$103.48,"$850,534.54"
PayPal Fees,09/23/2023,Deposit,2SE78293DW442571W,04 PAYPAL GENERAL UNRESTR,PayPal fees,OFFICE/GENERAL ADMINISTRATIVE EXPENSES:PayPal Fees,PayPal Bank 3,$3.48,"$850,538.02"
PayPal Bank 3,09/23/2023,Deposit,6GW48357TF3167051,04 PAYPAL GENERAL UNRESTR,"Subject: GeneralPage
Note: Слава Україні ��
Transaction ID: 6GW48357TF3167051
https://www.paypal.com/activity/payment/6GW48357TF3167051",PayPal Bank 3,--,$14.76,"$850,552.78"
Donations directed by individuals,09/23/2023,Deposit,6GW48357TF3167051,04 PAYPAL GENERAL UNRESTR,Support Ukraine - Support Ukraine,Contributed income:Donations directed by individuals,PayPal Bank 3,$15.95,"$850,568.73"
PayPal Fees,09/23/2023,Deposit,6GW48357TF3167051,04 PAYPAL GENERAL UNRESTR,PayPal fees,OFFICE/GENERAL ADMINISTRATIVE EXPENSES:PayPal Fees,PayPal Bank 3,$1.19,"$850,569.92"
PayPal Bank 3,09/23/2023,Deposit,19W44458UA0082448,08 VICTORY DRONES RESTR,"Subject: VictoryDrones
Transaction ID: 19W44458UA0082448
https://www.paypal.com/activity/payment/19W44458UA0082448",PayPal Bank 3,--,$290.84,"$850,860.76"
Donations directed by individuals,09/23/2023,Deposit,19W44458UA0082448,08 VICTORY DRONES RESTR,VICTORY DRONES - VICTORY DRONES,Contributed income:Donations directed by individuals,PayPal Bank 3,$300.00,"$851,160.76"
PayPal Fees,09/23/2023,Deposit,19W44458UA0082448,08 VICTORY DRONES RESTR,PayPal fees,OFFICE/GENERAL ADMINISTRATIVE EXPENSES:PayPal Fees,PayPal Bank 3,$9.16,"$851,169.92"
PayPal Bank 3,09/23/2023,Deposit,63X69138KA049252M,04 PAYPAL GENERAL UNRESTR,"Subject: GeneralPage
Transaction ID: 63X69138KA049252M
https://www.paypal.com/activity/payment/63X69138KA049252M",PayPal Bank 3,--,$47.31,"$851,217.23"
Donations directed by individuals,09/23/2023,Deposit,63X69138KA049252M,04 PAYPAL GENERAL UNRESTR,Support Ukraine - Support Ukraine,Contributed income:Donations directed by individuals,PayPal Bank 3,$50.00,"$851,267.23"
PayPal Fees,09/23/2023,Deposit,63X69138KA049252M,04 PAYPAL GENERAL UNRESTR,PayPal fees,OFFICE/GENERAL ADMINISTRATIVE EXPENSES:PayPal Fees,PayPal Bank 3,$2.69,"$851,269.92"
PayPal Bank 3,09/23/2023,Deposit,9D33126395002631C,08 VICTORY DRONES RESTR,"Subject: VictoryDrones
Transaction ID: 9D33126395002631C
https://www.paypal.com/activity/payment/9D33126395002631C",PayPal Bank 3,--,$47.31,"$851,317.23"
Donations directed by individuals,09/23/2023,Deposit,9D33126395002631C,08 VICTORY DRONES RESTR,VICTORY DRONES - VICTORY DRONES,Contributed income:Donations directed by individuals,PayPal Bank 3,$50.00,"$851,367.23"
PayPal Fees,09/23/2023,Deposit,9D33126395002631C,08 VICTORY DRONES RESTR,PayPal fees,OFFICE/GENERAL ADMINISTRATIVE EXPENSES:PayPal Fees,PayPal Bank 3,$2.69,"$851,369.92"
PayPal Bank 3,09/23/2023,Deposit,3WL35463L54124920,07 1000 DRONES RESTR,"Subject: 1000DRONES
Transaction ID: 3WL35463L54124920
https://www.paypal.com/activity/payment/3WL35463L54124920",PayPal Bank 3,--,$98.45,"$851,468.37"
Donations directed by individuals,09/23/2023,Deposit,3WL35463L54124920,07 1000 DRONES RESTR,1000 DRONES FOR UKRAINE - 1000 DRONES FOR UKRAINE,Contributed income:Donations directed by individuals,PayPal Bank 3,$103.48,"$851,571.85"
PayPal Fees,09/23/2023,Deposit,3WL35463L54124920,07 1000 DRONES RESTR,PayPal fees,OFFICE/GENERAL ADMINISTRATIVE EXPENSES:PayPal Fees,PayPal Bank 3,$5.03,"$851,576.88"
PayPal Bank 3,09/23/2023,Deposit,9TC921050Y485921X,04 PAYPAL GENERAL UNRESTR,"Subject: GeneralPage
Transaction ID: 9TC921050Y485921X
https://www.paypal.com/activity/payment/9TC921050Y485921X",PayPal Bank 3,--,$118.14,"$851,695.02"
Donations directed by individuals,09/23/2023,Deposit,9TC921050Y485921X,04 PAYPAL GENERAL UNRESTR,Support Ukraine - Support Ukraine,Contributed income:Donations directed by individuals,PayPal Bank 3,$124.08,"$851,819.10"
PayPal Fees,09/23/2023,Deposit,9TC921050Y485921X,04 PAYPAL GENERAL UNRESTR,PayPal fees,OFFICE/GENERAL ADMINISTRATIVE EXPENSES:PayPal Fees,PayPal Bank 3,$5.94,"$851,825.04"
PayPal Bank 3,09/23/2023,Deposit,3AA88442BG777454U,04 PAYPAL GENERAL UNRESTR,"Subject: Support Ukraine
Transaction ID: 3AA88442BG777454U
https://www.paypal.com/activity/payment/3AA88442BG777454U",PayPal Bank 3,--,$50.00,"$851,875.04"
Donations directed by individuals,09/23/2023,Deposit,3AA88442BG777454U,04 PAYPAL GENERAL UNRESTR,Money in to PayPal,Contributed income:Donations directed by individuals,PayPal Bank 3,$51.99,"$851,927.03"
PayPal Fees,09/23/2023,Deposit,3AA88442BG777454U,04 PAYPAL GENERAL UNRESTR,PayPal fees,OFFICE/GENERAL ADMINISTRATIVE EXPENSES:PayPal Fees,PayPal Bank 3,$1.99,"$851,929.02"
PayPal Bank 3,09/23/2023,Deposit,2FD93918MS2779318,04 PAYPAL GENERAL UNRESTR,"Subject: GeneralPage
Transaction ID: 2FD93918MS2779318
https://www.paypal.com/activity/payment/2FD93918MS2779318",PayPal Bank 3,--,$100.00,"$852,029.02"
Donations directed by individuals,09/23/2023,Deposit,2FD93918MS2779318,04 PAYPAL GENERAL UNRESTR,Support Ukraine - Support Ukraine,Contributed income:Donations directed by individuals,PayPal Bank 3,$103.48,"$852,132.50"
PayPal Fees,09/23/2023,Deposit,2FD93918MS2779318,04 PAYPAL GENERAL UNRESTR,PayPal fees,OFFICE/GENERAL ADMINISTRATIVE EXPENSES:PayPal Fees,PayPal Bank 3,$3.48,"$852,135.98"
PayPal Bank 3,09/23/2023,Deposit,7W707089VE5282218,04 PAYPAL GENERAL UNRESTR,"Subject: GeneralPage
Transaction ID: 7W707089VE5282218
https://www.paypal.com/activity/payment/7W707089VE5282218",PayPal Bank 3,--,$1.96,"$852,137.94"
Donations directed by individuals,09/23/2023,Deposit,7W707089VE5282218,04 PAYPAL GENERAL UNRESTR,Support Ukraine - Support Ukraine,Contributed income:Donations directed by individuals,PayPal Bank 3,$2.56,"$852,140.50"
PayPal Fees,09/23/2023,Deposit,7W707089VE5282218,04 PAYPAL GENERAL UNRESTR,PayPal fees,OFFICE/GENERAL ADMINISTRATIVE EXPENSES:PayPal Fees,PayPal Bank 3,$0.60,"$852,141.10"
PayPal Bank 3,09/23/2023,Deposit,665936122T2080605,04 PAYPAL GENERAL UNRESTR,"Subject: Support Ukraine
Transaction ID: 665936122T2080605
https://www.paypal.com/activity/payment/665936122T2080605",PayPal Bank 3,--,$25.00,"$852,166.10"
Donations directed by individuals,09/23/2023,Deposit,665936122T2080605,04 PAYPAL GENERAL UNRESTR,Money in to PayPal,Contributed income:Donations directed by individuals,PayPal Bank 3,$26.25,"$852,192.35"
PayPal Fees,09/23/2023,Deposit,665936122T2080605,04 PAYPAL GENERAL UNRESTR,PayPal fees,OFFICE/GENERAL ADMINISTRATIVE EXPENSES:PayPal Fees,PayPal Bank 3,$1.25,"$852,193.60"
PayPal Bank 3,09/23/2023,Deposit,44C66672X45984817,04 PAYPAL GENERAL UNRESTR,"Subject: Support Ukraine
Transaction ID: 44C66672X45984817
https://www.paypal.com/activity/payment/44C66672X45984817",PayPal Bank 3,--,$47.31,"$852,240.91"
Donations directed by individuals,09/23/2023,Deposit,44C66672X45984817,04 PAYPAL GENERAL UNRESTR,Money in to PayPal,Contributed income:Donations directed by individuals,PayPal Bank 3,$50.00,"$852,290.91"
PayPal Fees,09/23/2023,Deposit,44C66672X45984817,04 PAYPAL GENERAL UNRESTR,PayPal fees,OFFICE/GENERAL ADMINISTRATIVE EXPENSES:PayPal Fees,PayPal Bank 3,$2.69,"$852,293.60"
PayPal Bank 3,09/23/2023,Deposit,0EG06841430515333,04 PAYPAL GENERAL UNRESTR,"Subject: Support Ukraine
Transaction ID: 0EG06841430515333
https://www.paypal.com/activity/payment/0EG06841430515333",PayPal Bank 3,--,$50.00,"$852,343.60"
Donations directed by individuals,09/23/2023,Deposit,0EG06841430515333,04 PAYPAL GENERAL UNRESTR,Money in to PayPal,Contributed income:Donations directed by individuals,PayPal Bank 3,$51.99,"$852,395.59"
PayPal Fees,09/23/2023,Deposit,0EG06841430515333,04 PAYPAL GENERAL UNRESTR,PayPal fees,OFFICE/GENERAL ADMINISTRATIVE EXPENSES:PayPal Fees,PayPal Bank 3,$1.99,"$852,397.58"
PayPal Bank 3,09/23/2023,Deposit,7NV05535BS2112334,04 PAYPAL GENERAL UNRESTR,"Subject: GeneralPage
Transaction ID: 7NV05535BS2112334
https://www.paypal.com/activity/payment/7NV05535BS2112334",PayPal Bank 3,--,$118.14,"$852,515.72"
Donations directed by individuals,09/23/2023,Deposit,7NV05535BS2112334,04 PAYPAL GENERAL UNRESTR,Support Ukraine - Support Ukraine,Contributed income:Donations directed by individuals,PayPal Bank 3,$124.08,"$852,639.80"
PayPal Fees,09/23/2023,Deposit,7NV05535BS2112334,04 PAYPAL GENERAL UNRESTR,PayPal fees,OFFICE/GENERAL ADMINISTRATIVE EXPENSES:PayPal Fees,PayPal Bank 3,$5.94,"$852,645.74"
PayPal Bank 3,09/23/2023,Deposit,1TK47758J95155925,04 PAYPAL GENERAL UNRESTR,"Subject: GeneralPage
Transaction ID: 1TK47758J95155925
https://www.paypal.com/activity/payment/1TK47758J95155925",PayPal Bank 3,--,$23.79,"$852,669.53"
Donations directed by individuals,09/23/2023,Deposit,1TK47758J95155925,04 PAYPAL GENERAL UNRESTR,Support Ukraine - Support Ukraine,Contributed income:Donations directed by individuals,PayPal Bank 3,$25.00,"$852,694.53"
PayPal Fees,09/23/2023,Deposit,1TK47758J95155925,04 PAYPAL GENERAL UNRESTR,PayPal fees,OFFICE/GENERAL ADMINISTRATIVE EXPENSES:PayPal Fees,PayPal Bank 3,$1.21,"$852,695.74"
PayPal Bank 3,09/23/2023,Deposit,5J440345H84215503,08 VICTORY DRONES RESTR,"Subject: VictoryDrones
Transaction ID: 5J440345H84215503
https://www.paypal.com/activity/payment/5J440345H84215503",PayPal Bank 3,--,$9.07,"$852,704.81"
Donations directed by individuals,09/23/2023,Deposit,5J440345H84215503,08 VICTORY DRONES RESTR,VICTORY DRONES - VICTORY DRONES,Contributed income:Donations directed by individuals,PayPal Bank 3,$10.00,"$852,714.81"
PayPal Fees,09/23/2023,Deposit,5J440345H84215503,08 VICTORY DRONES RESTR,PayPal fees,OFFICE/GENERAL ADMINISTRATIVE EXPENSES:PayPal Fees,PayPal Bank 3,$0.93,"$852,715.74"
PayPal Bank 3,09/23/2023,Deposit,55G66731BS528610X,04 PAYPAL GENERAL UNRESTR,"Subject: GeneralPage
Transaction ID: 55G66731BS528610X
https://www.paypal.com/activity/payment/55G66731BS528610X",PayPal Bank 3,--,$14.76,"$852,730.50"
Donations directed by individuals,09/23/2023,Deposit,55G66731BS528610X,04 PAYPAL GENERAL UNRESTR,Support Ukraine - Support Ukraine,Contributed income:Donations directed by individuals,PayPal Bank 3,$15.95,"$852,746.45"
PayPal Fees,09/23/2023,Deposit,55G66731BS528610X,04 PAYPAL GENERAL UNRESTR,PayPal fees,OFFICE/GENERAL ADMINISTRATIVE EXPENSES:PayPal Fees,PayPal Bank 3,$1.19,"$852,747.64"
PayPal Bank 3,09/23/2023,Deposit,0MN46735DC497164D,04 PAYPAL GENERAL UNRESTR,"Subject: GeneralPage
Transaction ID: 0MN46735DC497164D
https://www.paypal.com/activity/payment/0MN46735DC497164D",PayPal Bank 3,--,$200.00,"$852,947.64"
Donations directed by individuals,09/23/2023,Deposit,0MN46735DC497164D,04 PAYPAL GENERAL UNRESTR,Support Ukraine - Support Ukraine,Contributed income:Donations directed by individuals,PayPal Bank 3,$206.46,"$853,154.10"
PayPal Fees,09/23/2023,Deposit,0MN46735DC497164D,04 PAYPAL GENERAL UNRESTR,PayPal fees,OFFICE/GENERAL ADMINISTRATIVE EXPENSES:PayPal Fees,PayPal Bank 3,$6.46,"$853,160.56"
PayPal Bank 3,09/23/2023,Deposit,3M97511137419480A,04 PAYPAL GENERAL UNRESTR,"Subject: GeneralPage
Transaction ID: 3M97511137419480A
https://www.paypal.com/activity/payment/3M97511137419480A",PayPal Bank 3,--,$10.00,"$853,170.56"
Donations directed by individuals,09/23/2023,Deposit,3M97511137419480A,04 PAYPAL GENERAL UNRESTR,Support Ukraine - Support Ukraine,Contributed income:Donations directed by individuals,PayPal Bank 3,$10.80,"$853,181.36"
PayPal Fees,09/23/2023,Deposit,3M97511137419480A,04 PAYPAL GENERAL UNRESTR,PayPal fees,OFFICE/GENERAL ADMINISTRATIVE EXPENSES:PayPal Fees,PayPal Bank 3,$0.80,"$853,182.16"
PayPal Bank 3,09/23/2023,Deposit,9DC61277CU1149933,04 PAYPAL GENERAL UNRESTR,"Subject: GeneralPage
Transaction ID: 9DC61277CU1149933
https://www.paypal.com/activity/payment/9DC61277CU1149933",PayPal Bank 3,--,$668.78,"$853,850.94"
Donations directed by individuals,09/23/2023,Deposit,9DC61277CU1149933,04 PAYPAL GENERAL UNRESTR,Support Ukraine - Support Ukraine,Contributed income:Donations directed by individuals,PayPal Bank 3,$700.00,"$854,550.94"
PayPal Fees,09/23/2023,Deposit,9DC61277CU1149933,04 PAYPAL GENERAL UNRESTR,PayPal fees,OFFICE/GENERAL ADMINISTRATIVE EXPENSES:PayPal Fees,PayPal Bank 3,$31.22,"$854,582.16"
PayPal Bank 3,09/23/2023,Deposit,84G567561B1885244,10 Flight to Recovery RESTR,"Subject: FlightToRecovery
Note: Slava Ukraini, slava Geroyam!
Transaction ID: 84G567561B1885244
https://www.paypal.com/activity/payment/84G567561B1885244",PayPal Bank 3,--,$29.53,"$854,611.69"
Donations directed by individuals,09/23/2023,Deposit,84G567561B1885244,10 Flight to Recovery RESTR,Dignitas Ukraine Flight to Recovery - Dignitas Ukraine Flight to Recovery,Contributed income:Donations directed by individuals,PayPal Bank 3,$31.40,"$854,643.09"
PayPal Fees,09/23/2023,Deposit,84G567561B1885244,10 Flight to Recovery RESTR,PayPal fees,OFFICE/GENERAL ADMINISTRATIVE EXPENSES:PayPal Fees,PayPal Bank 3,$1.87,"$854,644.96"
PayPal Bank 3,09/23/2023,Deposit,7AR37534EM879264J,04 PAYPAL GENERAL UNRESTR,"Subject: GeneralPage
Transaction ID: 7AR37534EM879264J
https://www.paypal.com/activity/payment/7AR37534EM879264J",PayPal Bank 3,--,$100.00,"$854,744.96"
Donations directed by individuals,09/23/2023,Deposit,7AR37534EM879264J,04 PAYPAL GENERAL UNRESTR,Support Ukraine - Support Ukraine,Contributed income:Donations directed by individuals,PayPal Bank 3,$103.48,"$854,848.44"
PayPal Fees,09/23/2023,Deposit,7AR37534EM879264J,04 PAYPAL GENERAL UNRESTR,PayPal fees,OFFICE/GENERAL ADMINISTRATIVE EXPENSES:PayPal Fees,PayPal Bank 3,$3.48,"$854,851.92"
PayPal Bank 3,09/23/2023,Deposit,0TN73263CH345653C,04 PAYPAL GENERAL UNRESTR,"Subject: GeneralPage
Transaction ID: 0TN73263CH345653C
https://www.paypal.com/activity/payment/0TN73263CH345653C",PayPal Bank 3,--,$21.85,"$854,873.77"
Donations directed by individuals,09/23/2023,Deposit,0TN73263CH345653C,04 PAYPAL GENERAL UNRESTR,Support Ukraine - Support Ukraine,Contributed income:Donations directed by individuals,PayPal Bank 3,$23.00,"$854,896.77"
PayPal Fees,09/23/2023,Deposit,0TN73263CH345653C,04 PAYPAL GENERAL UNRESTR,PayPal fees,OFFICE/GENERAL ADMINISTRATIVE EXPENSES:PayPal Fees,PayPal Bank 3,$1.15,"$854,897.92"
PayPal Bank 3,09/23/2023,Deposit,8NV05107CS904944H,04 PAYPAL GENERAL UNRESTR,"Subject: GeneralPage
Transaction ID: 8NV05107CS904944H
https://www.paypal.com/activity/payment/8NV05107CS904944H",PayPal Bank 3,--,$50.00,"$854,947.92"
Donations directed by individuals,09/23/2023,Deposit,8NV05107CS904944H,04 PAYPAL GENERAL UNRESTR,Support Ukraine - Support Ukraine,Contributed income:Donations directed by individuals,PayPal Bank 3,$51.99,"$854,999.91"
PayPal Fees,09/23/2023,Deposit,8NV05107CS904944H,04 PAYPAL GENERAL UNRESTR,PayPal fees,OFFICE/GENERAL ADMINISTRATIVE EXPENSES:PayPal Fees,PayPal Bank 3,$1.99,"$855,001.90"
PayPal Bank 3,09/23/2023,Deposit,67H711754F231324B,09 MSU RESTR,"Subject: MobileShowers
Note: For mobile showers
Transaction ID: 67H711754F231324B
https://www.paypal.com/activity/payment/67H711754F231324B",PayPal Bank 3,--,$48.06,"$855,049.96"
Donations directed by individuals,09/23/2023,Deposit,67H711754F231324B,09 MSU RESTR,Mobile Shower/Laundry Units - Mobile Shower/Laundry Units,Contributed income:Donations directed by individuals,PayPal Bank 3,$50.00,"$855,099.96"
PayPal Fees,09/23/2023,Deposit,67H711754F231324B,09 MSU RESTR,PayPal fees,OFFICE/GENERAL ADMINISTRATIVE EXPENSES:PayPal Fees,PayPal Bank 3,$1.94,"$855,101.90"
PayPal Bank 3,09/23/2023,Deposit,38D17421C6583532P,04 PAYPAL GENERAL UNRESTR,"Subject: GeneralPage
Transaction ID: 38D17421C6583532P
https://www.paypal.com/activity/payment/38D17421C6583532P",PayPal Bank 3,--,$19.68,"$855,121.58"
Donations directed by individuals,09/23/2023,Deposit,38D17421C6583532P,04 PAYPAL GENERAL UNRESTR,Support Ukraine - Support Ukraine,Contributed income:Donations directed by individuals,PayPal Bank 3,$21.10,"$855,142.68"
PayPal Fees,09/23/2023,Deposit,38D17421C6583532P,04 PAYPAL GENERAL UNRESTR,PayPal fees,OFFICE/GENERAL ADMINISTRATIVE EXPENSES:PayPal Fees,PayPal Bank 3,$1.42,"$855,144.10"
PayPal Bank 3,09/23/2023,Deposit,0E07667699921560N,04 PAYPAL GENERAL UNRESTR,"Subject: GeneralPage
Transaction ID: 0E07667699921560N
https://www.paypal.com/activity/payment/0E07667699921560N",PayPal Bank 3,--,$45.00,"$855,189.10"
Donations directed by individuals,09/23/2023,Deposit,0E07667699921560N,04 PAYPAL GENERAL UNRESTR,Support Ukraine - Support Ukraine,Contributed income:Donations directed by individuals,PayPal Bank 3,$46.84,"$855,235.94"
PayPal Fees,09/23/2023,Deposit,0E07667699921560N,04 PAYPAL GENERAL UNRESTR,PayPal fees,OFFICE/GENERAL ADMINISTRATIVE EXPENSES:PayPal Fees,PayPal Bank 3,$1.84,"$855,237.78"
PayPal Bank 3,09/23/2023,Deposit,7CH95711MB5522415,07 1000 DRONES RESTR,"Subject: 1000DRONES
Transaction ID: 7CH95711MB5522415
https://www.paypal.com/activity/payment/7CH95711MB5522415",PayPal Bank 3,--,$98.45,"$855,336.23"
Donations directed by individuals,09/23/2023,Deposit,7CH95711MB5522415,07 1000 DRONES RESTR,1000 DRONES FOR UKRAINE - 1000 DRONES FOR UKRAINE,Contributed income:Donations directed by individuals,PayPal Bank 3,$103.48,"$855,439.71"
PayPal Fees,09/23/2023,Deposit,7CH95711MB5522415,07 1000 DRONES RESTR,PayPal fees,OFFICE/GENERAL ADMINISTRATIVE EXPENSES:PayPal Fees,PayPal Bank 3,$5.03,"$855,444.74"
PayPal Bank 3,09/23/2023,Deposit,9SB27171CE0989104,04 PAYPAL GENERAL UNRESTR,"Subject: GeneralPage
Transaction ID: 9SB27171CE0989104
https://www.paypal.com/activity/payment/9SB27171CE0989104",PayPal Bank 3,--,$19.68,"$855,464.42"
Donations directed by individuals,09/23/2023,Deposit,9SB27171CE0989104,04 PAYPAL GENERAL UNRESTR,Support Ukraine - Support Ukraine,Contributed income:Donations directed by individuals,PayPal Bank 3,$21.10,"$855,485.52"
PayPal Fees,09/23/2023,Deposit,9SB27171CE0989104,04 PAYPAL GENERAL UNRESTR,PayPal fees,OFFICE/GENERAL ADMINISTRATIVE EXPENSES:PayPal Fees,PayPal Bank 3,$1.42,"$855,486.94"
PayPal Bank 3,09/23/2023,Deposit,6EG27504D5378110H,04 PAYPAL GENERAL UNRESTR,"Subject: Support Ukraine
Transaction ID: 6EG27504D5378110H
https://www.paypal.com/activity/payment/6EG27504D5378110H",PayPal Bank 3,--,$98.45,"$855,585.39"
Donations directed by individuals,09/23/2023,Deposit,6EG27504D5378110H,04 PAYPAL GENERAL UNRESTR,Money in to PayPal,Contributed income:Donations directed by individuals,PayPal Bank 3,$103.48,"$855,688.87"
PayPal Fees,09/23/2023,Deposit,6EG27504D5378110H,04 PAYPAL GENERAL UNRESTR,PayPal fees,OFFICE/GENERAL ADMINISTRATIVE EXPENSES:PayPal Fees,PayPal Bank 3,$5.03,"$855,693.90"
PayPal Bank 3,09/23/2023,Deposit,74N40597CA078781W,04 PAYPAL GENERAL UNRESTR,"Subject: Support Ukraine
Transaction ID: 74N40597CA078781W
https://www.paypal.com/activity/payment/74N40597CA078781W",PayPal Bank 3,--,$20.75,"$855,714.65"
Donations directed by individuals,09/23/2023,Deposit,74N40597CA078781W,04 PAYPAL GENERAL UNRESTR,Money in to PayPal,Contributed income:Donations directed by individuals,PayPal Bank 3,$22.22,"$855,736.87"
PayPal Fees,09/23/2023,Deposit,74N40597CA078781W,04 PAYPAL GENERAL UNRESTR,PayPal fees,OFFICE/GENERAL ADMINISTRATIVE EXPENSES:PayPal Fees,PayPal Bank 3,$1.47,"$855,738.34"
PayPal Bank 3,09/23/2023,Deposit,9YF7297233882512E,07 1000 DRONES RESTR,"Subject: FlightToRecovery
Transaction ID: 9YF7297233882512E
https://www.paypal.com/activity/payment/9YF7297233882512E",PayPal Bank 3,--,$295.36,"$856,033.70"
Donations directed by individuals,09/23/2023,Deposit,9YF7297233882512E,07 1000 DRONES RESTR,Dignitas Ukraine Flight to Recovery - Dignitas Ukraine Flight to Recovery,Contributed income:Donations directed by individuals,PayPal Bank 3,$309.43,"$856,343.13"
PayPal Fees,09/23/2023,Deposit,9YF7297233882512E,07 1000 DRONES RESTR,PayPal fees,OFFICE/GENERAL ADMINISTRATIVE EXPENSES:PayPal Fees,PayPal Bank 3,$14.07,"$856,357.20"
PayPal Bank 3,09/23/2023,Deposit,26B35556SE0695930,10 Flight to Recovery RESTR,"Subject: 1000DRONES
Transaction ID: 26B35556SE0695930
https://www.paypal.com/activity/payment/26B35556SE0695930",PayPal Bank 3,--,$295.36,"$856,652.56"
Donations directed by individuals,09/23/2023,Deposit,26B35556SE0695930,10 Flight to Recovery RESTR,1000 DRONES FOR UKRAINE - 1000 DRONES FOR UKRAINE,Contributed income:Donations directed by individuals,PayPal Bank 3,$309.43,"$856,961.99"
PayPal Fees,09/23/2023,Deposit,26B35556SE0695930,10 Flight to Recovery RESTR,PayPal fees,OFFICE/GENERAL ADMINISTRATIVE EXPENSES:PayPal Fees,PayPal Bank 3,$14.07,"$856,976.06"
PayPal Bank 3,09/23/2023,Deposit,4K651821WW903705U,04 PAYPAL GENERAL UNRESTR,"Subject: GeneralPage
Note: Slava Ukraine!
Transaction ID: 4K651821WW903705U
https://www.paypal.com/activity/payment/4K651821WW903705U",PayPal Bank 3,--,$300.00,"$857,276.06"
Donations directed by individuals,09/23/2023,Deposit,4K651821WW903705U,04 PAYPAL GENERAL UNRESTR,Support Ukraine - Support Ukraine,Contributed income:Donations directed by individuals,PayPal Bank 3,$309.43,"$857,585.49"
PayPal Fees,09/23/2023,Deposit,4K651821WW903705U,04 PAYPAL GENERAL UNRESTR,PayPal fees,OFFICE/GENERAL ADMINISTRATIVE EXPENSES:PayPal Fees,PayPal Bank 3,$9.43,"$857,594.92"
PayPal Bank 3,09/23/2023,Deposit,0X237622YS963911F,07 1000 DRONES RESTR,"Subject: 1000DRONES
Transaction ID: 0X237622YS963911F
https://www.paypal.com/activity/payment/0X237622YS963911F",PayPal Bank 3,--,$5.00,"$857,599.92"
Donations directed by individuals,09/23/2023,Deposit,0X237622YS963911F,07 1000 DRONES RESTR,1000 DRONES FOR UKRAINE - 1000 DRONES FOR UKRAINE,Contributed income:Donations directed by individuals,PayPal Bank 3,$5.65,"$857,605.57"
PayPal Fees,09/23/2023,Deposit,0X237622YS963911F,07 1000 DRONES RESTR,PayPal fees,OFFICE/GENERAL ADMINISTRATIVE EXPENSES:PayPal Fees,PayPal Bank 3,$0.65,"$857,606.22"
PayPal Bank 3,09/23/2023,Deposit,1XN54743KS274452V,04 PAYPAL GENERAL UNRESTR,"Subject: GeneralPage
Transaction ID: 1XN54743KS274452V
https://www.paypal.com/activity/payment/1XN54743KS274452V",PayPal Bank 3,--,$98.45,"$857,704.67"
Donations directed by individuals,09/23/2023,Deposit,1XN54743KS274452V,04 PAYPAL GENERAL UNRESTR,Support Ukraine - Support Ukraine,Contributed income:Donations directed by individuals,PayPal Bank 3,$103.48,"$857,808.15"
PayPal Fees,09/23/2023,Deposit,1XN54743KS274452V,04 PAYPAL GENERAL UNRESTR,PayPal fees,OFFICE/GENERAL ADMINISTRATIVE EXPENSES:PayPal Fees,PayPal Bank 3,$5.03,"$857,813.18"
PayPal Bank 3,09/23/2023,Deposit,5YK56674N92542915,07 1000 DRONES RESTR,"Subject: 1000DRONES
Transaction ID: 5YK56674N92542915
https://www.paypal.com/activity/payment/5YK56674N92542915",PayPal Bank 3,--,$2.94,"$857,816.12"
Donations directed by individuals,09/23/2023,Deposit,5YK56674N92542915,07 1000 DRONES RESTR,1000 DRONES FOR UKRAINE - 1000 DRONES FOR UKRAINE,Contributed income:Donations directed by individuals,PayPal Bank 3,$3.59,"$857,819.71"
PayPal Fees,09/23/2023,Deposit,5YK56674N92542915,07 1000 DRONES RESTR,PayPal fees,OFFICE/GENERAL ADMINISTRATIVE EXPENSES:PayPal Fees,PayPal Bank 3,$0.65,"$857,820.36"
PayPal Bank 3,09/23/2023,Deposit,8S807441T9763502Y,08 VICTORY DRONES RESTR,"Subject: VICTORY DRONES
Transaction ID: 8S807441T9763502Y
https://www.paypal.com/activity/payment/8S807441T9763502Y",PayPal Bank 3,--,$2.94,"$857,823.30"
Donations directed by individuals,09/23/2023,Deposit,8S807441T9763502Y,08 VICTORY DRONES RESTR,Money in to PayPal,Contributed income:Donations directed by individuals,PayPal Bank 3,$3.59,"$857,826.89"
PayPal Fees,09/23/2023,Deposit,8S807441T9763502Y,08 VICTORY DRONES RESTR,PayPal fees,OFFICE/GENERAL ADMINISTRATIVE EXPENSES:PayPal Fees,PayPal Bank 3,$0.65,"$857,827.54"
PayPal Bank 3,09/23/2023,Deposit,02333359GX721791V,07 1000 DRONES RESTR,"Subject: 1000DRONES
Transaction ID: 02333359GX721791V
https://www.paypal.com/activity/payment/02333359GX721791V",PayPal Bank 3,--,$100.00,"$857,927.54"
Donations directed by individuals,09/23/2023,Deposit,02333359GX721791V,07 1000 DRONES RESTR,1000 DRONES FOR UKRAINE - 1000 DRONES FOR UKRAINE,Contributed income:Donations directed by individuals,PayPal Bank 3,$103.48,"$858,031.02"
PayPal Fees,09/23/2023,Deposit,02333359GX721791V,07 1000 DRONES RESTR,PayPal fees,OFFICE/GENERAL ADMINISTRATIVE EXPENSES:PayPal Fees,PayPal Bank 3,$3.48,"$858,034.50"
PayPal Bank 3,09/23/2023,Deposit,2Y2197616V9901540,04 PAYPAL GENERAL UNRESTR,"Subject: Support Ukraine
Transaction ID: 2Y2197616V9901540
https://www.paypal.com/activity/payment/2Y2197616V9901540",PayPal Bank 3,--,$98.45,"$858,132.95"
Donations directed by individuals,09/23/2023,Deposit,2Y2197616V9901540,04 PAYPAL GENERAL UNRESTR,Money in to PayPal,Contributed income:Donations directed by individuals,PayPal Bank 3,$103.48,"$858,236.43"
PayPal Fees,09/23/2023,Deposit,2Y2197616V9901540,04 PAYPAL GENERAL UNRESTR,PayPal fees,OFFICE/GENERAL ADMINISTRATIVE EXPENSES:PayPal Fees,PayPal Bank 3,$5.03,"$858,241.46"
PayPal Bank 3,09/23/2023,Deposit,07E60294H34378218,04 PAYPAL GENERAL UNRESTR,"Subject: Support Ukraine
Transaction ID: 07E60294H34378218
https://www.paypal.com/activity/payment/07E60294H34378218",PayPal Bank 3,--,$14.76,"$858,256.22"
Donations directed by individuals,09/23/2023,Deposit,07E60294H34378218,04 PAYPAL GENERAL UNRESTR,Money in to PayPal,Contributed income:Donations directed by individuals,PayPal Bank 3,$15.95,"$858,272.17"
PayPal Fees,09/23/2023,Deposit,07E60294H34378218,04 PAYPAL GENERAL UNRESTR,PayPal fees,OFFICE/GENERAL ADMINISTRATIVE EXPENSES:PayPal Fees,PayPal Bank 3,$1.19,"$858,273.36"
PayPal Bank 3,09/23/2023,Deposit,4SL68460G36896927,04 PAYPAL GENERAL UNRESTR,"Subject: GeneralPage
Transaction ID: 4SL68460G36896927
https://www.paypal.com/activity/payment/4SL68460G36896927",PayPal Bank 3,--,$9.84,"$858,283.20"
Donations directed by individuals,09/23/2023,Deposit,4SL68460G36896927,04 PAYPAL GENERAL UNRESTR,Support Ukraine - Support Ukraine,Contributed income:Donations directed by individuals,PayPal Bank 3,$10.80,"$858,294.00"
PayPal Fees,09/23/2023,Deposit,4SL68460G36896927,04 PAYPAL GENERAL UNRESTR,PayPal fees,OFFICE/GENERAL ADMINISTRATIVE EXPENSES:PayPal Fees,PayPal Bank 3,$0.96,"$858,294.96"
PayPal Bank 3,09/23/2023,Deposit,8DC64498GD116361B,04 PAYPAL GENERAL UNRESTR,"Subject: GeneralPage
Transaction ID: 8DC64498GD116361B
https://www.paypal.com/activity/payment/8DC64498GD116361B",PayPal Bank 3,--,$290.84,"$858,585.80"
Donations directed by individuals,09/23/2023,Deposit,8DC64498GD116361B,04 PAYPAL GENERAL UNRESTR,Support Ukraine - Support Ukraine,Contributed income:Donations directed by individuals,PayPal Bank 3,$300.00,"$858,885.80"
PayPal Fees,09/23/2023,Deposit,8DC64498GD116361B,04 PAYPAL GENERAL UNRESTR,PayPal fees,OFFICE/GENERAL ADMINISTRATIVE EXPENSES:PayPal Fees,PayPal Bank 3,$9.16,"$858,894.96"
PayPal Bank 3,09/23/2023,Deposit,5YH51490YR095101K,04 PAYPAL GENERAL UNRESTR,"Subject: GeneralPage
Transaction ID: 5YH51490YR095101K
https://www.paypal.com/activity/payment/5YH51490YR095101K",PayPal Bank 3,--,$100.00,"$858,994.96"
Donations directed by individuals,09/23/2023,Deposit,5YH51490YR095101K,04 PAYPAL GENERAL UNRESTR,Support Ukraine - Support Ukraine,Contributed income:Donations directed by individuals,PayPal Bank 3,$103.48,"$859,098.44"
PayPal Fees,09/23/2023,Deposit,5YH51490YR095101K,04 PAYPAL GENERAL UNRESTR,PayPal fees,OFFICE/GENERAL ADMINISTRATIVE EXPENSES:PayPal Fees,PayPal Bank 3,$3.48,"$859,101.92"
PayPal Bank 3,09/23/2023,Deposit,6PE84191X58083244,04 PAYPAL GENERAL UNRESTR,"Subject: Support Ukraine
Transaction ID: 6PE84191X58083244
https://www.paypal.com/activity/payment/6PE84191X58083244",PayPal Bank 3,--,$47.25,"$859,149.17"
Donations directed by individuals,09/23/2023,Deposit,6PE84191X58083244,04 PAYPAL GENERAL UNRESTR,Money in to PayPal,Contributed income:Donations directed by individuals,PayPal Bank 3,$49.93,"$859,199.10"
PayPal Fees,09/23/2023,Deposit,6PE84191X58083244,04 PAYPAL GENERAL UNRESTR,PayPal fees,OFFICE/GENERAL ADMINISTRATIVE EXPENSES:PayPal Fees,PayPal Bank 3,$2.68,"$859,201.78"
PayPal Bank 3,09/23/2023,Deposit,5XJ54888PE177950V,07 1000 DRONES RESTR,"Subject: 1000 DRONES FOR UKRAINE
Transaction ID: 5XJ54888PE177950V
https://www.paypal.com/activity/payment/5XJ54888PE177950V",PayPal Bank 3,--,$18.63,"$859,220.41"
Donations directed by individuals,09/23/2023,Deposit,5XJ54888PE177950V,07 1000 DRONES RESTR,Money in to PayPal,Contributed income:Donations directed by individuals,PayPal Bank 3,$20.00,"$859,240.41"
PayPal Fees,09/23/2023,Deposit,5XJ54888PE177950V,07 1000 DRONES RESTR,PayPal fees,OFFICE/GENERAL ADMINISTRATIVE EXPENSES:PayPal Fees,PayPal Bank 3,$1.37,"$859,241.78"
PayPal Bank 3,09/23/2023,Deposit,6PH31114W0689862R,04 PAYPAL GENERAL UNRESTR,"Subject: GeneralPage
Transaction ID: 6PH31114W0689862R
https://www.paypal.com/activity/payment/6PH31114W0689862R",PayPal Bank 3,--,$19.68,"$859,261.46"
Donations directed by individuals,09/23/2023,Deposit,6PH31114W0689862R,04 PAYPAL GENERAL UNRESTR,Support Ukraine - Support Ukraine,Contributed income:Donations directed by individuals,PayPal Bank 3,$21.10,"$859,282.56"
PayPal Fees,09/23/2023,Deposit,6PH31114W0689862R,04 PAYPAL GENERAL UNRESTR,PayPal fees,OFFICE/GENERAL ADMINISTRATIVE EXPENSES:PayPal Fees,PayPal Bank 3,$1.42,"$859,283.98"
PayPal Bank 3,09/23/2023,Deposit,37C00519VP726131D,04 PAYPAL GENERAL UNRESTR,"Subject: Support Ukraine
Transaction ID: 37C00519VP726131D
https://www.paypal.com/activity/payment/37C00519VP726131D",PayPal Bank 3,--,$9.84,"$859,293.82"
Donations directed by individuals,09/23/2023,Deposit,37C00519VP726131D,04 PAYPAL GENERAL UNRESTR,Money in to PayPal,Contributed income:Donations directed by individuals,PayPal Bank 3,$10.80,"$859,304.62"
PayPal Fees,09/23/2023,Deposit,37C00519VP726131D,04 PAYPAL GENERAL UNRESTR,PayPal fees,OFFICE/GENERAL ADMINISTRATIVE EXPENSES:PayPal Fees,PayPal Bank 3,$0.96,"$859,305.58"
PayPal Bank 3,09/23/2023,Deposit,0AR583669N117912H,04 PAYPAL GENERAL UNRESTR,"Subject: GeneralPage
Transaction ID: 0AR583669N117912H
https://www.paypal.com/activity/payment/0AR583669N117912H",PayPal Bank 3,--,$18.63,"$859,324.21"
Donations directed by individuals,09/23/2023,Deposit,0AR583669N117912H,04 PAYPAL GENERAL UNRESTR,Support Ukraine - Support Ukraine,Contributed income:Donations directed by individuals,PayPal Bank 3,$20.00,"$859,344.21"
PayPal Fees,09/23/2023,Deposit,0AR583669N117912H,04 PAYPAL GENERAL UNRESTR,PayPal fees,OFFICE/GENERAL ADMINISTRATIVE EXPENSES:PayPal Fees,PayPal Bank 3,$1.37,"$859,345.58"
PayPal Bank 3,09/23/2023,Deposit,0EP803740P980024N,04 PAYPAL GENERAL UNRESTR,"Subject: GeneralPage
Transaction ID: 0EP803740P980024N
https://www.paypal.com/activity/payment/0EP803740P980024N",PayPal Bank 3,--,$95.12,"$859,440.70"
Donations directed by individuals,09/23/2023,Deposit,0EP803740P980024N,04 PAYPAL GENERAL UNRESTR,Support Ukraine - Support Ukraine,Contributed income:Donations directed by individuals,PayPal Bank 3,$100.00,"$859,540.70"
PayPal Fees,09/23/2023,Deposit,0EP803740P980024N,04 PAYPAL GENERAL UNRESTR,PayPal fees,OFFICE/GENERAL ADMINISTRATIVE EXPENSES:PayPal Fees,PayPal Bank 3,$4.88,"$859,545.58"
PayPal Bank 3,09/23/2023,Deposit,9A624234D1132170G,04 PAYPAL GENERAL UNRESTR,"Subject: GeneralPage
Transaction ID: 9A624234D1132170G
https://www.paypal.com/activity/payment/9A624234D1132170G",PayPal Bank 3,--,$20.00,"$859,565.58"
Donations directed by individuals,09/23/2023,Deposit,9A624234D1132170G,04 PAYPAL GENERAL UNRESTR,Support Ukraine - Support Ukraine,Contributed income:Donations directed by individuals,PayPal Bank 3,$21.10,"$859,586.68"
PayPal Fees,09/23/2023,Deposit,9A624234D1132170G,04 PAYPAL GENERAL UNRESTR,PayPal fees,OFFICE/GENERAL ADMINISTRATIVE EXPENSES:PayPal Fees,PayPal Bank 3,$1.10,"$859,587.78"
PayPal Bank 3,09/23/2023,Deposit,3EW68326M7285463T,04 PAYPAL GENERAL UNRESTR,"Subject: GeneralPage
Transaction ID: 3EW68326M7285463T
https://www.paypal.com/activity/payment/3EW68326M7285463T",PayPal Bank 3,--,$9.84,"$859,597.62"
Donations directed by individuals,09/23/2023,Deposit,3EW68326M7285463T,04 PAYPAL GENERAL UNRESTR,Support Ukraine - Support Ukraine,Contributed income:Donations directed by individuals,PayPal Bank 3,$10.80,"$859,608.42"
PayPal Fees,09/23/2023,Deposit,3EW68326M7285463T,04 PAYPAL GENERAL UNRESTR,PayPal fees,OFFICE/GENERAL ADMINISTRATIVE EXPENSES:PayPal Fees,PayPal Bank 3,$0.96,"$859,609.38"
PayPal Bank 3,09/23/2023,Deposit,9BG3278120805054E,04 PAYPAL GENERAL UNRESTR,"Subject: GeneralPage
Transaction ID: 9BG3278120805054E
https://www.paypal.com/activity/payment/9BG3278120805054E",PayPal Bank 3,--,$98.45,"$859,707.83"
Donations directed by individuals,09/23/2023,Deposit,9BG3278120805054E,04 PAYPAL GENERAL UNRESTR,Support Ukraine - Support Ukraine,Contributed income:Donations directed by individuals,PayPal Bank 3,$103.48,"$859,811.31"
PayPal Fees,09/23/2023,Deposit,9BG3278120805054E,04 PAYPAL GENERAL UNRESTR,PayPal fees,OFFICE/GENERAL ADMINISTRATIVE EXPENSES:PayPal Fees,PayPal Bank 3,$5.03,"$859,816.34"
PayPal Bank 3,09/23/2023,Deposit,5KD90779WN431614W,04 PAYPAL GENERAL UNRESTR,"Subject: GeneralPage
Transaction ID: 5KD90779WN431614W
https://www.paypal.com/activity/payment/5KD90779WN431614W",PayPal Bank 3,--,$29.53,"$859,845.87"
Donations directed by individuals,09/23/2023,Deposit,5KD90779WN431614W,04 PAYPAL GENERAL UNRESTR,Support Ukraine - Support Ukraine,Contributed income:Donations directed by individuals,PayPal Bank 3,$31.40,"$859,877.27"
PayPal Fees,09/23/2023,Deposit,5KD90779WN431614W,04 PAYPAL GENERAL UNRESTR,PayPal fees,OFFICE/GENERAL ADMINISTRATIVE EXPENSES:PayPal Fees,PayPal Bank 3,$1.87,"$859,879.14"
PayPal Bank 3,09/23/2023,Deposit,7S413017L0658415N,04 PAYPAL GENERAL UNRESTR,"Subject: GeneralPage
Transaction ID: 7S413017L0658415N
https://www.paypal.com/activity/payment/7S413017L0658415N",PayPal Bank 3,--,$23.41,"$859,902.55"
Donations directed by individuals,09/23/2023,Deposit,7S413017L0658415N,04 PAYPAL GENERAL UNRESTR,Support Ukraine - Support Ukraine,Contributed income:Donations directed by individuals,PayPal Bank 3,$25.00,"$859,927.55"
PayPal Fees,09/23/2023,Deposit,7S413017L0658415N,04 PAYPAL GENERAL UNRESTR,PayPal fees,OFFICE/GENERAL ADMINISTRATIVE EXPENSES:PayPal Fees,PayPal Bank 3,$1.59,"$859,929.14"
PayPal Bank 3,09/23/2023,Deposit,10493917CT989150R,04 PAYPAL GENERAL UNRESTR,"Subject: GeneralPage
Transaction ID: 10493917CT989150R
https://www.paypal.com/activity/payment/10493917CT989150R",PayPal Bank 3,--,$98.45,"$860,027.59"
Donations directed by individuals,09/23/2023,Deposit,10493917CT989150R,04 PAYPAL GENERAL UNRESTR,Support Ukraine - Support Ukraine,Contributed income:Donations directed by individuals,PayPal Bank 3,$103.48,"$860,131.07"
PayPal Fees,09/23/2023,Deposit,10493917CT989150R,04 PAYPAL GENERAL UNRESTR,PayPal fees,OFFICE/GENERAL ADMINISTRATIVE EXPENSES:PayPal Fees,PayPal Bank 3,$5.03,"$860,136.10"
PayPal Bank 3,09/23/2023,Deposit,1Y165680C37142420,04 PAYPAL GENERAL UNRESTR,"Subject: GeneralPage
Transaction ID: 1Y165680C37142420
https://www.paypal.com/activity/payment/1Y165680C37142420",PayPal Bank 3,--,$19.68,"$860,155.78"
Donations directed by individuals,09/23/2023,Deposit,1Y165680C37142420,04 PAYPAL GENERAL UNRESTR,Support Ukraine - Support Ukraine,Contributed income:Donations directed by individuals,PayPal Bank 3,$21.10,"$860,176.88"
PayPal Fees,09/23/2023,Deposit,1Y165680C37142420,04 PAYPAL GENERAL UNRESTR,PayPal fees,OFFICE/GENERAL ADMINISTRATIVE EXPENSES:PayPal Fees,PayPal Bank 3,$1.42,"$860,178.30"
PayPal Bank 3,09/23/2023,Deposit,03X78893E2039615P,07 1000 DRONES RESTR,"Subject: 1000DRONES
Transaction ID: 03X78893E2039615P
https://www.paypal.com/activity/payment/03X78893E2039615P",PayPal Bank 3,--,$200.00,"$860,378.30"
Donations directed by individuals,09/23/2023,Deposit,03X78893E2039615P,07 1000 DRONES RESTR,1000 DRONES FOR UKRAINE - 1000 DRONES FOR UKRAINE,Contributed income:Donations directed by individuals,PayPal Bank 3,$206.46,"$860,584.76"
PayPal Fees,09/23/2023,Deposit,03X78893E2039615P,07 1000 DRONES RESTR,PayPal fees,OFFICE/GENERAL ADMINISTRATIVE EXPENSES:PayPal Fees,PayPal Bank 3,$6.46,"$860,591.22"
PayPal Bank 3,09/23/2023,Deposit,74T870496J466915S,04 PAYPAL GENERAL UNRESTR,"Subject: Support Ukraine
Transaction ID: 74T870496J466915S
https://www.paypal.com/activity/payment/74T870496J466915S",PayPal Bank 3,--,$19.68,"$860,610.90"
Donations directed by individuals,09/23/2023,Deposit,74T870496J466915S,04 PAYPAL GENERAL UNRESTR,Money in to PayPal,Contributed income:Donations directed by individuals,PayPal Bank 3,$21.10,"$860,632.00"
PayPal Fees,09/23/2023,Deposit,74T870496J466915S,04 PAYPAL GENERAL UNRESTR,PayPal fees,OFFICE/GENERAL ADMINISTRATIVE EXPENSES:PayPal Fees,PayPal Bank 3,$1.42,"$860,633.42"
PayPal Bank 3,09/23/2023,Deposit,4D024371EE604424D,04 PAYPAL GENERAL UNRESTR,"Subject: GeneralPage
Transaction ID: 4D024371EE604424D
https://www.paypal.com/activity/payment/4D024371EE604424D",PayPal Bank 3,--,$50.00,"$860,683.42"
Donations directed by individuals,09/23/2023,Deposit,4D024371EE604424D,04 PAYPAL GENERAL UNRESTR,Support Ukraine - Support Ukraine,Contributed income:Donations directed by individuals,PayPal Bank 3,$51.99,"$860,735.41"
PayPal Fees,09/23/2023,Deposit,4D024371EE604424D,04 PAYPAL GENERAL UNRESTR,PayPal fees,OFFICE/GENERAL ADMINISTRATIVE EXPENSES:PayPal Fees,PayPal Bank 3,$1.99,"$860,737.40"
PayPal Bank 3,09/23/2023,Deposit,5UP96113GW272314S,04 PAYPAL GENERAL UNRESTR,"Subject: GeneralPage
Transaction ID: 5UP96113GW272314S
https://www.paypal.com/activity/payment/5UP96113GW272314S",PayPal Bank 3,--,$96.62,"$860,834.02"
Donations directed by individuals,09/23/2023,Deposit,5UP96113GW272314S,04 PAYPAL GENERAL UNRESTR,Support Ukraine - Support Ukraine,Contributed income:Donations directed by individuals,PayPal Bank 3,$100.00,"$860,934.02"
PayPal Fees,09/23/2023,Deposit,5UP96113GW272314S,04 PAYPAL GENERAL UNRESTR,PayPal fees,OFFICE/GENERAL ADMINISTRATIVE EXPENSES:PayPal Fees,PayPal Bank 3,$3.38,"$860,937.40"
PayPal Bank 3,09/23/2023,Deposit,2YJ551927C9037054,04 PAYPAL GENERAL UNRESTR,"Subject: GeneralPage
Transaction ID: 2YJ551927C9037054
https://www.paypal.com/activity/payment/2YJ551927C9037054",PayPal Bank 3,--,$150.00,"$861,087.40"
Donations directed by individuals,09/23/2023,Deposit,2YJ551927C9037054,04 PAYPAL GENERAL UNRESTR,Support Ukraine - Support Ukraine,Contributed income:Donations directed by individuals,PayPal Bank 3,$154.97,"$861,242.37"
PayPal Fees,09/23/2023,Deposit,2YJ551927C9037054,04 PAYPAL GENERAL UNRESTR,PayPal fees,OFFICE/GENERAL ADMINISTRATIVE EXPENSES:PayPal Fees,PayPal Bank 3,$4.97,"$861,247.34"
PayPal Bank 3,09/23/2023,Deposit,3GT23301W2746432R,04 PAYPAL GENERAL UNRESTR,"Transaction ID: 3GT23301W2746432R
https://www.paypal.com/activity/payment/3GT23301W2746432R",PayPal Bank 3,--,$95.51,"$861,342.85"
Donations directed by individuals,09/23/2023,Deposit,3GT23301W2746432R,04 PAYPAL GENERAL UNRESTR,Money in to PayPal,Contributed income:Donations directed by individuals,PayPal Bank 3,$100.00,"$861,442.85"
PayPal Fees,09/23/2023,Deposit,3GT23301W2746432R,04 PAYPAL GENERAL UNRESTR,PayPal fees,OFFICE/GENERAL ADMINISTRATIVE EXPENSES:PayPal Fees,PayPal Bank 3,$4.49,"$861,447.34"
PayPal Bank 3,09/23/2023,Deposit,6ML112189R870751M,04 PAYPAL GENERAL UNRESTR,"Subject: GeneralPage
Transaction ID: 6ML112189R870751M
https://www.paypal.com/activity/payment/6ML112189R870751M",PayPal Bank 3,--,$11.81,"$861,459.15"
Donations directed by individuals,09/23/2023,Deposit,6ML112189R870751M,04 PAYPAL GENERAL UNRESTR,Support Ukraine - Support Ukraine,Contributed income:Donations directed by individuals,PayPal Bank 3,$12.86,"$861,472.01"
PayPal Fees,09/23/2023,Deposit,6ML112189R870751M,04 PAYPAL GENERAL UNRESTR,PayPal fees,OFFICE/GENERAL ADMINISTRATIVE EXPENSES:PayPal Fees,PayPal Bank 3,$1.05,"$861,473.06"
PayPal Bank 3,09/23/2023,Deposit,3V7230392X1018248,04 PAYPAL GENERAL UNRESTR,"Subject: GeneralPage
Transaction ID: 3V7230392X1018248
https://www.paypal.com/activity/payment/3V7230392X1018248",PayPal Bank 3,--,$29.53,"$861,502.59"
Donations directed by individuals,09/23/2023,Deposit,3V7230392X1018248,04 PAYPAL GENERAL UNRESTR,Support Ukraine - Support Ukraine,Contributed income:Donations directed by individuals,PayPal Bank 3,$31.40,"$861,533.99"
PayPal Fees,09/23/2023,Deposit,3V7230392X1018248,04 PAYPAL GENERAL UNRESTR,PayPal fees,OFFICE/GENERAL ADMINISTRATIVE EXPENSES:PayPal Fees,PayPal Bank 3,$1.87,"$861,535.86"
PayPal Bank 3,09/23/2023,Deposit,83D054725J665890F,04 PAYPAL GENERAL UNRESTR,"Subject: Support Ukraine
Transaction ID: 83D054725J665890F
https://www.paypal.com/activity/payment/83D054725J665890F",PayPal Bank 3,--,$9.07,"$861,544.93"
Donations directed by individuals,09/23/2023,Deposit,83D054725J665890F,04 PAYPAL GENERAL UNRESTR,Money in to PayPal,Contributed income:Donations directed by individuals,PayPal Bank 3,$10.00,"$861,554.93"
PayPal Fees,09/23/2023,Deposit,83D054725J665890F,04 PAYPAL GENERAL UNRESTR,PayPal fees,OFFICE/GENERAL ADMINISTRATIVE EXPENSES:PayPal Fees,PayPal Bank 3,$0.93,"$861,555.86"
PayPal Bank 3,09/23/2023,Deposit,0EJ573644J657291S,04 PAYPAL GENERAL UNRESTR,"Subject: Support Ukraine
Transaction ID: 0EJ573644J657291S
https://www.paypal.com/activity/payment/0EJ573644J657291S",PayPal Bank 3,--,$9.07,"$861,564.93"
Donations directed by individuals,09/23/2023,Deposit,0EJ573644J657291S,04 PAYPAL GENERAL UNRESTR,Money in to PayPal,Contributed income:Donations directed by individuals,PayPal Bank 3,$10.00,"$861,574.93"
PayPal Fees,09/23/2023,Deposit,0EJ573644J657291S,04 PAYPAL GENERAL UNRESTR,PayPal fees,OFFICE/GENERAL ADMINISTRATIVE EXPENSES:PayPal Fees,PayPal Bank 3,$0.93,"$861,575.86"
PayPal Bank 3,09/23/2023,Deposit,3MM72063Y7312125Y,04 PAYPAL GENERAL UNRESTR,"Subject: GeneralPage
Transaction ID: 3MM72063Y7312125Y
https://www.paypal.com/activity/payment/3MM72063Y7312125Y",PayPal Bank 3,--,$50.00,"$861,625.86"
Donations directed by individuals,09/23/2023,Deposit,3MM72063Y7312125Y,04 PAYPAL GENERAL UNRESTR,Support Ukraine - Support Ukraine,Contributed income:Donations directed by individuals,PayPal Bank 3,$51.99,"$861,677.85"
PayPal Fees,09/23/2023,Deposit,3MM72063Y7312125Y,04 PAYPAL GENERAL UNRESTR,PayPal fees,OFFICE/GENERAL ADMINISTRATIVE EXPENSES:PayPal Fees,PayPal Bank 3,$1.99,"$861,679.84"
PayPal Bank 3,09/23/2023,Deposit,6XC226380D552160B,04 PAYPAL GENERAL UNRESTR,"Subject: GeneralPage
Transaction ID: 6XC226380D552160B
https://www.paypal.com/activity/payment/6XC226380D552160B",PayPal Bank 3,--,$43.49,"$861,723.33"
Donations directed by individuals,09/23/2023,Deposit,6XC226380D552160B,04 PAYPAL GENERAL UNRESTR,Support Ukraine - Support Ukraine,Contributed income:Donations directed by individuals,PayPal Bank 3,$46.00,"$861,769.33"
PayPal Fees,09/23/2023,Deposit,6XC226380D552160B,04 PAYPAL GENERAL UNRESTR,PayPal fees,OFFICE/GENERAL ADMINISTRATIVE EXPENSES:PayPal Fees,PayPal Bank 3,$2.51,"$861,771.84"
PayPal Bank 3,09/23/2023,Deposit,83428782YL157182J,08 VICTORY DRONES RESTR,"Subject: VictoryDrones
Transaction ID: 83428782YL157182J
https://www.paypal.com/activity/payment/83428782YL157182J",PayPal Bank 3,--,$147.68,"$861,919.52"
Donations directed by individuals,09/23/2023,Deposit,83428782YL157182J,08 VICTORY DRONES RESTR,VICTORY DRONES - VICTORY DRONES,Contributed income:Donations directed by individuals,PayPal Bank 3,$154.97,"$862,074.49"
PayPal Fees,09/23/2023,Deposit,83428782YL157182J,08 VICTORY DRONES RESTR,PayPal fees,OFFICE/GENERAL ADMINISTRATIVE EXPENSES:PayPal Fees,PayPal Bank 3,$7.29,"$862,081.78"
PayPal Bank 3,09/23/2023,Deposit,2JM39382SK070930A,04 PAYPAL GENERAL UNRESTR,"Subject: Support Ukraine
Transaction ID: 2JM39382SK070930A
https://www.paypal.com/activity/payment/2JM39382SK070930A",PayPal Bank 3,--,$24.61,"$862,106.39"
Donations directed by individuals,09/23/2023,Deposit,2JM39382SK070930A,04 PAYPAL GENERAL UNRESTR,Money in to PayPal,Contributed income:Donations directed by individuals,PayPal Bank 3,$26.25,"$862,132.64"
PayPal Fees,09/23/2023,Deposit,2JM39382SK070930A,04 PAYPAL GENERAL UNRESTR,PayPal fees,OFFICE/GENERAL ADMINISTRATIVE EXPENSES:PayPal Fees,PayPal Bank 3,$1.64,"$862,134.28"
PayPal Bank 3,09/23/2023,Deposit,03378647UA515902H,04 PAYPAL GENERAL UNRESTR,"Subject: Support Ukraine
Transaction ID: 03378647UA515902H
https://www.paypal.com/activity/payment/03378647UA515902H",PayPal Bank 3,--,$50.00,"$862,184.28"
Donations directed by individuals,09/23/2023,Deposit,03378647UA515902H,04 PAYPAL GENERAL UNRESTR,Money in to PayPal,Contributed income:Donations directed by individuals,PayPal Bank 3,$51.99,"$862,236.27"
PayPal Fees,09/23/2023,Deposit,03378647UA515902H,04 PAYPAL GENERAL UNRESTR,PayPal fees,OFFICE/GENERAL ADMINISTRATIVE EXPENSES:PayPal Fees,PayPal Bank 3,$1.99,"$862,238.26"
PayPal Bank 3,09/23/2023,Deposit,0XL750071R888983N,04 PAYPAL GENERAL UNRESTR,"Subject: GeneralPage
Transaction ID: 0XL750071R888983N
https://www.paypal.com/activity/payment/0XL750071R888983N",PayPal Bank 3,--,$98.45,"$862,336.71"
Donations directed by individuals,09/23/2023,Deposit,0XL750071R888983N,04 PAYPAL GENERAL UNRESTR,Support Ukraine - Support Ukraine,Contributed income:Donations directed by individuals,PayPal Bank 3,$103.48,"$862,440.19"
PayPal Fees,09/23/2023,Deposit,0XL750071R888983N,04 PAYPAL GENERAL UNRESTR,PayPal fees,OFFICE/GENERAL ADMINISTRATIVE EXPENSES:PayPal Fees,PayPal Bank 3,$5.03,"$862,445.22"
PayPal Bank 3,09/23/2023,Deposit,0R7292846G9332029,04 PAYPAL GENERAL UNRESTR,"Subject: GeneralPage
Transaction ID: 0R7292846G9332029
https://www.paypal.com/activity/payment/0R7292846G9332029",PayPal Bank 3,--,$56.88,"$862,502.10"
Donations directed by individuals,09/23/2023,Deposit,0R7292846G9332029,04 PAYPAL GENERAL UNRESTR,Support Ukraine - Support Ukraine,Contributed income:Donations directed by individuals,PayPal Bank 3,$60.00,"$862,562.10"
PayPal Fees,09/23/2023,Deposit,0R7292846G9332029,04 PAYPAL GENERAL UNRESTR,PayPal fees,OFFICE/GENERAL ADMINISTRATIVE EXPENSES:PayPal Fees,PayPal Bank 3,$3.12,"$862,565.22"
PayPal Bank 3,09/23/2023,Deposit,7E931665A03787010,07 1000 DRONES RESTR,"Subject: 1000DRONES
Transaction ID: 7E931665A03787010
https://www.paypal.com/activity/payment/7E931665A03787010",PayPal Bank 3,--,$18.63,"$862,583.85"
Donations directed by individuals,09/23/2023,Deposit,7E931665A03787010,07 1000 DRONES RESTR,1000 DRONES FOR UKRAINE - 1000 DRONES FOR UKRAINE,Contributed income:Donations directed by individuals,PayPal Bank 3,$20.00,"$862,603.85"
PayPal Fees,09/23/2023,Deposit,7E931665A03787010,07 1000 DRONES RESTR,PayPal fees,OFFICE/GENERAL ADMINISTRATIVE EXPENSES:PayPal Fees,PayPal Bank 3,$1.37,"$862,605.22"
PayPal Bank 3,09/23/2023,Deposit,0ME91647AV943362U,07 1000 DRONES RESTR,"Subject: 1000DRONES
Transaction ID: 0ME91647AV943362U
https://www.paypal.com/activity/payment/0ME91647AV943362U",PayPal Bank 3,--,$196.91,"$862,802.13"
Donations directed by individuals,09/23/2023,Deposit,0ME91647AV943362U,07 1000 DRONES RESTR,1000 DRONES FOR UKRAINE - 1000 DRONES FOR UKRAINE,Contributed income:Donations directed by individuals,PayPal Bank 3,$206.46,"$863,008.59"
PayPal Fees,09/23/2023,Deposit,0ME91647AV943362U,07 1000 DRONES RESTR,PayPal fees,OFFICE/GENERAL ADMINISTRATIVE EXPENSES:PayPal Fees,PayPal Bank 3,$9.55,"$863,018.14"
PayPal Bank 3,09/23/2023,Deposit,6W579787CF1457611,08 VICTORY DRONES RESTR,"Subject: VictoryDrones
Transaction ID: 6W579787CF1457611
https://www.paypal.com/activity/payment/6W579787CF1457611",PayPal Bank 3,--,$50.00,"$863,068.14"
Donations directed by individuals,09/23/2023,Deposit,6W579787CF1457611,08 VICTORY DRONES RESTR,VICTORY DRONES - VICTORY DRONES,Contributed income:Donations directed by individuals,PayPal Bank 3,$51.99,"$863,120.13"
PayPal Fees,09/23/2023,Deposit,6W579787CF1457611,08 VICTORY DRONES RESTR,PayPal fees,OFFICE/GENERAL ADMINISTRATIVE EXPENSES:PayPal Fees,PayPal Bank 3,$1.99,"$863,122.12"
PayPal Bank 3,09/23/2023,Deposit,50B1273184218024T,07 1000 DRONES RESTR,"Subject: 1000DRONES
Transaction ID: 50B1273184218024T
https://www.paypal.com/activity/payment/50B1273184218024T",PayPal Bank 3,--,$78.76,"$863,200.88"
Donations directed by individuals,09/23/2023,Deposit,50B1273184218024T,07 1000 DRONES RESTR,1000 DRONES FOR UKRAINE - 1000 DRONES FOR UKRAINE,Contributed income:Donations directed by individuals,PayPal Bank 3,$82.89,"$863,283.77"
PayPal Fees,09/23/2023,Deposit,50B1273184218024T,07 1000 DRONES RESTR,PayPal fees,OFFICE/GENERAL ADMINISTRATIVE EXPENSES:PayPal Fees,PayPal Bank 3,$4.13,"$863,287.90"
PayPal Bank 3,09/23/2023,Deposit,8ET648336P1787717,04 PAYPAL GENERAL UNRESTR,"Subject: GeneralPage
Transaction ID: 8ET648336P1787717
https://www.paypal.com/activity/payment/8ET648336P1787717",PayPal Bank 3,--,$96.62,"$863,384.52"
Donations directed by individuals,09/23/2023,Deposit,8ET648336P1787717,04 PAYPAL GENERAL UNRESTR,Support Ukraine - Support Ukraine,Contributed income:Donations directed by individuals,PayPal Bank 3,$100.00,"$863,484.52"
PayPal Fees,09/23/2023,Deposit,8ET648336P1787717,04 PAYPAL GENERAL UNRESTR,PayPal fees,OFFICE/GENERAL ADMINISTRATIVE EXPENSES:PayPal Fees,PayPal Bank 3,$3.38,"$863,487.90"
PayPal Bank 3,09/23/2023,Deposit,4WG825122K733550U,07 1000 DRONES RESTR,"Subject: 1000DRONES
Transaction ID: 4WG825122K733550U
https://www.paypal.com/activity/payment/4WG825122K733550U",PayPal Bank 3,--,$4.91,"$863,492.81"
Donations directed by individuals,09/23/2023,Deposit,4WG825122K733550U,07 1000 DRONES RESTR,1000 DRONES FOR UKRAINE - 1000 DRONES FOR UKRAINE,Contributed income:Donations directed by individuals,PayPal Bank 3,$5.65,"$863,498.46"
PayPal Fees,09/23/2023,Deposit,4WG825122K733550U,07 1000 DRONES RESTR,PayPal fees,OFFICE/GENERAL ADMINISTRATIVE EXPENSES:PayPal Fees,PayPal Bank 3,$0.74,"$863,499.20"
PayPal Bank 3,09/23/2023,Deposit,37T968166T150770Y,04 PAYPAL GENERAL UNRESTR,"Subject: Support Ukraine
Transaction ID: 37T968166T150770Y
https://www.paypal.com/activity/payment/37T968166T150770Y",PayPal Bank 3,--,$19.68,"$863,518.88"
Donations directed by individuals,09/23/2023,Deposit,37T968166T150770Y,04 PAYPAL GENERAL UNRESTR,Money in to PayPal,Contributed income:Donations directed by individuals,PayPal Bank 3,$21.10,"$863,539.98"
PayPal Fees,09/23/2023,Deposit,37T968166T150770Y,04 PAYPAL GENERAL UNRESTR,PayPal fees,OFFICE/GENERAL ADMINISTRATIVE EXPENSES:PayPal Fees,PayPal Bank 3,$1.42,"$863,541.40"
PayPal Bank 3,09/23/2023,Deposit,1AM88865PM313052T,07 1000 DRONES RESTR,"Subject: 1000DRONES
Transaction ID: 1AM88865PM313052T
https://www.paypal.com/activity/payment/1AM88865PM313052T",PayPal Bank 3,--,$300.00,"$863,841.40"
Donations directed by individuals,09/23/2023,Deposit,1AM88865PM313052T,07 1000 DRONES RESTR,1000 DRONES FOR UKRAINE - 1000 DRONES FOR UKRAINE,Contributed income:Donations directed by individuals,PayPal Bank 3,$309.43,"$864,150.83"
PayPal Fees,09/23/2023,Deposit,1AM88865PM313052T,07 1000 DRONES RESTR,PayPal fees,OFFICE/GENERAL ADMINISTRATIVE EXPENSES:PayPal Fees,PayPal Bank 3,$9.43,"$864,160.26"
PayPal Bank 3,09/23/2023,Deposit,7GM91182T20560145,04 PAYPAL GENERAL UNRESTR,"Subject: GeneralPage
Transaction ID: 7GM91182T20560145
https://www.paypal.com/activity/payment/7GM91182T20560145",PayPal Bank 3,--,$179.26,"$864,339.52"
Donations directed by individuals,09/23/2023,Deposit,7GM91182T20560145,04 PAYPAL GENERAL UNRESTR,Support Ukraine - Support Ukraine,Contributed income:Donations directed by individuals,PayPal Bank 3,$188.00,"$864,527.52"
PayPal Fees,09/23/2023,Deposit,7GM91182T20560145,04 PAYPAL GENERAL UNRESTR,PayPal fees,OFFICE/GENERAL ADMINISTRATIVE EXPENSES:PayPal Fees,PayPal Bank 3,$8.74,"$864,536.26"
PayPal Bank 3,09/23/2023,Deposit,814797513S731722X,04 PAYPAL GENERAL UNRESTR,"Subject: GeneralPage
Transaction ID: 814797513S731722X
https://www.paypal.com/activity/payment/814797513S731722X",PayPal Bank 3,--,$56.88,"$864,593.14"
Donations directed by individuals,09/23/2023,Deposit,814797513S731722X,04 PAYPAL GENERAL UNRESTR,Support Ukraine - Support Ukraine,Contributed income:Donations directed by individuals,PayPal Bank 3,$60.00,"$864,653.14"
PayPal Fees,09/23/2023,Deposit,814797513S731722X,04 PAYPAL GENERAL UNRESTR,PayPal fees,OFFICE/GENERAL ADMINISTRATIVE EXPENSES:PayPal Fees,PayPal Bank 3,$3.12,"$864,656.26"
PayPal Bank 3,09/23/2023,Deposit,1J090000TJ948193J,07 1000 DRONES RESTR,"Subject: 1000DRONES
Transaction ID: 1J090000TJ948193J
https://www.paypal.com/activity/payment/1J090000TJ948193J",PayPal Bank 3,--,$500.00,"$865,156.26"
Donations directed by individuals,09/23/2023,Deposit,1J090000TJ948193J,07 1000 DRONES RESTR,1000 DRONES FOR UKRAINE - 1000 DRONES FOR UKRAINE,Contributed income:Donations directed by individuals,PayPal Bank 3,$515.38,"$865,671.64"
PayPal Fees,09/23/2023,Deposit,1J090000TJ948193J,07 1000 DRONES RESTR,PayPal fees,OFFICE/GENERAL ADMINISTRATIVE EXPENSES:PayPal Fees,PayPal Bank 3,$15.38,"$865,687.02"
PayPal Bank 3,09/23/2023,Deposit,55M356677A734003E,04 PAYPAL GENERAL UNRESTR,"Subject: GeneralPage
Transaction ID: 55M356677A734003E
https://www.paypal.com/activity/payment/55M356677A734003E",PayPal Bank 3,--,$4.29,"$865,691.31"
Donations directed by individuals,09/23/2023,Deposit,55M356677A734003E,04 PAYPAL GENERAL UNRESTR,Support Ukraine - Support Ukraine,Contributed income:Donations directed by individuals,PayPal Bank 3,$5.00,"$865,696.31"
PayPal Fees,09/23/2023,Deposit,55M356677A734003E,04 PAYPAL GENERAL UNRESTR,PayPal fees,OFFICE/GENERAL ADMINISTRATIVE EXPENSES:PayPal Fees,PayPal Bank 3,$0.71,"$865,697.02"
PayPal Bank 3,09/23/2023,Deposit,8YX21506GF134004X,08 VICTORY DRONES RESTR,"Subject: VICTORY DRONES
Transaction ID: 8YX21506GF134004X
https://www.paypal.com/activity/payment/8YX21506GF134004X",PayPal Bank 3,--,$2.94,"$865,699.96"
Donations directed by individuals,09/23/2023,Deposit,8YX21506GF134004X,08 VICTORY DRONES RESTR,Money in to PayPal,Contributed income:Donations directed by individuals,PayPal Bank 3,$3.59,"$865,703.55"
PayPal Fees,09/23/2023,Deposit,8YX21506GF134004X,08 VICTORY DRONES RESTR,PayPal fees,OFFICE/GENERAL ADMINISTRATIVE EXPENSES:PayPal Fees,PayPal Bank 3,$0.65,"$865,704.20"
PayPal Bank 3,09/23/2023,Deposit,1M9138826F965090E,04 PAYPAL GENERAL UNRESTR,"Subject: Support Ukraine
Transaction ID: 1M9138826F965090E
https://www.paypal.com/activity/payment/1M9138826F965090E",PayPal Bank 3,--,$295.36,"$865,999.56"
Donations directed by individuals,09/23/2023,Deposit,1M9138826F965090E,04 PAYPAL GENERAL UNRESTR,Money in to PayPal,Contributed income:Donations directed by individuals,PayPal Bank 3,$309.43,"$866,308.99"
PayPal Fees,09/23/2023,Deposit,1M9138826F965090E,04 PAYPAL GENERAL UNRESTR,PayPal fees,OFFICE/GENERAL ADMINISTRATIVE EXPENSES:PayPal Fees,PayPal Bank 3,$14.07,"$866,323.06"
PayPal Bank 3,09/23/2023,Deposit,6E1852743E7625219,07 1000 DRONES RESTR,"Subject: 1000DRONES
Transaction ID: 6E1852743E7625219
https://www.paypal.com/activity/payment/6E1852743E7625219",PayPal Bank 3,--,$39.37,"$866,362.43"
Donations directed by individuals,09/23/2023,Deposit,6E1852743E7625219,07 1000 DRONES RESTR,1000 DRONES FOR UKRAINE - 1000 DRONES FOR UKRAINE,Contributed income:Donations directed by individuals,PayPal Bank 3,$41.69,"$866,404.12"
PayPal Fees,09/23/2023,Deposit,6E1852743E7625219,07 1000 DRONES RESTR,PayPal fees,OFFICE/GENERAL ADMINISTRATIVE EXPENSES:PayPal Fees,PayPal Bank 3,$2.32,"$866,406.44"
PayPal Bank 3,09/23/2023,Deposit,2K874654LD241973L,04 PAYPAL GENERAL UNRESTR,"Subject: GeneralPage
Transaction ID: 2K874654LD241973L
https://www.paypal.com/activity/payment/2K874654LD241973L",PayPal Bank 3,--,$9.84,"$866,416.28"
Donations directed by individuals,09/23/2023,Deposit,2K874654LD241973L,04 PAYPAL GENERAL UNRESTR,Support Ukraine - Support Ukraine,Contributed income:Donations directed by individuals,PayPal Bank 3,$10.80,"$866,427.08"
PayPal Fees,09/23/2023,Deposit,2K874654LD241973L,04 PAYPAL GENERAL UNRESTR,PayPal fees,OFFICE/GENERAL ADMINISTRATIVE EXPENSES:PayPal Fees,PayPal Bank 3,$0.96,"$866,428.04"
PayPal Bank 3,09/23/2023,Deposit,2TL73642MY450052M,04 PAYPAL GENERAL UNRESTR,"Subject: GeneralPage
Transaction ID: 2TL73642MY450052M
https://www.paypal.com/activity/payment/2TL73642MY450052M",PayPal Bank 3,--,$984.54,"$867,412.58"
Donations directed by individuals,09/23/2023,Deposit,2TL73642MY450052M,04 PAYPAL GENERAL UNRESTR,Support Ukraine - Support Ukraine,Contributed income:Donations directed by individuals,PayPal Bank 3,"$1,030.26","$868,442.84"
PayPal Fees,09/23/2023,Deposit,2TL73642MY450052M,04 PAYPAL GENERAL UNRESTR,PayPal fees,OFFICE/GENERAL ADMINISTRATIVE EXPENSES:PayPal Fees,PayPal Bank 3,$45.72,"$868,488.56"
PayPal Bank 3,09/23/2023,Deposit,2R956744K07362254,07 1000 DRONES RESTR,"Subject: 1000DRONES
Transaction ID: 2R956744K07362254
https://www.paypal.com/activity/payment/2R956744K07362254",PayPal Bank 3,--,$50.00,"$868,538.56"
Donations directed by individuals,09/23/2023,Deposit,2R956744K07362254,07 1000 DRONES RESTR,1000 DRONES FOR UKRAINE - 1000 DRONES FOR UKRAINE,Contributed income:Donations directed by individuals,PayPal Bank 3,$51.99,"$868,590.55"
PayPal Fees,09/23/2023,Deposit,2R956744K07362254,07 1000 DRONES RESTR,PayPal fees,OFFICE/GENERAL ADMINISTRATIVE EXPENSES:PayPal Fees,PayPal Bank 3,$1.99,"$868,592.54"
PayPal Bank 3,09/23/2023,Deposit,5W603213F4199803D,04 PAYPAL GENERAL UNRESTR,"Subject: GeneralPage
Transaction ID: 5W603213F4199803D
https://www.paypal.com/activity/payment/5W603213F4199803D",PayPal Bank 3,--,$28.19,"$868,620.73"
Donations directed by individuals,09/23/2023,Deposit,5W603213F4199803D,04 PAYPAL GENERAL UNRESTR,Support Ukraine - Support Ukraine,Contributed income:Donations directed by individuals,PayPal Bank 3,$30.00,"$868,650.73"
PayPal Fees,09/23/2023,Deposit,5W603213F4199803D,04 PAYPAL GENERAL UNRESTR,PayPal fees,OFFICE/GENERAL ADMINISTRATIVE EXPENSES:PayPal Fees,PayPal Bank 3,$1.81,"$868,652.54"
PayPal Bank 3,09/23/2023,Deposit,56870444WL507231L,04 PAYPAL GENERAL UNRESTR,"Transaction ID: 56870444WL507231L
https://www.paypal.com/activity/payment/56870444WL507231L",PayPal Bank 3,--,$29.70,"$868,682.24"
Donations directed by individuals,09/23/2023,Deposit,56870444WL507231L,04 PAYPAL GENERAL UNRESTR,Money in to PayPal,Contributed income:Donations directed by individuals,PayPal Bank 3,$31.10,"$868,713.34"
PayPal Fees,09/23/2023,Deposit,56870444WL507231L,04 PAYPAL GENERAL UNRESTR,PayPal fees,OFFICE/GENERAL ADMINISTRATIVE EXPENSES:PayPal Fees,PayPal Bank 3,$1.40,"$868,714.74"
PayPal Bank 3,09/23/2023,Deposit,30L89620DJ600733L,04 PAYPAL GENERAL UNRESTR,"Subject: GeneralPage
Transaction ID: 30L89620DJ600733L
https://www.paypal.com/activity/payment/30L89620DJ600733L",PayPal Bank 3,--,$48.06,"$868,762.80"
Donations directed by individuals,09/23/2023,Deposit,30L89620DJ600733L,04 PAYPAL GENERAL UNRESTR,Support Ukraine - Support Ukraine,Contributed income:Donations directed by individuals,PayPal Bank 3,$50.00,"$868,812.80"
PayPal Fees,09/23/2023,Deposit,30L89620DJ600733L,04 PAYPAL GENERAL UNRESTR,PayPal fees,OFFICE/GENERAL ADMINISTRATIVE EXPENSES:PayPal Fees,PayPal Bank 3,$1.94,"$868,814.74"
PayPal Bank 3,09/23/2023,Deposit,4JP64523GY4382219,07 1000 DRONES RESTR,"Subject: 1000DRONES
Transaction ID: 4JP64523GY4382219
https://www.paypal.com/activity/payment/4JP64523GY4382219",PayPal Bank 3,--,$95.12,"$868,909.86"
Donations directed by individuals,09/23/2023,Deposit,4JP64523GY4382219,07 1000 DRONES RESTR,1000 DRONES FOR UKRAINE - 1000 DRONES FOR UKRAINE,Contributed income:Donations directed by individuals,PayPal Bank 3,$100.00,"$869,009.86"
PayPal Fees,09/23/2023,Deposit,4JP64523GY4382219,07 1000 DRONES RESTR,PayPal fees,OFFICE/GENERAL ADMINISTRATIVE EXPENSES:PayPal Fees,PayPal Bank 3,$4.88,"$869,014.74"
PayPal Bank 3,09/23/2023,Deposit,9J000095K60969356,04 PAYPAL GENERAL UNRESTR,"Subject: GeneralPage
Transaction ID: 9J000095K60969356
https://www.paypal.com/activity/payment/9J000095K60969356",PayPal Bank 3,--,$150.00,"$869,164.74"
Donations directed by individuals,09/23/2023,Deposit,9J000095K60969356,04 PAYPAL GENERAL UNRESTR,Support Ukraine - Support Ukraine,Contributed income:Donations directed by individuals,PayPal Bank 3,$154.97,"$869,319.71"
PayPal Fees,09/23/2023,Deposit,9J000095K60969356,04 PAYPAL GENERAL UNRESTR,PayPal fees,OFFICE/GENERAL ADMINISTRATIVE EXPENSES:PayPal Fees,PayPal Bank 3,$4.97,"$869,324.68"
PayPal Bank 3,09/23/2023,Deposit,42L88251WU3933024,04 PAYPAL GENERAL UNRESTR,"Subject: GeneralPage
Transaction ID: 42L88251WU3933024
https://www.paypal.com/activity/payment/42L88251WU3933024",PayPal Bank 3,--,$95.12,"$869,419.80"
Donations directed by individuals,09/23/2023,Deposit,42L88251WU3933024,04 PAYPAL GENERAL UNRESTR,Support Ukraine - Support Ukraine,Contributed income:Donations directed by individuals,PayPal Bank 3,$100.00,"$869,519.80"
PayPal Fees,09/23/2023,Deposit,42L88251WU3933024,04 PAYPAL GENERAL UNRESTR,PayPal fees,OFFICE/GENERAL ADMINISTRATIVE EXPENSES:PayPal Fees,PayPal Bank 3,$4.88,"$869,524.68"
PayPal Bank 3,09/23/2023,Deposit,5UA71580HH172350S,04 PAYPAL GENERAL UNRESTR,"Subject: GeneralPage
Transaction ID: 5UA71580HH172350S
https://www.paypal.com/activity/payment/5UA71580HH172350S",PayPal Bank 3,--,$14.76,"$869,539.44"
Donations directed by individuals,09/23/2023,Deposit,5UA71580HH172350S,04 PAYPAL GENERAL UNRESTR,Support Ukraine - Support Ukraine,Contributed income:Donations directed by individuals,PayPal Bank 3,$15.95,"$869,555.39"
PayPal Fees,09/23/2023,Deposit,5UA71580HH172350S,04 PAYPAL GENERAL UNRESTR,PayPal fees,OFFICE/GENERAL ADMINISTRATIVE EXPENSES:PayPal Fees,PayPal Bank 3,$1.19,"$869,556.58"
PayPal Bank 3,09/23/2023,Deposit,89U61364UP507803L,07 1000 DRONES RESTR,"Subject: 1000DRONES
Transaction ID: 89U61364UP507803L
https://www.paypal.com/activity/payment/89U61364UP507803L",PayPal Bank 3,--,$100.00,"$869,656.58"
Donations directed by individuals,09/23/2023,Deposit,89U61364UP507803L,07 1000 DRONES RESTR,1000 DRONES FOR UKRAINE - 1000 DRONES FOR UKRAINE,Contributed income:Donations directed by individuals,PayPal Bank 3,$103.48,"$869,760.06"
PayPal Fees,09/23/2023,Deposit,89U61364UP507803L,07 1000 DRONES RESTR,PayPal fees,OFFICE/GENERAL ADMINISTRATIVE EXPENSES:PayPal Fees,PayPal Bank 3,$3.48,"$869,763.54"
PayPal Bank 3,09/23/2023,Deposit,6JT11453Y2818021S,04 PAYPAL GENERAL UNRESTR,"Subject: GeneralPage
Transaction ID: 6JT11453Y2818021S
https://www.paypal.com/activity/payment/6JT11453Y2818021S",PayPal Bank 3,--,$100.00,"$869,863.54"
Donations directed by individuals,09/23/2023,Deposit,6JT11453Y2818021S,04 PAYPAL GENERAL UNRESTR,Support Ukraine - Support Ukraine,Contributed income:Donations directed by individuals,PayPal Bank 3,$103.48,"$869,967.02"
PayPal Fees,09/23/2023,Deposit,6JT11453Y2818021S,04 PAYPAL GENERAL UNRESTR,PayPal fees,OFFICE/GENERAL ADMINISTRATIVE EXPENSES:PayPal Fees,PayPal Bank 3,$3.48,"$869,970.50"
PayPal Bank 3,09/23/2023,Deposit,2KR67177EA2101107,04 PAYPAL GENERAL UNRESTR,"Subject: GeneralPage
Transaction ID: 2KR67177EA2101107
https://www.paypal.com/activity/payment/2KR67177EA2101107",PayPal Bank 3,--,$28.64,"$869,999.14"
Donations directed by individuals,09/23/2023,Deposit,2KR67177EA2101107,04 PAYPAL GENERAL UNRESTR,Support Ukraine - Support Ukraine,Contributed income:Donations directed by individuals,PayPal Bank 3,$30.00,"$870,029.14"
PayPal Fees,09/23/2023,Deposit,2KR67177EA2101107,04 PAYPAL GENERAL UNRESTR,PayPal fees,OFFICE/GENERAL ADMINISTRATIVE EXPENSES:PayPal Fees,PayPal Bank 3,$1.36,"$870,030.50"
PayPal Bank 3,09/23/2023,Deposit,3AA40702N9238421F,04 PAYPAL GENERAL UNRESTR,"Subject: GeneralPage
Transaction ID: 3AA40702N9238421F
https://www.paypal.com/activity/payment/3AA40702N9238421F",PayPal Bank 3,--,$49.22,"$870,079.72"
Donations directed by individuals,09/23/2023,Deposit,3AA40702N9238421F,04 PAYPAL GENERAL UNRESTR,Support Ukraine - Support Ukraine,Contributed income:Donations directed by individuals,PayPal Bank 3,$51.99,"$870,131.71"
PayPal Fees,09/23/2023,Deposit,3AA40702N9238421F,04 PAYPAL GENERAL UNRESTR,PayPal fees,OFFICE/GENERAL ADMINISTRATIVE EXPENSES:PayPal Fees,PayPal Bank 3,$2.77,"$870,134.48"
PayPal Bank 3,09/23/2023,Deposit,7JA06279JP053780G,04 PAYPAL GENERAL UNRESTR,"Subject: GeneralPage
Transaction ID: 7JA06279JP053780G
https://www.paypal.com/activity/payment/7JA06279JP053780G",PayPal Bank 3,--,$485.06,"$870,619.54"
Donations directed by individuals,09/23/2023,Deposit,7JA06279JP053780G,04 PAYPAL GENERAL UNRESTR,Support Ukraine - Support Ukraine,Contributed income:Donations directed by individuals,PayPal Bank 3,$500.00,"$871,119.54"
PayPal Fees,09/23/2023,Deposit,7JA06279JP053780G,04 PAYPAL GENERAL UNRESTR,PayPal fees,OFFICE/GENERAL ADMINISTRATIVE EXPENSES:PayPal Fees,PayPal Bank 3,$14.94,"$871,134.48"
PayPal Bank 3,09/23/2023,Deposit,9VG37145HJ154410H,04 PAYPAL GENERAL UNRESTR,"Subject: GeneralPage
Transaction ID: 9VG37145HJ154410H
https://www.paypal.com/activity/payment/9VG37145HJ154410H",PayPal Bank 3,--,$33.47,"$871,167.95"
Donations directed by individuals,09/23/2023,Deposit,9VG37145HJ154410H,04 PAYPAL GENERAL UNRESTR,Support Ukraine - Support Ukraine,Contributed income:Donations directed by individuals,PayPal Bank 3,$35.52,"$871,203.47"
PayPal Fees,09/23/2023,Deposit,9VG37145HJ154410H,04 PAYPAL GENERAL UNRESTR,PayPal fees,OFFICE/GENERAL ADMINISTRATIVE EXPENSES:PayPal Fees,PayPal Bank 3,$2.05,"$871,205.52"
PayPal Bank 3,09/23/2023,Deposit,54A48154P06585502,04 PAYPAL GENERAL UNRESTR,"Subject: GeneralPage
Note: Advertisement in Immigrant Porada
Transaction ID: 54A48154P06585502
https://www.paypal.com/activity/payment/54A48154P06585502",PayPal Bank 3,--,$50.00,"$871,255.52"
Donations directed by individuals,09/23/2023,Deposit,54A48154P06585502,04 PAYPAL GENERAL UNRESTR,Support Ukraine - Support Ukraine,Contributed income:Donations directed by individuals,PayPal Bank 3,$51.99,"$871,307.51"
PayPal Fees,09/23/2023,Deposit,54A48154P06585502,04 PAYPAL GENERAL UNRESTR,PayPal fees,OFFICE/GENERAL ADMINISTRATIVE EXPENSES:PayPal Fees,PayPal Bank 3,$1.99,"$871,309.50"
PayPal Bank 3,09/23/2023,Deposit,59462870L1711745C,04 PAYPAL GENERAL UNRESTR,"Subject: GeneralPage
Transaction ID: 59462870L1711745C
https://www.paypal.com/activity/payment/59462870L1711745C",PayPal Bank 3,--,$300.00,"$871,609.50"
Donations directed by individuals,09/23/2023,Deposit,59462870L1711745C,04 PAYPAL GENERAL UNRESTR,Support Ukraine - Support Ukraine,Contributed income:Donations directed by individuals,PayPal Bank 3,$309.43,"$871,918.93"
PayPal Fees,09/23/2023,Deposit,59462870L1711745C,04 PAYPAL GENERAL UNRESTR,PayPal fees,OFFICE/GENERAL ADMINISTRATIVE EXPENSES:PayPal Fees,PayPal Bank 3,$9.43,"$871,928.36"
PayPal Bank 3,09/23/2023,Deposit,4Y55306342583315J,07 1000 DRONES RESTR,"Subject: 1000DRONES
Transaction ID: 4Y55306342583315J
https://www.paypal.com/activity/payment/4Y55306342583315J",PayPal Bank 3,--,$485.06,"$872,413.42"
Donations directed by individuals,09/23/2023,Deposit,4Y55306342583315J,07 1000 DRONES RESTR,1000 DRONES FOR UKRAINE - 1000 DRONES FOR UKRAINE,Contributed income:Donations directed by individuals,PayPal Bank 3,$500.00,"$872,913.42"
PayPal Fees,09/23/2023,Deposit,4Y55306342583315J,07 1000 DRONES RESTR,PayPal fees,OFFICE/GENERAL ADMINISTRATIVE EXPENSES:PayPal Fees,PayPal Bank 3,$14.94,"$872,928.36"
PayPal Bank 3,09/23/2023,Deposit,3SH92116BT6873141,04 PAYPAL GENERAL UNRESTR,"Subject: Support Ukraine
Transaction ID: 3SH92116BT6873141
https://www.paypal.com/activity/payment/3SH92116BT6873141",PayPal Bank 3,--,$98.45,"$873,026.81"
Donations directed by individuals,09/23/2023,Deposit,3SH92116BT6873141,04 PAYPAL GENERAL UNRESTR,Money in to PayPal,Contributed income:Donations directed by individuals,PayPal Bank 3,$103.48,"$873,130.29"
PayPal Fees,09/23/2023,Deposit,3SH92116BT6873141,04 PAYPAL GENERAL UNRESTR,PayPal fees,OFFICE/GENERAL ADMINISTRATIVE EXPENSES:PayPal Fees,PayPal Bank 3,$5.03,"$873,135.32"
PayPal Bank 3,09/23/2023,Deposit,3UG31484WW383721H,04 PAYPAL GENERAL UNRESTR,"Subject: GeneralPage
Transaction ID: 3UG31484WW383721H
https://www.paypal.com/activity/payment/3UG31484WW383721H",PayPal Bank 3,--,$47.31,"$873,182.63"
Donations directed by individuals,09/23/2023,Deposit,3UG31484WW383721H,04 PAYPAL GENERAL UNRESTR,Support Ukraine - Support Ukraine,Contributed income:Donations directed by individuals,PayPal Bank 3,$50.00,"$873,232.63"
PayPal Fees,09/23/2023,Deposit,3UG31484WW383721H,04 PAYPAL GENERAL UNRESTR,PayPal fees,OFFICE/GENERAL ADMINISTRATIVE EXPENSES:PayPal Fees,PayPal Bank 3,$2.69,"$873,235.32"
PayPal Bank 3,09/23/2023,Deposit,5J268388MC176994C,08 VICTORY DRONES RESTR,"Subject: VICTORY DRONES
Transaction ID: 5J268388MC176994C
https://www.paypal.com/activity/payment/5J268388MC176994C",PayPal Bank 3,--,$100.00,"$873,335.32"
Donations directed by individuals,09/23/2023,Deposit,5J268388MC176994C,08 VICTORY DRONES RESTR,Money in to PayPal,Contributed income:Donations directed by individuals,PayPal Bank 3,$103.48,"$873,438.80"
PayPal Fees,09/23/2023,Deposit,5J268388MC176994C,08 VICTORY DRONES RESTR,PayPal fees,OFFICE/GENERAL ADMINISTRATIVE EXPENSES:PayPal Fees,PayPal Bank 3,$3.48,"$873,442.28"
PayPal Bank 3,09/23/2023,Deposit,0GA75210G10762703,04 PAYPAL GENERAL UNRESTR,"Subject: GeneralPage
Transaction ID: 0GA75210G10762703
https://www.paypal.com/activity/payment/0GA75210G10762703",PayPal Bank 3,--,$120.00,"$873,562.28"
Donations directed by individuals,09/23/2023,Deposit,0GA75210G10762703,04 PAYPAL GENERAL UNRESTR,Support Ukraine - Support Ukraine,Contributed income:Donations directed by individuals,PayPal Bank 3,$124.08,"$873,686.36"
PayPal Fees,09/23/2023,Deposit,0GA75210G10762703,04 PAYPAL GENERAL UNRESTR,PayPal fees,OFFICE/GENERAL ADMINISTRATIVE EXPENSES:PayPal Fees,PayPal Bank 3,$4.08,"$873,690.44"
PayPal Bank 3,09/23/2023,Deposit,56777134BK2851236,04 PAYPAL GENERAL UNRESTR,"Subject: GeneralPage
Transaction ID: 56777134BK2851236
https://www.paypal.com/activity/payment/56777134BK2851236",PayPal Bank 3,--,$120.00,"$873,810.44"
Donations directed by individuals,09/23/2023,Deposit,56777134BK2851236,04 PAYPAL GENERAL UNRESTR,Support Ukraine - Support Ukraine,Contributed income:Donations directed by individuals,PayPal Bank 3,$124.08,"$873,934.52"
PayPal Fees,09/23/2023,Deposit,56777134BK2851236,04 PAYPAL GENERAL UNRESTR,PayPal fees,OFFICE/GENERAL ADMINISTRATIVE EXPENSES:PayPal Fees,PayPal Bank 3,$4.08,"$873,938.60"
PayPal Bank 3,09/23/2023,Deposit,1X6852961R969633B,04 PAYPAL GENERAL UNRESTR,"Subject: GeneralPage
Transaction ID: 1X6852961R969633B
https://www.paypal.com/activity/payment/1X6852961R969633B",PayPal Bank 3,--,"$1,000.00","$874,938.60"
Donations directed by individuals,09/23/2023,Deposit,1X6852961R969633B,04 PAYPAL GENERAL UNRESTR,Support Ukraine - Support Ukraine,Contributed income:Donations directed by individuals,PayPal Bank 3,"$1,030.26","$875,968.86"
PayPal Fees,09/23/2023,Deposit,1X6852961R969633B,04 PAYPAL GENERAL UNRESTR,PayPal fees,OFFICE/GENERAL ADMINISTRATIVE EXPENSES:PayPal Fees,PayPal Bank 3,$30.26,"$875,999.12"
PayPal Bank 3,09/23/2023,Deposit,1DJ25972B81607007,04 PAYPAL GENERAL UNRESTR,"Subject: Support Ukraine
Transaction ID: 1DJ25972B81607007
https://www.paypal.com/activity/payment/1DJ25972B81607007",PayPal Bank 3,--,$50.00,"$876,049.12"
Donations directed by individuals,09/23/2023,Deposit,1DJ25972B81607007,04 PAYPAL GENERAL UNRESTR,Money in to PayPal,Contributed income:Donations directed by individuals,PayPal Bank 3,$51.99,"$876,101.11"
PayPal Fees,09/23/2023,Deposit,1DJ25972B81607007,04 PAYPAL GENERAL UNRESTR,PayPal fees,OFFICE/GENERAL ADMINISTRATIVE EXPENSES:PayPal Fees,PayPal Bank 3,$1.99,"$876,103.10"
PayPal Bank 3,09/23/2023,Deposit,3AE30931TY8746800,04 PAYPAL GENERAL UNRESTR,"Subject: Support Ukraine
Transaction ID: 3AE30931TY8746800
https://www.paypal.com/activity/payment/3AE30931TY8746800",PayPal Bank 3,--,$9.84,"$876,112.94"
Donations directed by individuals,09/23/2023,Deposit,3AE30931TY8746800,04 PAYPAL GENERAL UNRESTR,Money in to PayPal,Contributed income:Donations directed by individuals,PayPal Bank 3,$10.80,"$876,123.74"
PayPal Fees,09/23/2023,Deposit,3AE30931TY8746800,04 PAYPAL GENERAL UNRESTR,PayPal fees,OFFICE/GENERAL ADMINISTRATIVE EXPENSES:PayPal Fees,PayPal Bank 3,$0.96,"$876,124.70"
PayPal Bank 3,09/23/2023,Deposit,65U23597T2978325V,04 PAYPAL GENERAL UNRESTR,"Subject: Support Ukraine
Transaction ID: 65U23597T2978325V
https://www.paypal.com/activity/payment/65U23597T2978325V",PayPal Bank 3,--,$24.61,"$876,149.31"
Donations directed by individuals,09/23/2023,Deposit,65U23597T2978325V,04 PAYPAL GENERAL UNRESTR,Money in to PayPal,Contributed income:Donations directed by individuals,PayPal Bank 3,$26.25,"$876,175.56"
PayPal Fees,09/23/2023,Deposit,65U23597T2978325V,04 PAYPAL GENERAL UNRESTR,PayPal fees,OFFICE/GENERAL ADMINISTRATIVE EXPENSES:PayPal Fees,PayPal Bank 3,$1.64,"$876,177.20"
PayPal Bank 3,09/23/2023,Deposit,34R17728VT877705U,04 PAYPAL GENERAL UNRESTR,"Subject: Support Ukraine
Transaction ID: 34R17728VT877705U
https://www.paypal.com/activity/payment/34R17728VT877705U",PayPal Bank 3,--,$4.91,"$876,182.11"
Donations directed by individuals,09/23/2023,Deposit,34R17728VT877705U,04 PAYPAL GENERAL UNRESTR,Money in to PayPal,Contributed income:Donations directed by individuals,PayPal Bank 3,$5.65,"$876,187.76"
PayPal Fees,09/23/2023,Deposit,34R17728VT877705U,04 PAYPAL GENERAL UNRESTR,PayPal fees,OFFICE/GENERAL ADMINISTRATIVE EXPENSES:PayPal Fees,PayPal Bank 3,$0.74,"$876,188.50"
PayPal Bank 3,09/23/2023,Deposit,8CJ215698J065660D,04 PAYPAL GENERAL UNRESTR,"Subject: Support Ukraine
Transaction ID: 8CJ215698J065660D
https://www.paypal.com/activity/payment/8CJ215698J065660D",PayPal Bank 3,--,$147.68,"$876,336.18"
Donations directed by individuals,09/23/2023,Deposit,8CJ215698J065660D,04 PAYPAL GENERAL UNRESTR,Money in to PayPal,Contributed income:Donations directed by individuals,PayPal Bank 3,$154.97,"$876,491.15"
PayPal Fees,09/23/2023,Deposit,8CJ215698J065660D,04 PAYPAL GENERAL UNRESTR,PayPal fees,OFFICE/GENERAL ADMINISTRATIVE EXPENSES:PayPal Fees,PayPal Bank 3,$7.29,"$876,498.44"
PayPal Bank 3,09/23/2023,Deposit,1W636452MY857735A,04 PAYPAL GENERAL UNRESTR,"Subject: GeneralPage
Transaction ID: 1W636452MY857735A
https://www.paypal.com/activity/payment/1W636452MY857735A",PayPal Bank 3,--,$152.60,"$876,651.04"
Donations directed by individuals,09/23/2023,Deposit,1W636452MY857735A,04 PAYPAL GENERAL UNRESTR,Support Ukraine - Support Ukraine,Contributed income:Donations directed by individuals,PayPal Bank 3,$160.12,"$876,811.16"
PayPal Fees,09/23/2023,Deposit,1W636452MY857735A,04 PAYPAL GENERAL UNRESTR,PayPal fees,OFFICE/GENERAL ADMINISTRATIVE EXPENSES:PayPal Fees,PayPal Bank 3,$7.52,"$876,818.68"
PayPal Bank 3,09/23/2023,Deposit,2JJ91533S2733964A,04 PAYPAL GENERAL UNRESTR,"Subject: GeneralPage
Transaction ID: 2JJ91533S2733964A
https://www.paypal.com/activity/payment/2JJ91533S2733964A",PayPal Bank 3,--,$50.01,"$876,868.69"
Donations directed by individuals,09/23/2023,Deposit,2JJ91533S2733964A,04 PAYPAL GENERAL UNRESTR,Support Ukraine - Support Ukraine,Contributed income:Donations directed by individuals,PayPal Bank 3,$52.00,"$876,920.69"
PayPal Fees,09/23/2023,Deposit,2JJ91533S2733964A,04 PAYPAL GENERAL UNRESTR,PayPal fees,OFFICE/GENERAL ADMINISTRATIVE EXPENSES:PayPal Fees,PayPal Bank 3,$1.99,"$876,922.68"
PayPal Bank 3,09/23/2023,Deposit,5VJ33232UR9131814,04 PAYPAL GENERAL UNRESTR,"Subject: Support Ukraine
Transaction ID: 5VJ33232UR9131814
https://www.paypal.com/activity/payment/5VJ33232UR9131814",PayPal Bank 3,--,$98.45,"$877,021.13"
Donations directed by individuals,09/23/2023,Deposit,5VJ33232UR9131814,04 PAYPAL GENERAL UNRESTR,Money in to PayPal,Contributed income:Donations directed by individuals,PayPal Bank 3,$103.48,"$877,124.61"
PayPal Fees,09/23/2023,Deposit,5VJ33232UR9131814,04 PAYPAL GENERAL UNRESTR,PayPal fees,OFFICE/GENERAL ADMINISTRATIVE EXPENSES:PayPal Fees,PayPal Bank 3,$5.03,"$877,129.64"
PayPal Bank 3,09/23/2023,Deposit,1KM99155AX392723D,04 PAYPAL GENERAL UNRESTR,"Subject: GeneralPage
Transaction ID: 1KM99155AX392723D
https://www.paypal.com/activity/payment/1KM99155AX392723D",PayPal Bank 3,--,$100.00,"$877,229.64"
Donations directed by individuals,09/23/2023,Deposit,1KM99155AX392723D,04 PAYPAL GENERAL UNRESTR,Support Ukraine - Support Ukraine,Contributed income:Donations directed by individuals,PayPal Bank 3,$103.48,"$877,333.12"
PayPal Fees,09/23/2023,Deposit,1KM99155AX392723D,04 PAYPAL GENERAL UNRESTR,PayPal fees,OFFICE/GENERAL ADMINISTRATIVE EXPENSES:PayPal Fees,PayPal Bank 3,$3.48,"$877,336.60"
PayPal Bank 3,09/23/2023,Deposit,00G10777M4738273P,04 PAYPAL GENERAL UNRESTR,"Subject: GeneralPage
Note: Thank you for everything you do.  I hope peace will come soon for all Ukrainian people!
Transaction ID: 00G10777M4738273P
https://www.paypal.com/activity/payment/00G10777M4738273P",PayPal Bank 3,--,$100.00,"$877,436.60"
Donations directed by individuals,09/23/2023,Deposit,00G10777M4738273P,04 PAYPAL GENERAL UNRESTR,Support Ukraine - Support Ukraine,Contributed income:Donations directed by individuals,PayPal Bank 3,$103.48,"$877,540.08"
PayPal Fees,09/23/2023,Deposit,00G10777M4738273P,04 PAYPAL GENERAL UNRESTR,PayPal fees,OFFICE/GENERAL ADMINISTRATIVE EXPENSES:PayPal Fees,PayPal Bank 3,$3.48,"$877,543.56"
PayPal Bank 3,09/23/2023,Deposit,17K11555500528818,10 Flight to Recovery RESTR,"Subject: FlightToRecovery
Transaction ID: 17K11555500528818
https://www.paypal.com/activity/payment/17K11555500528818",PayPal Bank 3,--,$39.37,"$877,582.93"
Donations directed by individuals,09/23/2023,Deposit,17K11555500528818,10 Flight to Recovery RESTR,Dignitas Ukraine Flight to Recovery - Dignitas Ukraine Flight to Recovery,Contributed income:Donations directed by individuals,PayPal Bank 3,$41.69,"$877,624.62"
PayPal Fees,09/23/2023,Deposit,17K11555500528818,10 Flight to Recovery RESTR,PayPal fees,OFFICE/GENERAL ADMINISTRATIVE EXPENSES:PayPal Fees,PayPal Bank 3,$2.32,"$877,626.94"
PayPal Bank 3,09/23/2023,Deposit,9F247060FG610643H,04 PAYPAL GENERAL UNRESTR,"Subject: GeneralPage
Transaction ID: 9F247060FG610643H
https://www.paypal.com/activity/payment/9F247060FG610643H",PayPal Bank 3,--,$190.73,"$877,817.67"
Donations directed by individuals,09/23/2023,Deposit,9F247060FG610643H,04 PAYPAL GENERAL UNRESTR,Support Ukraine - Support Ukraine,Contributed income:Donations directed by individuals,PayPal Bank 3,$200.00,"$878,017.67"
PayPal Fees,09/23/2023,Deposit,9F247060FG610643H,04 PAYPAL GENERAL UNRESTR,PayPal fees,OFFICE/GENERAL ADMINISTRATIVE EXPENSES:PayPal Fees,PayPal Bank 3,$9.27,"$878,026.94"
PayPal Bank 3,09/23/2023,Deposit,4JA04879C7952490V,07 1000 DRONES RESTR,"Subject: 1000DRONES
Transaction ID: 4JA04879C7952490V
https://www.paypal.com/activity/payment/4JA04879C7952490V",PayPal Bank 3,--,$129.95,"$878,156.89"
Donations directed by individuals,09/23/2023,Deposit,4JA04879C7952490V,07 1000 DRONES RESTR,1000 DRONES FOR UKRAINE - 1000 DRONES FOR UKRAINE,Contributed income:Donations directed by individuals,PayPal Bank 3,$136.43,"$878,293.32"
PayPal Fees,09/23/2023,Deposit,4JA04879C7952490V,07 1000 DRONES RESTR,PayPal fees,OFFICE/GENERAL ADMINISTRATIVE EXPENSES:PayPal Fees,PayPal Bank 3,$6.48,"$878,299.80"
PayPal Bank 3,09/23/2023,Deposit,5PF5970161756693T,04 PAYPAL GENERAL UNRESTR,"Subject: GeneralPage
Transaction ID: 5PF5970161756693T
https://www.paypal.com/activity/payment/5PF5970161756693T",PayPal Bank 3,--,$95.12,"$878,394.92"
Donations directed by individuals,09/23/2023,Deposit,5PF5970161756693T,04 PAYPAL GENERAL UNRESTR,Support Ukraine - Support Ukraine,Contributed income:Donations directed by individuals,PayPal Bank 3,$100.00,"$878,494.92"
PayPal Fees,09/23/2023,Deposit,5PF5970161756693T,04 PAYPAL GENERAL UNRESTR,PayPal fees,OFFICE/GENERAL ADMINISTRATIVE EXPENSES:PayPal Fees,PayPal Bank 3,$4.88,"$878,499.80"
PayPal Bank 3,09/23/2023,Deposit,85C884642S920054R,04 PAYPAL GENERAL UNRESTR,"Subject: GeneralPage
Transaction ID: 85C884642S920054R
https://www.paypal.com/activity/payment/85C884642S920054R",PayPal Bank 3,--,$100.00,"$878,599.80"
Donations directed by individuals,09/23/2023,Deposit,85C884642S920054R,04 PAYPAL GENERAL UNRESTR,Support Ukraine - Support Ukraine,Contributed income:Donations directed by individuals,PayPal Bank 3,$103.48,"$878,703.28"
PayPal Fees,09/23/2023,Deposit,85C884642S920054R,04 PAYPAL GENERAL UNRESTR,PayPal fees,OFFICE/GENERAL ADMINISTRATIVE EXPENSES:PayPal Fees,PayPal Bank 3,$3.48,"$878,706.76"
PayPal Bank 3,09/23/2023,Deposit,2NJ26077720592129,04 PAYPAL GENERAL UNRESTR,"Subject: GeneralPage
Note: Meest America $50 Post Payment + 100 for future 2 publications
Transaction ID: 2NJ26077720592129
https://www.paypal.com/activity/payment/2NJ26077720592129",PayPal Bank 3,--,$50.00,"$878,756.76"
Donations directed by individuals,09/23/2023,Deposit,2NJ26077720592129,04 PAYPAL GENERAL UNRESTR,Support Ukraine - Support Ukraine,Contributed income:Donations directed by individuals,PayPal Bank 3,$51.99,"$878,808.75"
PayPal Fees,09/23/2023,Deposit,2NJ26077720592129,04 PAYPAL GENERAL UNRESTR,PayPal fees,OFFICE/GENERAL ADMINISTRATIVE EXPENSES:PayPal Fees,PayPal Bank 3,$1.99,"$878,810.74"
PayPal Bank 3,09/23/2023,Deposit,1PG54135JX7240611,04 PAYPAL GENERAL UNRESTR,"Subject: GeneralPage
Transaction ID: 1PG54135JX7240611
https://www.paypal.com/activity/payment/1PG54135JX7240611",PayPal Bank 3,--,$49.22,"$878,859.96"
Donations directed by individuals,09/23/2023,Deposit,1PG54135JX7240611,04 PAYPAL GENERAL UNRESTR,Support Ukraine - Support Ukraine,Contributed income:Donations directed by individuals,PayPal Bank 3,$51.99,"$878,911.95"
PayPal Fees,09/23/2023,Deposit,1PG54135JX7240611,04 PAYPAL GENERAL UNRESTR,PayPal fees,OFFICE/GENERAL ADMINISTRATIVE EXPENSES:PayPal Fees,PayPal Bank 3,$2.77,"$878,914.72"
PayPal Bank 3,09/23/2023,Deposit,5V0372480N270221C,04 PAYPAL GENERAL UNRESTR,"Subject: Support Ukraine
Transaction ID: 5V0372480N270221C
https://www.paypal.com/activity/payment/5V0372480N270221C",PayPal Bank 3,--,$193.73,"$879,108.45"
Donations directed by individuals,09/23/2023,Deposit,5V0372480N270221C,04 PAYPAL GENERAL UNRESTR,Money in to PayPal,Contributed income:Donations directed by individuals,PayPal Bank 3,$200.00,"$879,308.45"
PayPal Fees,09/23/2023,Deposit,5V0372480N270221C,04 PAYPAL GENERAL UNRESTR,PayPal fees,OFFICE/GENERAL ADMINISTRATIVE EXPENSES:PayPal Fees,PayPal Bank 3,$6.27,"$879,314.72"
PayPal Bank 3,09/23/2023,Deposit,83A87585UT442860P,04 PAYPAL GENERAL UNRESTR,"Subject: GeneralPage
Transaction ID: 83A87585UT442860P
https://www.paypal.com/activity/payment/83A87585UT442860P",PayPal Bank 3,--,$96.62,"$879,411.34"
Donations directed by individuals,09/23/2023,Deposit,83A87585UT442860P,04 PAYPAL GENERAL UNRESTR,Support Ukraine - Support Ukraine,Contributed income:Donations directed by individuals,PayPal Bank 3,$100.00,"$879,511.34"
PayPal Fees,09/23/2023,Deposit,83A87585UT442860P,04 PAYPAL GENERAL UNRESTR,PayPal fees,OFFICE/GENERAL ADMINISTRATIVE EXPENSES:PayPal Fees,PayPal Bank 3,$3.38,"$879,514.72"
PayPal Bank 3,09/23/2023,Deposit,5JA35228HA676611R,04 PAYPAL GENERAL UNRESTR,"Subject: GeneralPage
Transaction ID: 5JA35228HA676611R
https://www.paypal.com/activity/payment/5JA35228HA676611R",PayPal Bank 3,--,$492.26,"$880,006.98"
Donations directed by individuals,09/23/2023,Deposit,5JA35228HA676611R,04 PAYPAL GENERAL UNRESTR,Support Ukraine - Support Ukraine,Contributed income:Donations directed by individuals,PayPal Bank 3,$515.38,"$880,522.36"
PayPal Fees,09/23/2023,Deposit,5JA35228HA676611R,04 PAYPAL GENERAL UNRESTR,PayPal fees,OFFICE/GENERAL ADMINISTRATIVE EXPENSES:PayPal Fees,PayPal Bank 3,$23.12,"$880,545.48"
PayPal Bank 3,09/23/2023,Deposit,0LK53003JB1138543,04 PAYPAL GENERAL UNRESTR,"Subject: GeneralPage
Transaction ID: 0LK53003JB1138543
https://www.paypal.com/activity/payment/0LK53003JB1138543",PayPal Bank 3,--,$50.00,"$880,595.48"
Donations directed by individuals,09/23/2023,Deposit,0LK53003JB1138543,04 PAYPAL GENERAL UNRESTR,Support Ukraine - Support Ukraine,Contributed income:Donations directed by individuals,PayPal Bank 3,$51.99,"$880,647.47"
PayPal Fees,09/23/2023,Deposit,0LK53003JB1138543,04 PAYPAL GENERAL UNRESTR,PayPal fees,OFFICE/GENERAL ADMINISTRATIVE EXPENSES:PayPal Fees,PayPal Bank 3,$1.99,"$880,649.46"
PayPal Bank 3,09/23/2023,Deposit,02B546718W785282Y,04 PAYPAL GENERAL UNRESTR,"Subject: GeneralPage
Transaction ID: 02B546718W785282Y
https://www.paypal.com/activity/payment/02B546718W785282Y",PayPal Bank 3,--,$10.00,"$880,659.46"
Donations directed by individuals,09/23/2023,Deposit,02B546718W785282Y,04 PAYPAL GENERAL UNRESTR,Support Ukraine - Support Ukraine,Contributed income:Donations directed by individuals,PayPal Bank 3,$10.80,"$880,670.26"
PayPal Fees,09/23/2023,Deposit,02B546718W785282Y,04 PAYPAL GENERAL UNRESTR,PayPal fees,OFFICE/GENERAL ADMINISTRATIVE EXPENSES:PayPal Fees,PayPal Bank 3,$0.80,"$880,671.06"
PayPal Bank 3,09/23/2023,Deposit,0BK3818404001781N,04 PAYPAL GENERAL UNRESTR,"Subject: GeneralPage
Transaction ID: 0BK3818404001781N
https://www.paypal.com/activity/payment/0BK3818404001781N",PayPal Bank 3,--,$50.00,"$880,721.06"
Donations directed by individuals,09/23/2023,Deposit,0BK3818404001781N,04 PAYPAL GENERAL UNRESTR,Support Ukraine - Support Ukraine,Contributed income:Donations directed by individuals,PayPal Bank 3,$51.99,"$880,773.05"
PayPal Fees,09/23/2023,Deposit,0BK3818404001781N,04 PAYPAL GENERAL UNRESTR,PayPal fees,OFFICE/GENERAL ADMINISTRATIVE EXPENSES:PayPal Fees,PayPal Bank 3,$1.99,"$880,775.04"
PayPal Bank 3,09/23/2023,Deposit,2KN53284A3134434X,08 VICTORY DRONES RESTR,"Subject: VictoryDrones
Transaction ID: 2KN53284A3134434X
https://www.paypal.com/activity/payment/2KN53284A3134434X",PayPal Bank 3,--,$19.68,"$880,794.72"
Donations directed by individuals,09/23/2023,Deposit,2KN53284A3134434X,08 VICTORY DRONES RESTR,VICTORY DRONES - VICTORY DRONES,Contributed income:Donations directed by individuals,PayPal Bank 3,$21.10,"$880,815.82"
PayPal Fees,09/23/2023,Deposit,2KN53284A3134434X,08 VICTORY DRONES RESTR,PayPal fees,OFFICE/GENERAL ADMINISTRATIVE EXPENSES:PayPal Fees,PayPal Bank 3,$1.42,"$880,817.24"
PayPal Bank 3,09/23/2023,Deposit,14Y354229B560015H,04 PAYPAL GENERAL UNRESTR,"Subject: GeneralPage
Transaction ID: 14Y354229B560015H
https://www.paypal.com/activity/payment/14Y354229B560015H",PayPal Bank 3,--,$485.06,"$881,302.30"
Donations directed by individuals,09/23/2023,Deposit,14Y354229B560015H,04 PAYPAL GENERAL UNRESTR,Support Ukraine - Support Ukraine,Contributed income:Donations directed by individuals,PayPal Bank 3,$500.00,"$881,802.30"
PayPal Fees,09/23/2023,Deposit,14Y354229B560015H,04 PAYPAL GENERAL UNRESTR,PayPal fees,OFFICE/GENERAL ADMINISTRATIVE EXPENSES:PayPal Fees,PayPal Bank 3,$14.94,"$881,817.24"
PayPal Bank 3,09/23/2023,Deposit,7G457630EV506892T,04 PAYPAL GENERAL UNRESTR,"Subject: GeneralPage
Transaction ID: 7G457630EV506892T
https://www.paypal.com/activity/payment/7G457630EV506892T",PayPal Bank 3,--,$49.22,"$881,866.46"
Donations directed by individuals,09/23/2023,Deposit,7G457630EV506892T,04 PAYPAL GENERAL UNRESTR,Support Ukraine - Support Ukraine,Contributed income:Donations directed by individuals,PayPal Bank 3,$51.99,"$881,918.45"
PayPal Fees,09/23/2023,Deposit,7G457630EV506892T,04 PAYPAL GENERAL UNRESTR,PayPal fees,OFFICE/GENERAL ADMINISTRATIVE EXPENSES:PayPal Fees,PayPal Bank 3,$2.77,"$881,921.22"
PayPal Bank 3,09/23/2023,Deposit,66568384HG3550906,07 1000 DRONES RESTR,"Subject: 1000 DRONES FOR UKRAINE
Transaction ID: 66568384HG3550906
https://www.paypal.com/activity/payment/66568384HG3550906",PayPal Bank 3,--,$24.61,"$881,945.83"
Donations directed by individuals,09/23/2023,Deposit,66568384HG3550906,07 1000 DRONES RESTR,Money in to PayPal,Contributed income:Donations directed by individuals,PayPal Bank 3,$26.25,"$881,972.08"
PayPal Fees,09/23/2023,Deposit,66568384HG3550906,07 1000 DRONES RESTR,PayPal fees,OFFICE/GENERAL ADMINISTRATIVE EXPENSES:PayPal Fees,PayPal Bank 3,$1.64,"$881,973.72"
PayPal Bank 3,09/23/2023,Deposit,58M01245U2747191M,04 PAYPAL GENERAL UNRESTR,"Subject: GeneralPage
Transaction ID: 58M01245U2747191M
https://www.paypal.com/activity/payment/58M01245U2747191M",PayPal Bank 3,--,$33.47,"$882,007.19"
Donations directed by individuals,09/23/2023,Deposit,58M01245U2747191M,04 PAYPAL GENERAL UNRESTR,Support Ukraine - Support Ukraine,Contributed income:Donations directed by individuals,PayPal Bank 3,$35.52,"$882,042.71"
PayPal Fees,09/23/2023,Deposit,58M01245U2747191M,04 PAYPAL GENERAL UNRESTR,PayPal fees,OFFICE/GENERAL ADMINISTRATIVE EXPENSES:PayPal Fees,PayPal Bank 3,$2.05,"$882,044.76"
PayPal Bank 3,09/23/2023,Deposit,5V182613YX908114U,08 VICTORY DRONES RESTR,"Subject: VictoryDrones
Note: Honor to: Lyuba Shipovich and all team
Transaction ID: 5V182613YX908114U
https://www.paypal.com/activity/payment/5V182613YX908114U",PayPal Bank 3,--,$108.00,"$882,152.76"
Donations directed by individuals,09/23/2023,Deposit,5V182613YX908114U,08 VICTORY DRONES RESTR,VICTORY DRONES - VICTORY DRONES,Contributed income:Donations directed by individuals,PayPal Bank 3,$111.72,"$882,264.48"
PayPal Fees,09/23/2023,Deposit,5V182613YX908114U,08 VICTORY DRONES RESTR,PayPal fees,OFFICE/GENERAL ADMINISTRATIVE EXPENSES:PayPal Fees,PayPal Bank 3,$3.72,"$882,268.20"
PayPal Bank 3,09/23/2023,Deposit,91077538HL419931F,07 1000 DRONES RESTR,"Subject: GeneralPage
Note: На дрони на честь дня народження Катерини Шліфер
Transaction ID: 91077538HL419931F
https://www.paypal.com/activity/payment/91077538HL419931F",PayPal Bank 3,--,$49.22,"$882,317.42"
Donations directed by individuals,09/23/2023,Deposit,91077538HL419931F,07 1000 DRONES RESTR,Support Ukraine - Support Ukraine,Contributed income:Donations directed by individuals,PayPal Bank 3,$51.99,"$882,369.41"
PayPal Fees,09/23/2023,Deposit,91077538HL419931F,07 1000 DRONES RESTR,PayPal fees,OFFICE/GENERAL ADMINISTRATIVE EXPENSES:PayPal Fees,PayPal Bank 3,$2.77,"$882,372.18"
PayPal Bank 3,09/23/2023,Deposit,1NW228256Y3581319,04 PAYPAL GENERAL UNRESTR,"Subject: GeneralPage
Transaction ID: 1NW228256Y3581319
https://www.paypal.com/activity/payment/1NW228256Y3581319",PayPal Bank 3,--,$19.68,"$882,391.86"
Donations directed by individuals,09/23/2023,Deposit,1NW228256Y3581319,04 PAYPAL GENERAL UNRESTR,Support Ukraine - Support Ukraine,Contributed income:Donations directed by individuals,PayPal Bank 3,$21.10,"$882,412.96"
PayPal Fees,09/23/2023,Deposit,1NW228256Y3581319,04 PAYPAL GENERAL UNRESTR,PayPal fees,OFFICE/GENERAL ADMINISTRATIVE EXPENSES:PayPal Fees,PayPal Bank 3,$1.42,"$882,414.38"
PayPal Bank 3,09/23/2023,Deposit,79N73737P6977362H,04 PAYPAL GENERAL UNRESTR,"Subject: GeneralPage
Transaction ID: 79N73737P6977362H
https://www.paypal.com/activity/payment/79N73737P6977362H",PayPal Bank 3,--,$50.00,"$882,464.38"
Donations directed by individuals,09/23/2023,Deposit,79N73737P6977362H,04 PAYPAL GENERAL UNRESTR,Support Ukraine - Support Ukraine,Contributed income:Donations directed by individuals,PayPal Bank 3,$51.99,"$882,516.37"
PayPal Fees,09/23/2023,Deposit,79N73737P6977362H,04 PAYPAL GENERAL UNRESTR,PayPal fees,OFFICE/GENERAL ADMINISTRATIVE EXPENSES:PayPal Fees,PayPal Bank 3,$1.99,"$882,518.36"
PayPal Bank 3,09/23/2023,Deposit,01A20139MG717545R,07 1000 DRONES RESTR,"Subject: 1000DRONES
Transaction ID: 01A20139MG717545R
https://www.paypal.com/activity/payment/01A20139MG717545R",PayPal Bank 3,--,$9.07,"$882,527.43"
Donations directed by individuals,09/23/2023,Deposit,01A20139MG717545R,07 1000 DRONES RESTR,1000 DRONES FOR UKRAINE - 1000 DRONES FOR UKRAINE,Contributed income:Donations directed by individuals,PayPal Bank 3,$10.00,"$882,537.43"
PayPal Fees,09/23/2023,Deposit,01A20139MG717545R,07 1000 DRONES RESTR,PayPal fees,OFFICE/GENERAL ADMINISTRATIVE EXPENSES:PayPal Fees,PayPal Bank 3,$0.93,"$882,538.36"
PayPal Bank 3,09/23/2023,Deposit,3K7471717F527735M,04 PAYPAL GENERAL UNRESTR,"Subject: Support Ukraine
Transaction ID: 3K7471717F527735M
https://www.paypal.com/activity/payment/3K7471717F527735M",PayPal Bank 3,--,$11.81,"$882,550.17"
Donations directed by individuals,09/23/2023,Deposit,3K7471717F527735M,04 PAYPAL GENERAL UNRESTR,Money in to PayPal,Contributed income:Donations directed by individuals,PayPal Bank 3,$12.86,"$882,563.03"
PayPal Fees,09/23/2023,Deposit,3K7471717F527735M,04 PAYPAL GENERAL UNRESTR,PayPal fees,OFFICE/GENERAL ADMINISTRATIVE EXPENSES:PayPal Fees,PayPal Bank 3,$1.05,"$882,564.08"
PayPal Bank 3,09/23/2023,Deposit,6CJ25789UF098361K,07 1000 DRONES RESTR,"Subject: 1000 DRONES FOR UKRAINE
Transaction ID: 6CJ25789UF098361K
https://www.paypal.com/activity/payment/6CJ25789UF098361K",PayPal Bank 3,--,$10.82,"$882,574.90"
Donations directed by individuals,09/23/2023,Deposit,6CJ25789UF098361K,07 1000 DRONES RESTR,Money in to PayPal,Contributed income:Donations directed by individuals,PayPal Bank 3,$11.83,"$882,586.73"
PayPal Fees,09/23/2023,Deposit,6CJ25789UF098361K,07 1000 DRONES RESTR,PayPal fees,OFFICE/GENERAL ADMINISTRATIVE EXPENSES:PayPal Fees,PayPal Bank 3,$1.01,"$882,587.74"
PayPal Bank 3,09/23/2023,Deposit,4K041382F2815471L,04 PAYPAL GENERAL UNRESTR,"Subject: GeneralPage
Transaction ID: 4K041382F2815471L
https://www.paypal.com/activity/payment/4K041382F2815471L",PayPal Bank 3,--,$100.00,"$882,687.74"
Donations directed by individuals,09/23/2023,Deposit,4K041382F2815471L,04 PAYPAL GENERAL UNRESTR,Support Ukraine - Support Ukraine,Contributed income:Donations directed by individuals,PayPal Bank 3,$103.48,"$882,791.22"
PayPal Fees,09/23/2023,Deposit,4K041382F2815471L,04 PAYPAL GENERAL UNRESTR,PayPal fees,OFFICE/GENERAL ADMINISTRATIVE EXPENSES:PayPal Fees,PayPal Bank 3,$3.48,"$882,794.70"
PayPal Bank 3,09/23/2023,Deposit,5N255724782856438,04 PAYPAL GENERAL UNRESTR,"Subject: GeneralPage
Transaction ID: 5N255724782856438
https://www.paypal.com/activity/payment/5N255724782856438",PayPal Bank 3,--,$98.45,"$882,893.15"
Donations directed by individuals,09/23/2023,Deposit,5N255724782856438,04 PAYPAL GENERAL UNRESTR,Support Ukraine - Support Ukraine,Contributed income:Donations directed by individuals,PayPal Bank 3,$103.48,"$882,996.63"
PayPal Fees,09/23/2023,Deposit,5N255724782856438,04 PAYPAL GENERAL UNRESTR,PayPal fees,OFFICE/GENERAL ADMINISTRATIVE EXPENSES:PayPal Fees,PayPal Bank 3,$5.03,"$883,001.66"
PayPal Bank 3,09/23/2023,Deposit,27038802EP0081510,04 PAYPAL GENERAL UNRESTR,"Subject: GeneralPage
Transaction ID: 27038802EP0081510
https://www.paypal.com/activity/payment/27038802EP0081510",PayPal Bank 3,--,$96.62,"$883,098.28"
Donations directed by individuals,09/23/2023,Deposit,27038802EP0081510,04 PAYPAL GENERAL UNRESTR,Support Ukraine - Support Ukraine,Contributed income:Donations directed by individuals,PayPal Bank 3,$100.00,"$883,198.28"
PayPal Fees,09/23/2023,Deposit,27038802EP0081510,04 PAYPAL GENERAL UNRESTR,PayPal fees,OFFICE/GENERAL ADMINISTRATIVE EXPENSES:PayPal Fees,PayPal Bank 3,$3.38,"$883,201.66"
PayPal Bank 3,09/23/2023,Deposit,28E10268044666340,04 PAYPAL GENERAL UNRESTR,"Subject: GeneralPage
Transaction ID: 28E10268044666340
https://www.paypal.com/activity/payment/28E10268044666340",PayPal Bank 3,--,$50.00,"$883,251.66"
Donations directed by individuals,09/23/2023,Deposit,28E10268044666340,04 PAYPAL GENERAL UNRESTR,Support Ukraine - Support Ukraine,Contributed income:Donations directed by individuals,PayPal Bank 3,$51.99,"$883,303.65"
PayPal Fees,09/23/2023,Deposit,28E10268044666340,04 PAYPAL GENERAL UNRESTR,PayPal fees,OFFICE/GENERAL ADMINISTRATIVE EXPENSES:PayPal Fees,PayPal Bank 3,$1.99,"$883,305.64"
PayPal Bank 3,09/23/2023,Deposit,54K03927TK6156128,04 PAYPAL GENERAL UNRESTR,"Subject: GeneralPage
Transaction ID: 54K03927TK6156128
https://www.paypal.com/activity/payment/54K03927TK6156128",PayPal Bank 3,--,$19.68,"$883,325.32"
Donations directed by individuals,09/23/2023,Deposit,54K03927TK6156128,04 PAYPAL GENERAL UNRESTR,Support Ukraine - Support Ukraine,Contributed income:Donations directed by individuals,PayPal Bank 3,$21.10,"$883,346.42"
PayPal Fees,09/23/2023,Deposit,54K03927TK6156128,04 PAYPAL GENERAL UNRESTR,PayPal fees,OFFICE/GENERAL ADMINISTRATIVE EXPENSES:PayPal Fees,PayPal Bank 3,$1.42,"$883,347.84"
PayPal Bank 3,09/23/2023,Deposit,2WJ30512FX3528524,04 PAYPAL GENERAL UNRESTR,"Subject: Support Ukraine
Transaction ID: 2WJ30512FX3528524
https://www.paypal.com/activity/payment/2WJ30512FX3528524",PayPal Bank 3,--,$29.53,"$883,377.37"
Donations directed by individuals,09/23/2023,Deposit,2WJ30512FX3528524,04 PAYPAL GENERAL UNRESTR,Money in to PayPal,Contributed income:Donations directed by individuals,PayPal Bank 3,$31.40,"$883,408.77"
PayPal Fees,09/23/2023,Deposit,2WJ30512FX3528524,04 PAYPAL GENERAL UNRESTR,PayPal fees,OFFICE/GENERAL ADMINISTRATIVE EXPENSES:PayPal Fees,PayPal Bank 3,$1.87,"$883,410.64"
PayPal Bank 3,09/23/2023,Deposit,8VB648034T5190047,04 PAYPAL GENERAL UNRESTR,"Subject: GeneralPage
Transaction ID: 8VB648034T5190047
https://www.paypal.com/activity/payment/8VB648034T5190047",PayPal Bank 3,--,$25.00,"$883,435.64"
Donations directed by individuals,09/23/2023,Deposit,8VB648034T5190047,04 PAYPAL GENERAL UNRESTR,Support Ukraine - Support Ukraine,Contributed income:Donations directed by individuals,PayPal Bank 3,$26.25,"$883,461.89"
PayPal Fees,09/23/2023,Deposit,8VB648034T5190047,04 PAYPAL GENERAL UNRESTR,PayPal fees,OFFICE/GENERAL ADMINISTRATIVE EXPENSES:PayPal Fees,PayPal Bank 3,$1.25,"$883,463.14"
PayPal Bank 3,09/23/2023,Deposit,5BD32753B65157406,04 PAYPAL GENERAL UNRESTR,"Subject: GeneralPage
Transaction ID: 5BD32753B65157406
https://www.paypal.com/activity/payment/5BD32753B65157406",PayPal Bank 3,--,$50.00,"$883,513.14"
Donations directed by individuals,09/23/2023,Deposit,5BD32753B65157406,04 PAYPAL GENERAL UNRESTR,Support Ukraine - Support Ukraine,Contributed income:Donations directed by individuals,PayPal Bank 3,$51.99,"$883,565.13"
PayPal Fees,09/23/2023,Deposit,5BD32753B65157406,04 PAYPAL GENERAL UNRESTR,PayPal fees,OFFICE/GENERAL ADMINISTRATIVE EXPENSES:PayPal Fees,PayPal Bank 3,$1.99,"$883,567.12"
PayPal Bank 3,09/23/2023,Deposit,4S657812RT310644B,04 PAYPAL GENERAL UNRESTR,"Subject: GeneralPage
Transaction ID: 4S657812RT310644B
https://www.paypal.com/activity/payment/4S657812RT310644B",PayPal Bank 3,--,$9.07,"$883,576.19"
Donations directed by individuals,09/23/2023,Deposit,4S657812RT310644B,04 PAYPAL GENERAL UNRESTR,Support Ukraine - Support Ukraine,Contributed income:Donations directed by individuals,PayPal Bank 3,$10.00,"$883,586.19"
PayPal Fees,09/23/2023,Deposit,4S657812RT310644B,04 PAYPAL GENERAL UNRESTR,PayPal fees,OFFICE/GENERAL ADMINISTRATIVE EXPENSES:PayPal Fees,PayPal Bank 3,$0.93,"$883,587.12"
PayPal Bank 3,09/23/2023,Deposit,1FW155467A029952T,04 PAYPAL GENERAL UNRESTR,"Subject: GeneralPage
Transaction ID: 1FW155467A029952T
https://www.paypal.com/activity/payment/1FW155467A029952T",PayPal Bank 3,--,$10.00,"$883,597.12"
Donations directed by individuals,09/23/2023,Deposit,1FW155467A029952T,04 PAYPAL GENERAL UNRESTR,Support Ukraine - Support Ukraine,Contributed income:Donations directed by individuals,PayPal Bank 3,$10.80,"$883,607.92"
PayPal Fees,09/23/2023,Deposit,1FW155467A029952T,04 PAYPAL GENERAL UNRESTR,PayPal fees,OFFICE/GENERAL ADMINISTRATIVE EXPENSES:PayPal Fees,PayPal Bank 3,$0.80,"$883,608.72"
PayPal Bank 3,09/23/2023,Deposit,2HX1819960016541E,04 PAYPAL GENERAL UNRESTR,"Subject: GeneralPage
Transaction ID: 2HX1819960016541E
https://www.paypal.com/activity/payment/2HX1819960016541E",PayPal Bank 3,--,$200.00,"$883,808.72"
Donations directed by individuals,09/23/2023,Deposit,2HX1819960016541E,04 PAYPAL GENERAL UNRESTR,Support Ukraine - Support Ukraine,Contributed income:Donations directed by individuals,PayPal Bank 3,$206.46,"$884,015.18"
PayPal Fees,09/23/2023,Deposit,2HX1819960016541E,04 PAYPAL GENERAL UNRESTR,PayPal fees,OFFICE/GENERAL ADMINISTRATIVE EXPENSES:PayPal Fees,PayPal Bank 3,$6.46,"$884,021.64"
PayPal Bank 3,09/23/2023,Deposit,07740514KY660261P,10 Flight to Recovery RESTR,"Subject: Dignitas Ukraine Flight to Recovery
Transaction ID: 07740514KY660261P
https://www.paypal.com/activity/payment/07740514KY660261P",PayPal Bank 3,--,$50.00,"$884,071.64"
Donations directed by individuals,09/23/2023,Deposit,07740514KY660261P,10 Flight to Recovery RESTR,Money in to PayPal,Contributed income:Donations directed by individuals,PayPal Bank 3,$51.99,"$884,123.63"
PayPal Fees,09/23/2023,Deposit,07740514KY660261P,10 Flight to Recovery RESTR,PayPal fees,OFFICE/GENERAL ADMINISTRATIVE EXPENSES:PayPal Fees,PayPal Bank 3,$1.99,"$884,125.62"
PayPal Bank 3,09/23/2023,Deposit,3SM22770VR113021S,04 PAYPAL GENERAL UNRESTR,"Subject: GeneralPage
Transaction ID: 3SM22770VR113021S
https://www.paypal.com/activity/payment/3SM22770VR113021S",PayPal Bank 3,--,$28.19,"$884,153.81"
Donations directed by individuals,09/23/2023,Deposit,3SM22770VR113021S,04 PAYPAL GENERAL UNRESTR,Support Ukraine - Support Ukraine,Contributed income:Donations directed by individuals,PayPal Bank 3,$30.00,"$884,183.81"
PayPal Fees,09/23/2023,Deposit,3SM22770VR113021S,04 PAYPAL GENERAL UNRESTR,PayPal fees,OFFICE/GENERAL ADMINISTRATIVE EXPENSES:PayPal Fees,PayPal Bank 3,$1.81,"$884,185.62"
PayPal Bank 3,09/23/2023,Deposit,1PJ21337X0381634E,08 VICTORY DRONES RESTR,"Subject: VICTORY DRONES
Transaction ID: 1PJ21337X0381634E
https://www.paypal.com/activity/payment/1PJ21337X0381634E",PayPal Bank 3,--,$98.45,"$884,284.07"
Donations directed by individuals,09/23/2023,Deposit,1PJ21337X0381634E,08 VICTORY DRONES RESTR,Money in to PayPal,Contributed income:Donations directed by individuals,PayPal Bank 3,$103.48,"$884,387.55"
PayPal Fees,09/23/2023,Deposit,1PJ21337X0381634E,08 VICTORY DRONES RESTR,PayPal fees,OFFICE/GENERAL ADMINISTRATIVE EXPENSES:PayPal Fees,PayPal Bank 3,$5.03,"$884,392.58"
PayPal Bank 3,09/23/2023,Deposit,5GC20159K01484358,10 Flight to Recovery RESTR,"Subject: Dignitas Ukraine Flight to Recovery
Transaction ID: 5GC20159K01484358
https://www.paypal.com/activity/payment/5GC20159K01484358",PayPal Bank 3,--,$98.45,"$884,491.03"
Donations directed by individuals,09/23/2023,Deposit,5GC20159K01484358,10 Flight to Recovery RESTR,Money in to PayPal,Contributed income:Donations directed by individuals,PayPal Bank 3,$103.48,"$884,594.51"
PayPal Fees,09/23/2023,Deposit,5GC20159K01484358,10 Flight to Recovery RESTR,PayPal fees,OFFICE/GENERAL ADMINISTRATIVE EXPENSES:PayPal Fees,PayPal Bank 3,$5.03,"$884,599.54"
PayPal Bank 3,09/23/2023,Deposit,9XB53773E89036047,04 PAYPAL GENERAL UNRESTR,"Subject: GeneralPage
Transaction ID: 9XB53773E89036047
https://www.paypal.com/activity/payment/9XB53773E89036047",PayPal Bank 3,--,$96.62,"$884,696.16"
Donations directed by individuals,09/23/2023,Deposit,9XB53773E89036047,04 PAYPAL GENERAL UNRESTR,Support Ukraine - Support Ukraine,Contributed income:Donations directed by individuals,PayPal Bank 3,$100.00,"$884,796.16"
PayPal Fees,09/23/2023,Deposit,9XB53773E89036047,04 PAYPAL GENERAL UNRESTR,PayPal fees,OFFICE/GENERAL ADMINISTRATIVE EXPENSES:PayPal Fees,PayPal Bank 3,$3.38,"$884,799.54"
PayPal Bank 3,09/23/2023,Deposit,78N74887AR473462F,04 PAYPAL GENERAL UNRESTR,"Subject: GeneralPage
Transaction ID: 78N74887AR473462F
https://www.paypal.com/activity/payment/78N74887AR473462F",PayPal Bank 3,--,$20.54,"$884,820.08"
Donations directed by individuals,09/23/2023,Deposit,78N74887AR473462F,04 PAYPAL GENERAL UNRESTR,Support Ukraine - Support Ukraine,Contributed income:Donations directed by individuals,PayPal Bank 3,$22.00,"$884,842.08"
PayPal Fees,09/23/2023,Deposit,78N74887AR473462F,04 PAYPAL GENERAL UNRESTR,PayPal fees,OFFICE/GENERAL ADMINISTRATIVE EXPENSES:PayPal Fees,PayPal Bank 3,$1.46,"$884,843.54"
PayPal Bank 3,09/23/2023,Deposit,7H440140EG856641L,04 PAYPAL GENERAL UNRESTR,"Subject: GeneralPage
Transaction ID: 7H440140EG856641L
https://www.paypal.com/activity/payment/7H440140EG856641L",PayPal Bank 3,--,$13.85,"$884,857.39"
Donations directed by individuals,09/23/2023,Deposit,7H440140EG856641L,04 PAYPAL GENERAL UNRESTR,Support Ukraine - Support Ukraine,Contributed income:Donations directed by individuals,PayPal Bank 3,$15.00,"$884,872.39"
PayPal Fees,09/23/2023,Deposit,7H440140EG856641L,04 PAYPAL GENERAL UNRESTR,PayPal fees,OFFICE/GENERAL ADMINISTRATIVE EXPENSES:PayPal Fees,PayPal Bank 3,$1.15,"$884,873.54"
PayPal Bank 3,09/23/2023,Deposit,31P730153B8899938,04 PAYPAL GENERAL UNRESTR,"Subject: GeneralPage
Note: Thank you for your support.   Glory to Ukraine!
Transaction ID: 31P730153B8899938
https://www.paypal.com/activity/payment/31P730153B8899938",PayPal Bank 3,--,$50.00,"$884,923.54"
Donations directed by individuals,09/23/2023,Deposit,31P730153B8899938,04 PAYPAL GENERAL UNRESTR,Support Ukraine - Support Ukraine,Contributed income:Donations directed by individuals,PayPal Bank 3,$51.99,"$884,975.53"
PayPal Fees,09/23/2023,Deposit,31P730153B8899938,04 PAYPAL GENERAL UNRESTR,PayPal fees,OFFICE/GENERAL ADMINISTRATIVE EXPENSES:PayPal Fees,PayPal Bank 3,$1.99,"$884,977.52"
PayPal Bank 3,09/23/2023,Deposit,927981320R714934J,07 1000 DRONES RESTR,"Subject: 1000DRONES
Note: нехай летять пташки
Transaction ID: 927981320R714934J
https://www.paypal.com/activity/payment/927981320R714934J",PayPal Bank 3,--,$630.72,"$885,608.24"
Donations directed by individuals,09/23/2023,Deposit,927981320R714934J,07 1000 DRONES RESTR,1000 DRONES FOR UKRAINE - 1000 DRONES FOR UKRAINE,Contributed income:Donations directed by individuals,PayPal Bank 3,$650.00,"$886,258.24"
PayPal Fees,09/23/2023,Deposit,927981320R714934J,07 1000 DRONES RESTR,PayPal fees,OFFICE/GENERAL ADMINISTRATIVE EXPENSES:PayPal Fees,PayPal Bank 3,$19.28,"$886,277.52"
PayPal Bank 3,09/23/2023,Deposit,0AD26228P85908925,07 1000 DRONES RESTR,"Subject: 1000DRONES
Note: Donate from Dub Family to purchase drones
Transaction ID: 0AD26228P85908925
https://www.paypal.com/activity/payment/0AD26228P85908925",PayPal Bank 3,--,$100.00,"$886,377.52"
Donations directed by individuals,09/23/2023,Deposit,0AD26228P85908925,07 1000 DRONES RESTR,1000 DRONES FOR UKRAINE - 1000 DRONES FOR UKRAINE,Contributed income:Donations directed by individuals,PayPal Bank 3,$103.48,"$886,481.00"
PayPal Fees,09/23/2023,Deposit,0AD26228P85908925,07 1000 DRONES RESTR,PayPal fees,OFFICE/GENERAL ADMINISTRATIVE EXPENSES:PayPal Fees,PayPal Bank 3,$3.48,"$886,484.48"
PayPal Bank 3,09/23/2023,Deposit,3AC87114AX939674L,04 PAYPAL GENERAL UNRESTR,"Subject: GeneralPage
Transaction ID: 3AC87114AX939674L
https://www.paypal.com/activity/payment/3AC87114AX939674L",PayPal Bank 3,--,$100.00,"$886,584.48"
Donations directed by individuals,09/23/2023,Deposit,3AC87114AX939674L,04 PAYPAL GENERAL UNRESTR,Support Ukraine - Support Ukraine,Contributed income:Donations directed by individuals,PayPal Bank 3,$103.48,"$886,687.96"
PayPal Fees,09/23/2023,Deposit,3AC87114AX939674L,04 PAYPAL GENERAL UNRESTR,PayPal fees,OFFICE/GENERAL ADMINISTRATIVE EXPENSES:PayPal Fees,PayPal Bank 3,$3.48,"$886,691.44"
PayPal Bank 3,09/23/2023,Deposit,3VS706893Y980111Y,04 PAYPAL GENERAL UNRESTR,"Subject: GeneralPage
Transaction ID: 3VS706893Y980111Y
https://www.paypal.com/activity/payment/3VS706893Y980111Y",PayPal Bank 3,--,$49.22,"$886,740.66"
Donations directed by individuals,09/23/2023,Deposit,3VS706893Y980111Y,04 PAYPAL GENERAL UNRESTR,Support Ukraine - Support Ukraine,Contributed income:Donations directed by individuals,PayPal Bank 3,$51.99,"$886,792.65"
PayPal Fees,09/23/2023,Deposit,3VS706893Y980111Y,04 PAYPAL GENERAL UNRESTR,PayPal fees,OFFICE/GENERAL ADMINISTRATIVE EXPENSES:PayPal Fees,PayPal Bank 3,$2.77,"$886,795.42"
PayPal Bank 3,09/23/2023,Deposit,1WS5944815973093P,04 PAYPAL GENERAL UNRESTR,"Subject: GeneralPage
Note: How much does a drone cost?
Transaction ID: 1WS5944815973093P
https://www.paypal.com/activity/payment/1WS5944815973093P",PayPal Bank 3,--,$541.49,"$887,336.91"
Donations directed by individuals,09/23/2023,Deposit,1WS5944815973093P,04 PAYPAL GENERAL UNRESTR,Support Ukraine - Support Ukraine,Contributed income:Donations directed by individuals,PayPal Bank 3,$566.87,"$887,903.78"
PayPal Fees,09/23/2023,Deposit,1WS5944815973093P,04 PAYPAL GENERAL UNRESTR,PayPal fees,OFFICE/GENERAL ADMINISTRATIVE EXPENSES:PayPal Fees,PayPal Bank 3,$25.38,"$887,929.16"
PayPal Bank 3,09/23/2023,Deposit,5MM51854BE9204300,04 PAYPAL GENERAL UNRESTR,"Subject: Support Ukraine
Transaction ID: 5MM51854BE9204300
https://www.paypal.com/activity/payment/5MM51854BE9204300",PayPal Bank 3,--,$4.29,"$887,933.45"
Donations directed by individuals,09/23/2023,Deposit,5MM51854BE9204300,04 PAYPAL GENERAL UNRESTR,Money in to PayPal,Contributed income:Donations directed by individuals,PayPal Bank 3,$5.00,"$887,938.45"
PayPal Fees,09/23/2023,Deposit,5MM51854BE9204300,04 PAYPAL GENERAL UNRESTR,PayPal fees,OFFICE/GENERAL ADMINISTRATIVE EXPENSES:PayPal Fees,PayPal Bank 3,$0.71,"$887,939.16"
PayPal Bank 3,09/23/2023,Deposit,7T65970426349884E,07 1000 DRONES RESTR,"Subject: 1000DRONES
Transaction ID: 7T65970426349884E
https://www.paypal.com/activity/payment/7T65970426349884E",PayPal Bank 3,--,$19.68,"$887,958.84"
Donations directed by individuals,09/23/2023,Deposit,7T65970426349884E,07 1000 DRONES RESTR,1000 DRONES FOR UKRAINE - 1000 DRONES FOR UKRAINE,Contributed income:Donations directed by individuals,PayPal Bank 3,$21.10,"$887,979.94"
PayPal Fees,09/23/2023,Deposit,7T65970426349884E,07 1000 DRONES RESTR,PayPal fees,OFFICE/GENERAL ADMINISTRATIVE EXPENSES:PayPal Fees,PayPal Bank 3,$1.42,"$887,981.36"
PayPal Bank 3,09/23/2023,Deposit,7PJ53948KS975352J,07 1000 DRONES RESTR,"Subject: GeneralPage
Note: На дрон для України
Transaction ID: 7PJ53948KS975352J
https://www.paypal.com/activity/payment/7PJ53948KS975352J",PayPal Bank 3,--,$96.62,"$888,077.98"
Donations directed by individuals,09/23/2023,Deposit,7PJ53948KS975352J,07 1000 DRONES RESTR,Support Ukraine - Support Ukraine,Contributed income:Donations directed by individuals,PayPal Bank 3,$100.00,"$888,177.98"
PayPal Fees,09/23/2023,Deposit,7PJ53948KS975352J,07 1000 DRONES RESTR,PayPal fees,OFFICE/GENERAL ADMINISTRATIVE EXPENSES:PayPal Fees,PayPal Bank 3,$3.38,"$888,181.36"
PayPal Bank 3,09/23/2023,Deposit,2RG00312E60205211,04 PAYPAL GENERAL UNRESTR,"Subject: GeneralPage
Transaction ID: 2RG00312E60205211
https://www.paypal.com/activity/payment/2RG00312E60205211",PayPal Bank 3,--,"$1,941.71","$890,123.07"
Donations directed by individuals,09/23/2023,Deposit,2RG00312E60205211,04 PAYPAL GENERAL UNRESTR,Support Ukraine - Support Ukraine,Contributed income:Donations directed by individuals,PayPal Bank 3,"$2,000.00","$892,123.07"
PayPal Fees,09/23/2023,Deposit,2RG00312E60205211,04 PAYPAL GENERAL UNRESTR,PayPal fees,OFFICE/GENERAL ADMINISTRATIVE EXPENSES:PayPal Fees,PayPal Bank 3,$58.29,"$892,181.36"
PayPal Bank 3,09/23/2023,Deposit,9FL410281P3847604,04 PAYPAL GENERAL UNRESTR,"Subject: Support Ukraine
Transaction ID: 9FL410281P3847604
https://www.paypal.com/activity/payment/9FL410281P3847604",PayPal Bank 3,--,$25.00,"$892,206.36"
Donations directed by individuals,09/23/2023,Deposit,9FL410281P3847604,04 PAYPAL GENERAL UNRESTR,Money in to PayPal,Contributed income:Donations directed by individuals,PayPal Bank 3,$26.25,"$892,232.61"
PayPal Fees,09/23/2023,Deposit,9FL410281P3847604,04 PAYPAL GENERAL UNRESTR,PayPal fees,OFFICE/GENERAL ADMINISTRATIVE EXPENSES:PayPal Fees,PayPal Bank 3,$1.25,"$892,233.86"
PayPal Bank 3,09/23/2023,Deposit,26W22203Y72452334,04 PAYPAL GENERAL UNRESTR,"Subject: GeneralPage
Transaction ID: 26W22203Y72452334
https://www.paypal.com/activity/payment/26W22203Y72452334",PayPal Bank 3,--,$9.07,"$892,242.93"
Donations directed by individuals,09/23/2023,Deposit,26W22203Y72452334,04 PAYPAL GENERAL UNRESTR,Support Ukraine - Support Ukraine,Contributed income:Donations directed by individuals,PayPal Bank 3,$10.00,"$892,252.93"
PayPal Fees,09/23/2023,Deposit,26W22203Y72452334,04 PAYPAL GENERAL UNRESTR,PayPal fees,OFFICE/GENERAL ADMINISTRATIVE EXPENSES:PayPal Fees,PayPal Bank 3,$0.93,"$892,253.86"
PayPal Bank 3,09/23/2023,Deposit,9AF94349FL570562G,04 PAYPAL GENERAL UNRESTR,"Subject: Support Ukraine
Transaction ID: 9AF94349FL570562G
https://www.paypal.com/activity/payment/9AF94349FL570562G",PayPal Bank 3,--,$68.35,"$892,322.21"
Donations directed by individuals,09/23/2023,Deposit,9AF94349FL570562G,04 PAYPAL GENERAL UNRESTR,Money in to PayPal,Contributed income:Donations directed by individuals,PayPal Bank 3,$72.00,"$892,394.21"
PayPal Fees,09/23/2023,Deposit,9AF94349FL570562G,04 PAYPAL GENERAL UNRESTR,PayPal fees,OFFICE/GENERAL ADMINISTRATIVE EXPENSES:PayPal Fees,PayPal Bank 3,$3.65,"$892,397.86"
PayPal Bank 3,09/23/2023,Deposit,8TJ76527VB7262132,04 PAYPAL GENERAL UNRESTR,"Subject: GeneralPage
Transaction ID: 8TJ76527VB7262132
https://www.paypal.com/activity/payment/8TJ76527VB7262132",PayPal Bank 3,--,$193.73,"$892,591.59"
Donations directed by individuals,09/23/2023,Deposit,8TJ76527VB7262132,04 PAYPAL GENERAL UNRESTR,Support Ukraine - Support Ukraine,Contributed income:Donations directed by individuals,PayPal Bank 3,$200.00,"$892,791.59"
PayPal Fees,09/23/2023,Deposit,8TJ76527VB7262132,04 PAYPAL GENERAL UNRESTR,PayPal fees,OFFICE/GENERAL ADMINISTRATIVE EXPENSES:PayPal Fees,PayPal Bank 3,$6.27,"$892,797.86"
PayPal Bank 3,09/23/2023,Deposit,6N342795V3145753P,04 PAYPAL GENERAL UNRESTR,"Subject: GeneralPage
Transaction ID: 6N342795V3145753P
https://www.paypal.com/activity/payment/6N342795V3145753P",PayPal Bank 3,--,$33.47,"$892,831.33"
Donations directed by individuals,09/23/2023,Deposit,6N342795V3145753P,04 PAYPAL GENERAL UNRESTR,Support Ukraine - Support Ukraine,Contributed income:Donations directed by individuals,PayPal Bank 3,$35.52,"$892,866.85"
PayPal Fees,09/23/2023,Deposit,6N342795V3145753P,04 PAYPAL GENERAL UNRESTR,PayPal fees,OFFICE/GENERAL ADMINISTRATIVE EXPENSES:PayPal Fees,PayPal Bank 3,$2.05,"$892,868.90"
PayPal Bank 3,09/23/2023,Deposit,8T877231T1544720B,04 PAYPAL GENERAL UNRESTR,"Subject: GeneralPage
Transaction ID: 8T877231T1544720B
https://www.paypal.com/activity/payment/8T877231T1544720B",PayPal Bank 3,--,$43.21,"$892,912.11"
Donations directed by individuals,09/23/2023,Deposit,8T877231T1544720B,04 PAYPAL GENERAL UNRESTR,Support Ukraine - Support Ukraine,Contributed income:Donations directed by individuals,PayPal Bank 3,$45.00,"$892,957.11"
PayPal Fees,09/23/2023,Deposit,8T877231T1544720B,04 PAYPAL GENERAL UNRESTR,PayPal fees,OFFICE/GENERAL ADMINISTRATIVE EXPENSES:PayPal Fees,PayPal Bank 3,$1.79,"$892,958.90"
PayPal Bank 3,09/23/2023,Deposit,5GX51317U50567018,07 1000 DRONES RESTR,"Subject: 1000DRONES
Transaction ID: 5GX51317U50567018
https://www.paypal.com/activity/payment/5GX51317U50567018",PayPal Bank 3,--,$48.06,"$893,006.96"
Donations directed by individuals,09/23/2023,Deposit,5GX51317U50567018,07 1000 DRONES RESTR,1000 DRONES FOR UKRAINE - 1000 DRONES FOR UKRAINE,Contributed income:Donations directed by individuals,PayPal Bank 3,$50.00,"$893,056.96"
PayPal Fees,09/23/2023,Deposit,5GX51317U50567018,07 1000 DRONES RESTR,PayPal fees,OFFICE/GENERAL ADMINISTRATIVE EXPENSES:PayPal Fees,PayPal Bank 3,$1.94,"$893,058.90"
PayPal Bank 3,09/23/2023,Deposit,78F25486W9536003E,07 1000 DRONES RESTR,"Subject: 1000DRONES
Transaction ID: 78F25486W9536003E
https://www.paypal.com/activity/payment/78F25486W9536003E",PayPal Bank 3,--,$51.00,"$893,109.90"
Donations directed by individuals,09/23/2023,Deposit,78F25486W9536003E,07 1000 DRONES RESTR,1000 DRONES FOR UKRAINE - 1000 DRONES FOR UKRAINE,Contributed income:Donations directed by individuals,PayPal Bank 3,$53.02,"$893,162.92"
PayPal Fees,09/23/2023,Deposit,78F25486W9536003E,07 1000 DRONES RESTR,PayPal fees,OFFICE/GENERAL ADMINISTRATIVE EXPENSES:PayPal Fees,PayPal Bank 3,$2.02,"$893,164.94"
PayPal Bank 3,09/23/2023,Deposit,1NM59292S3155102V,07 1000 DRONES RESTR,"Subject: 1000DRONES
Transaction ID: 1NM59292S3155102V
https://www.paypal.com/activity/payment/1NM59292S3155102V",PayPal Bank 3,--,$50.00,"$893,214.94"
Donations directed by individuals,09/23/2023,Deposit,1NM59292S3155102V,07 1000 DRONES RESTR,1000 DRONES FOR UKRAINE - 1000 DRONES FOR UKRAINE,Contributed income:Donations directed by individuals,PayPal Bank 3,$51.99,"$893,266.93"
PayPal Fees,09/23/2023,Deposit,1NM59292S3155102V,07 1000 DRONES RESTR,PayPal fees,OFFICE/GENERAL ADMINISTRATIVE EXPENSES:PayPal Fees,PayPal Bank 3,$1.99,"$893,268.92"
PayPal Bank 3,09/23/2023,Deposit,0U783249UR824542A,04 PAYPAL GENERAL UNRESTR,"Subject: GeneralPage
Transaction ID: 0U783249UR824542A
https://www.paypal.com/activity/payment/0U783249UR824542A",PayPal Bank 3,--,$49.22,"$893,318.14"
Donations directed by individuals,09/23/2023,Deposit,0U783249UR824542A,04 PAYPAL GENERAL UNRESTR,Support Ukraine - Support Ukraine,Contributed income:Donations directed by individuals,PayPal Bank 3,$51.99,"$893,370.13"
PayPal Fees,09/23/2023,Deposit,0U783249UR824542A,04 PAYPAL GENERAL UNRESTR,PayPal fees,OFFICE/GENERAL ADMINISTRATIVE EXPENSES:PayPal Fees,PayPal Bank 3,$2.77,"$893,372.90"
PayPal Bank 3,09/23/2023,Deposit,42H94566U4364802S,04 PAYPAL GENERAL UNRESTR,"Subject: GeneralPage
Transaction ID: 42H94566U4364802S
https://www.paypal.com/activity/payment/42H94566U4364802S",PayPal Bank 3,--,$18.93,"$893,391.83"
Donations directed by individuals,09/23/2023,Deposit,42H94566U4364802S,04 PAYPAL GENERAL UNRESTR,Support Ukraine - Support Ukraine,Contributed income:Donations directed by individuals,PayPal Bank 3,$20.00,"$893,411.83"
PayPal Fees,09/23/2023,Deposit,42H94566U4364802S,04 PAYPAL GENERAL UNRESTR,PayPal fees,OFFICE/GENERAL ADMINISTRATIVE EXPENSES:PayPal Fees,PayPal Bank 3,$1.07,"$893,412.90"
PayPal Bank 3,09/23/2023,Deposit,51836067JM587700N,04 PAYPAL GENERAL UNRESTR,"Subject: GeneralPage
Transaction ID: 51836067JM587700N
https://www.paypal.com/activity/payment/51836067JM587700N",PayPal Bank 3,--,$10.00,"$893,422.90"
Donations directed by individuals,09/23/2023,Deposit,51836067JM587700N,04 PAYPAL GENERAL UNRESTR,Support Ukraine - Support Ukraine,Contributed income:Donations directed by individuals,PayPal Bank 3,$10.80,"$893,433.70"
PayPal Fees,09/23/2023,Deposit,51836067JM587700N,04 PAYPAL GENERAL UNRESTR,PayPal fees,OFFICE/GENERAL ADMINISTRATIVE EXPENSES:PayPal Fees,PayPal Bank 3,$0.80,"$893,434.50"
PayPal Bank 3,09/23/2023,Deposit,9J4295428X058634N,07 1000 DRONES RESTR,"Subject: 1000DRONES
Transaction ID: 9J4295428X058634N
https://www.paypal.com/activity/payment/9J4295428X058634N",PayPal Bank 3,--,$96.62,"$893,531.12"
Donations directed by individuals,09/23/2023,Deposit,9J4295428X058634N,07 1000 DRONES RESTR,1000 DRONES FOR UKRAINE - 1000 DRONES FOR UKRAINE,Contributed income:Donations directed by individuals,PayPal Bank 3,$100.00,"$893,631.12"
PayPal Fees,09/23/2023,Deposit,9J4295428X058634N,07 1000 DRONES RESTR,PayPal fees,OFFICE/GENERAL ADMINISTRATIVE EXPENSES:PayPal Fees,PayPal Bank 3,$3.38,"$893,634.50"
PayPal Bank 3,09/23/2023,Deposit,5PA79431BA3165439,04 PAYPAL GENERAL UNRESTR,"Subject: GeneralPage
Transaction ID: 5PA79431BA3165439
https://www.paypal.com/activity/payment/5PA79431BA3165439",PayPal Bank 3,--,"$2,912.81","$896,547.31"
Donations directed by individuals,09/23/2023,Deposit,5PA79431BA3165439,04 PAYPAL GENERAL UNRESTR,Support Ukraine - Support Ukraine,Contributed income:Donations directed by individuals,PayPal Bank 3,"$3,000.00","$899,547.31"
PayPal Fees,09/23/2023,Deposit,5PA79431BA3165439,04 PAYPAL GENERAL UNRESTR,PayPal fees,OFFICE/GENERAL ADMINISTRATIVE EXPENSES:PayPal Fees,PayPal Bank 3,$87.19,"$899,634.50"
PayPal Bank 3,09/23/2023,Deposit,34S99665R0270580N,07 1000 DRONES RESTR,"Subject: 1000DRONES
Transaction ID: 34S99665R0270580N
https://www.paypal.com/activity/payment/34S99665R0270580N",PayPal Bank 3,--,$48.06,"$899,682.56"
Donations directed by individuals,09/23/2023,Deposit,34S99665R0270580N,07 1000 DRONES RESTR,1000 DRONES FOR UKRAINE - 1000 DRONES FOR UKRAINE,Contributed income:Donations directed by individuals,PayPal Bank 3,$50.00,"$899,732.56"
PayPal Fees,09/23/2023,Deposit,34S99665R0270580N,07 1000 DRONES RESTR,PayPal fees,OFFICE/GENERAL ADMINISTRATIVE EXPENSES:PayPal Fees,PayPal Bank 3,$1.94,"$899,734.50"
PayPal Bank 3,09/23/2023,Deposit,15D70934N0933822G,04 PAYPAL GENERAL UNRESTR,"Transaction ID: 15D70934N0933822G
https://www.paypal.com/activity/payment/15D70934N0933822G",PayPal Bank 3,--,$63.06,"$899,797.56"
Donations directed by individuals,09/23/2023,Deposit,15D70934N0933822G,04 PAYPAL GENERAL UNRESTR,Money in to PayPal,Contributed income:Donations directed by individuals,PayPal Bank 3,$65.00,"$899,862.56"
PayPal Fees,09/23/2023,Deposit,15D70934N0933822G,04 PAYPAL GENERAL UNRESTR,PayPal fees,OFFICE/GENERAL ADMINISTRATIVE EXPENSES:PayPal Fees,PayPal Bank 3,$1.94,"$899,864.50"
PayPal Bank 3,09/23/2023,Deposit,5CA36807KN644971L,04 PAYPAL GENERAL UNRESTR,"Subject: Support Ukraine
Transaction ID: 5CA36807KN644971L
https://www.paypal.com/activity/payment/5CA36807KN644971L",PayPal Bank 3,--,$29.53,"$899,894.03"
Donations directed by individuals,09/23/2023,Deposit,5CA36807KN644971L,04 PAYPAL GENERAL UNRESTR,Money in to PayPal,Contributed income:Donations directed by individuals,PayPal Bank 3,$31.40,"$899,925.43"
PayPal Fees,09/23/2023,Deposit,5CA36807KN644971L,04 PAYPAL GENERAL UNRESTR,PayPal fees,OFFICE/GENERAL ADMINISTRATIVE EXPENSES:PayPal Fees,PayPal Bank 3,$1.87,"$899,927.30"
PayPal Bank 3,09/23/2023,Deposit,13V74422FY753873N,04 PAYPAL GENERAL UNRESTR,"Subject: GeneralPage
Transaction ID: 13V74422FY753873N
https://www.paypal.com/activity/payment/13V74422FY753873N",PayPal Bank 3,--,$10.00,"$899,937.30"
Donations directed by individuals,09/23/2023,Deposit,13V74422FY753873N,04 PAYPAL GENERAL UNRESTR,Support Ukraine - Support Ukraine,Contributed income:Donations directed by individuals,PayPal Bank 3,$10.80,"$899,948.10"
PayPal Fees,09/23/2023,Deposit,13V74422FY753873N,04 PAYPAL GENERAL UNRESTR,PayPal fees,OFFICE/GENERAL ADMINISTRATIVE EXPENSES:PayPal Fees,PayPal Bank 3,$0.80,"$899,948.90"
PayPal Bank 3,09/23/2023,Deposit,71L55419TW982943L,04 PAYPAL GENERAL UNRESTR,"Subject: GeneralPage
Transaction ID: 71L55419TW982943L
https://www.paypal.com/activity/payment/71L55419TW982943L",PayPal Bank 3,--,$96.00,"$900,044.90"
Donations directed by individuals,09/23/2023,Deposit,71L55419TW982943L,04 PAYPAL GENERAL UNRESTR,Support Ukraine - Support Ukraine,Contributed income:Donations directed by individuals,PayPal Bank 3,$99.36,"$900,144.26"
PayPal Fees,09/23/2023,Deposit,71L55419TW982943L,04 PAYPAL GENERAL UNRESTR,PayPal fees,OFFICE/GENERAL ADMINISTRATIVE EXPENSES:PayPal Fees,PayPal Bank 3,$3.36,"$900,147.62"
PayPal Bank 3,09/23/2023,Deposit,7A087318BH466411C,04 PAYPAL GENERAL UNRESTR,"Subject: Support Ukraine
Transaction ID: 7A087318BH466411C
https://www.paypal.com/activity/payment/7A087318BH466411C",PayPal Bank 3,--,$100.00,"$900,247.62"
Donations directed by individuals,09/23/2023,Deposit,7A087318BH466411C,04 PAYPAL GENERAL UNRESTR,Money in to PayPal,Contributed income:Donations directed by individuals,PayPal Bank 3,$103.48,"$900,351.10"
PayPal Fees,09/23/2023,Deposit,7A087318BH466411C,04 PAYPAL GENERAL UNRESTR,PayPal fees,OFFICE/GENERAL ADMINISTRATIVE EXPENSES:PayPal Fees,PayPal Bank 3,$3.48,"$900,354.58"
PayPal Bank 3,09/23/2023,Deposit,04G44155D73746205,04 PAYPAL GENERAL UNRESTR,"Subject: Support Ukraine
Transaction ID: 04G44155D73746205
https://www.paypal.com/activity/payment/04G44155D73746205",PayPal Bank 3,--,$47.31,"$900,401.89"
Donations directed by individuals,09/23/2023,Deposit,04G44155D73746205,04 PAYPAL GENERAL UNRESTR,Money in to PayPal,Contributed income:Donations directed by individuals,PayPal Bank 3,$50.00,"$900,451.89"
PayPal Fees,09/23/2023,Deposit,04G44155D73746205,04 PAYPAL GENERAL UNRESTR,PayPal fees,OFFICE/GENERAL ADMINISTRATIVE EXPENSES:PayPal Fees,PayPal Bank 3,$2.69,"$900,454.58"
PayPal Bank 3,09/23/2023,Deposit,4BE16008E6168690H,04 PAYPAL GENERAL UNRESTR,"Subject: Support Ukraine
Transaction ID: 4BE16008E6168690H
https://www.paypal.com/activity/payment/4BE16008E6168690H",PayPal Bank 3,--,$18.63,"$900,473.21"
Donations directed by individuals,09/23/2023,Deposit,4BE16008E6168690H,04 PAYPAL GENERAL UNRESTR,Money in to PayPal,Contributed income:Donations directed by individuals,PayPal Bank 3,$20.00,"$900,493.21"
PayPal Fees,09/23/2023,Deposit,4BE16008E6168690H,04 PAYPAL GENERAL UNRESTR,PayPal fees,OFFICE/GENERAL ADMINISTRATIVE EXPENSES:PayPal Fees,PayPal Bank 3,$1.37,"$900,494.58"
PayPal Bank 3,09/23/2023,Deposit,02D910410J470822A,04 PAYPAL GENERAL UNRESTR,"Subject: Support Ukraine
Transaction ID: 02D910410J470822A
https://www.paypal.com/activity/payment/02D910410J470822A",PayPal Bank 3,--,$4.91,"$900,499.49"
Donations directed by individuals,09/23/2023,Deposit,02D910410J470822A,04 PAYPAL GENERAL UNRESTR,Money in to PayPal,Contributed income:Donations directed by individuals,PayPal Bank 3,$5.65,"$900,505.14"
PayPal Fees,09/23/2023,Deposit,02D910410J470822A,04 PAYPAL GENERAL UNRESTR,PayPal fees,OFFICE/GENERAL ADMINISTRATIVE EXPENSES:PayPal Fees,PayPal Bank 3,$0.74,"$900,505.88"
PayPal Bank 3,09/23/2023,Deposit,2Y456890DA875781C,04 PAYPAL GENERAL UNRESTR,"Subject: Support Ukraine
Transaction ID: 2Y456890DA875781C
https://www.paypal.com/activity/payment/2Y456890DA875781C",PayPal Bank 3,--,$23.41,"$900,529.29"
Donations directed by individuals,09/23/2023,Deposit,2Y456890DA875781C,04 PAYPAL GENERAL UNRESTR,Money in to PayPal,Contributed income:Donations directed by individuals,PayPal Bank 3,$25.00,"$900,554.29"
PayPal Fees,09/23/2023,Deposit,2Y456890DA875781C,04 PAYPAL GENERAL UNRESTR,PayPal fees,OFFICE/GENERAL ADMINISTRATIVE EXPENSES:PayPal Fees,PayPal Bank 3,$1.59,"$900,555.88"
PayPal Bank 3,09/23/2023,Deposit,1LM92038FY190573T,04 PAYPAL GENERAL UNRESTR,"Subject: GeneralPage
Transaction ID: 1LM92038FY190573T
https://www.paypal.com/activity/payment/1LM92038FY190573T",PayPal Bank 3,--,$98.45,"$900,654.33"
Donations directed by individuals,09/23/2023,Deposit,1LM92038FY190573T,04 PAYPAL GENERAL UNRESTR,Support Ukraine - Support Ukraine,Contributed income:Donations directed by individuals,PayPal Bank 3,$103.48,"$900,757.81"
PayPal Fees,09/23/2023,Deposit,1LM92038FY190573T,04 PAYPAL GENERAL UNRESTR,PayPal fees,OFFICE/GENERAL ADMINISTRATIVE EXPENSES:PayPal Fees,PayPal Bank 3,$5.03,"$900,762.84"
PayPal Bank 3,09/23/2023,Deposit,45M624386T715762R,04 PAYPAL GENERAL UNRESTR,"Subject: GeneralPage
Transaction ID: 45M624386T715762R
https://www.paypal.com/activity/payment/45M624386T715762R",PayPal Bank 3,--,$48.06,"$900,810.90"
Donations directed by individuals,09/23/2023,Deposit,45M624386T715762R,04 PAYPAL GENERAL UNRESTR,Support Ukraine - Support Ukraine,Contributed income:Donations directed by individuals,PayPal Bank 3,$50.00,"$900,860.90"
PayPal Fees,09/23/2023,Deposit,45M624386T715762R,04 PAYPAL GENERAL UNRESTR,PayPal fees,OFFICE/GENERAL ADMINISTRATIVE EXPENSES:PayPal Fees,PayPal Bank 3,$1.94,"$900,862.84"
PayPal Bank 3,09/23/2023,Deposit,99569497VD451211B,04 PAYPAL GENERAL UNRESTR,"Subject: GeneralPage
Note: Spende Ukraine
Transaction ID: 99569497VD451211B
https://www.paypal.com/activity/payment/99569497VD451211B",PayPal Bank 3,--,$344.59,"$901,207.43"
Donations directed by individuals,09/23/2023,Deposit,99569497VD451211B,04 PAYPAL GENERAL UNRESTR,Support Ukraine - Support Ukraine,Contributed income:Donations directed by individuals,PayPal Bank 3,$360.92,"$901,568.35"
PayPal Fees,09/23/2023,Deposit,99569497VD451211B,04 PAYPAL GENERAL UNRESTR,PayPal fees,OFFICE/GENERAL ADMINISTRATIVE EXPENSES:PayPal Fees,PayPal Bank 3,$16.33,"$901,584.68"
PayPal Bank 3,09/23/2023,Deposit,3T873985DH286712E,04 PAYPAL GENERAL UNRESTR,"Subject: Support Ukraine
Transaction ID: 3T873985DH286712E
https://www.paypal.com/activity/payment/3T873985DH286712E",PayPal Bank 3,--,$50.00,"$901,634.68"
Donations directed by individuals,09/23/2023,Deposit,3T873985DH286712E,04 PAYPAL GENERAL UNRESTR,Money in to PayPal,Contributed income:Donations directed by individuals,PayPal Bank 3,$51.99,"$901,686.67"
PayPal Fees,09/23/2023,Deposit,3T873985DH286712E,04 PAYPAL GENERAL UNRESTR,PayPal fees,OFFICE/GENERAL ADMINISTRATIVE EXPENSES:PayPal Fees,PayPal Bank 3,$1.99,"$901,688.66"
PayPal Bank 3,09/23/2023,Deposit,6SK89523M9875584P,04 PAYPAL GENERAL UNRESTR,"Subject: GeneralPage
Transaction ID: 6SK89523M9875584P
https://www.paypal.com/activity/payment/6SK89523M9875584P",PayPal Bank 3,--,$193.73,"$901,882.39"
Donations directed by individuals,09/23/2023,Deposit,6SK89523M9875584P,04 PAYPAL GENERAL UNRESTR,Support Ukraine - Support Ukraine,Contributed income:Donations directed by individuals,PayPal Bank 3,$200.00,"$902,082.39"
PayPal Fees,09/23/2023,Deposit,6SK89523M9875584P,04 PAYPAL GENERAL UNRESTR,PayPal fees,OFFICE/GENERAL ADMINISTRATIVE EXPENSES:PayPal Fees,PayPal Bank 3,$6.27,"$902,088.66"
PayPal Bank 3,09/23/2023,Deposit,9F973955SH182635L,04 PAYPAL GENERAL UNRESTR,"Subject: GeneralPage
Transaction ID: 9F973955SH182635L
https://www.paypal.com/activity/payment/9F973955SH182635L",PayPal Bank 3,--,$67.49,"$902,156.15"
Donations directed by individuals,09/23/2023,Deposit,9F973955SH182635L,04 PAYPAL GENERAL UNRESTR,Support Ukraine - Support Ukraine,Contributed income:Donations directed by individuals,PayPal Bank 3,$70.00,"$902,226.15"
PayPal Fees,09/23/2023,Deposit,9F973955SH182635L,04 PAYPAL GENERAL UNRESTR,PayPal fees,OFFICE/GENERAL ADMINISTRATIVE EXPENSES:PayPal Fees,PayPal Bank 3,$2.51,"$902,228.66"
PayPal Bank 3,09/23/2023,Deposit,19P82825UW920902X,08 VICTORY DRONES RESTR,"Subject: GeneralPage
Note: Donate for victory drones
Transaction ID: 19P82825UW920902X
https://www.paypal.com/activity/payment/19P82825UW920902X",PayPal Bank 3,--,$98.45,"$902,327.11"
Donations directed by individuals,09/23/2023,Deposit,19P82825UW920902X,08 VICTORY DRONES RESTR,Support Ukraine - Support Ukraine,Contributed income:Donations directed by individuals,PayPal Bank 3,$103.48,"$902,430.59"
PayPal Fees,09/23/2023,Deposit,19P82825UW920902X,08 VICTORY DRONES RESTR,PayPal fees,OFFICE/GENERAL ADMINISTRATIVE EXPENSES:PayPal Fees,PayPal Bank 3,$5.03,"$902,435.62"
PayPal Bank 3,09/23/2023,Deposit,1YD34091R7488540S,04 PAYPAL GENERAL UNRESTR,"Transaction ID: 1YD34091R7488540S
https://www.paypal.com/activity/payment/1YD34091R7488540S",PayPal Bank 3,--,$9.31,"$902,444.93"
Donations directed by individuals,09/23/2023,Deposit,1YD34091R7488540S,04 PAYPAL GENERAL UNRESTR,Money in to PayPal,Contributed income:Donations directed by individuals,PayPal Bank 3,$10.00,"$902,454.93"
PayPal Fees,09/23/2023,Deposit,1YD34091R7488540S,04 PAYPAL GENERAL UNRESTR,PayPal fees,OFFICE/GENERAL ADMINISTRATIVE EXPENSES:PayPal Fees,PayPal Bank 3,$0.69,"$902,455.62"
PayPal Bank 3,09/23/2023,Deposit,8WS73739X12345511,07 1000 DRONES RESTR,"Subject: 1000DRONES
Transaction ID: 8WS73739X12345511
https://www.paypal.com/activity/payment/8WS73739X12345511",PayPal Bank 3,--,$196.93,"$902,652.55"
Donations directed by individuals,09/23/2023,Deposit,8WS73739X12345511,07 1000 DRONES RESTR,1000 DRONES FOR UKRAINE - 1000 DRONES FOR UKRAINE,Contributed income:Donations directed by individuals,PayPal Bank 3,$204.56,"$902,857.11"
PayPal Fees,09/23/2023,Deposit,8WS73739X12345511,07 1000 DRONES RESTR,PayPal fees,OFFICE/GENERAL ADMINISTRATIVE EXPENSES:PayPal Fees,PayPal Bank 3,$7.63,"$902,864.74"
PayPal Bank 3,09/23/2023,Deposit,3UT78771CR865904G,07 1000 DRONES RESTR,"Subject: 1000DRONES
Transaction ID: 3UT78771CR865904G
https://www.paypal.com/activity/payment/3UT78771CR865904G",PayPal Bank 3,--,$40.00,"$902,904.74"
Donations directed by individuals,09/23/2023,Deposit,3UT78771CR865904G,07 1000 DRONES RESTR,1000 DRONES FOR UKRAINE - 1000 DRONES FOR UKRAINE,Contributed income:Donations directed by individuals,PayPal Bank 3,$41.31,"$902,946.05"
PayPal Fees,09/23/2023,Deposit,3UT78771CR865904G,07 1000 DRONES RESTR,PayPal fees,OFFICE/GENERAL ADMINISTRATIVE EXPENSES:PayPal Fees,PayPal Bank 3,$1.31,"$902,947.36"
PayPal Bank 3,09/23/2023,Deposit,3FE87981R98698824,04 PAYPAL GENERAL UNRESTR,"Subject: Support Ukraine
Transaction ID: 3FE87981R98698824
https://www.paypal.com/activity/payment/3FE87981R98698824",PayPal Bank 3,--,$47.76,"$902,995.12"
Donations directed by individuals,09/23/2023,Deposit,3FE87981R98698824,04 PAYPAL GENERAL UNRESTR,Money in to PayPal,Contributed income:Donations directed by individuals,PayPal Bank 3,$50.00,"$903,045.12"
PayPal Fees,09/23/2023,Deposit,3FE87981R98698824,04 PAYPAL GENERAL UNRESTR,PayPal fees,OFFICE/GENERAL ADMINISTRATIVE EXPENSES:PayPal Fees,PayPal Bank 3,$2.24,"$903,047.36"
PayPal Bank 3,09/23/2023,Deposit,8JE64607KS718594D,04 PAYPAL GENERAL UNRESTR,"Subject: Support Ukraine
Transaction ID: 8JE64607KS718594D
https://www.paypal.com/activity/payment/8JE64607KS718594D",PayPal Bank 3,--,$25.24,"$903,072.60"
Donations directed by individuals,09/23/2023,Deposit,8JE64607KS718594D,04 PAYPAL GENERAL UNRESTR,Money in to PayPal,Contributed income:Donations directed by individuals,PayPal Bank 3,$26.25,"$903,098.85"
PayPal Fees,09/23/2023,Deposit,8JE64607KS718594D,04 PAYPAL GENERAL UNRESTR,PayPal fees,OFFICE/GENERAL ADMINISTRATIVE EXPENSES:PayPal Fees,PayPal Bank 3,$1.01,"$903,099.86"
PayPal Bank 3,09/23/2023,Deposit,2PU14474GD5114805,04 PAYPAL GENERAL UNRESTR,"Subject: Support Ukraine
Transaction ID: 2PU14474GD5114805
https://www.paypal.com/activity/payment/2PU14474GD5114805",PayPal Bank 3,--,$50.47,"$903,150.33"
Donations directed by individuals,09/23/2023,Deposit,2PU14474GD5114805,04 PAYPAL GENERAL UNRESTR,Money in to PayPal,Contributed income:Donations directed by individuals,PayPal Bank 3,$51.99,"$903,202.32"
PayPal Fees,09/23/2023,Deposit,2PU14474GD5114805,04 PAYPAL GENERAL UNRESTR,PayPal fees,OFFICE/GENERAL ADMINISTRATIVE EXPENSES:PayPal Fees,PayPal Bank 3,$1.52,"$903,203.84"
PayPal Bank 3,09/23/2023,Deposit,6AE64066MN9093316,04 PAYPAL GENERAL UNRESTR,"Subject: GeneralPage
Transaction ID: 6AE64066MN9093316
https://www.paypal.com/activity/payment/6AE64066MN9093316",PayPal Bank 3,--,$400.00,"$903,603.84"
Donations directed by individuals,09/23/2023,Deposit,6AE64066MN9093316,04 PAYPAL GENERAL UNRESTR,Support Ukraine - Support Ukraine,Contributed income:Donations directed by individuals,PayPal Bank 3,$408.62,"$904,012.46"
PayPal Fees,09/23/2023,Deposit,6AE64066MN9093316,04 PAYPAL GENERAL UNRESTR,PayPal fees,OFFICE/GENERAL ADMINISTRATIVE EXPENSES:PayPal Fees,PayPal Bank 3,$8.62,"$904,021.08"
PayPal Bank 3,09/23/2023,Deposit,9PS81558AD5751825,07 1000 DRONES RESTR,"Subject: 1000DRONES
Transaction ID: 9PS81558AD5751825
https://www.paypal.com/activity/payment/9PS81558AD5751825",PayPal Bank 3,--,$192.53,"$904,213.61"
Donations directed by individuals,09/23/2023,Deposit,9PS81558AD5751825,07 1000 DRONES RESTR,1000 DRONES FOR UKRAINE - 1000 DRONES FOR UKRAINE,Contributed income:Donations directed by individuals,PayPal Bank 3,$200.00,"$904,413.61"
PayPal Fees,09/23/2023,Deposit,9PS81558AD5751825,07 1000 DRONES RESTR,PayPal fees,OFFICE/GENERAL ADMINISTRATIVE EXPENSES:PayPal Fees,PayPal Bank 3,$7.47,"$904,421.08"
PayPal Bank 3,09/23/2023,Deposit,2JA30787RC953050R,11 VETERANIUS RESTR,"Subject: Veteranius
Transaction ID: 2JA30787RC953050R
https://www.paypal.com/activity/payment/2JA30787RC953050R",PayPal Bank 3,--,$98.46,"$904,519.54"
Donations directed by individuals,09/23/2023,Deposit,2JA30787RC953050R,11 VETERANIUS RESTR,Veteranius - helping veterans to learn and gain experience in IT. - Veteranius - helping veterans to learn and gain experience in IT.,Contributed income:Donations directed by individuals,PayPal Bank 3,$102.53,"$904,622.07"
PayPal Fees,09/23/2023,Deposit,2JA30787RC953050R,11 VETERANIUS RESTR,PayPal fees,OFFICE/GENERAL ADMINISTRATIVE EXPENSES:PayPal Fees,PayPal Bank 3,$4.07,"$904,626.14"
PayPal Bank 3,09/23/2023,Deposit,6XJ28338AM1360502,04 PAYPAL GENERAL UNRESTR,"Subject: GeneralPage
Transaction ID: 6XJ28338AM1360502
https://www.paypal.com/activity/payment/6XJ28338AM1360502",PayPal Bank 3,--,"$1,959.71","$906,585.85"
Donations directed by individuals,09/23/2023,Deposit,6XJ28338AM1360502,04 PAYPAL GENERAL UNRESTR,Support Ukraine - Support Ukraine,Contributed income:Donations directed by individuals,PayPal Bank 3,"$2,000.00","$908,585.85"
PayPal Fees,09/23/2023,Deposit,6XJ28338AM1360502,04 PAYPAL GENERAL UNRESTR,PayPal fees,OFFICE/GENERAL ADMINISTRATIVE EXPENSES:PayPal Fees,PayPal Bank 3,$40.29,"$908,626.14"
PayPal Bank 3,09/23/2023,Deposit,6B946761K9904120E,04 PAYPAL GENERAL UNRESTR,"Subject: GeneralPage
Transaction ID: 6B946761K9904120E
https://www.paypal.com/activity/payment/6B946761K9904120E",PayPal Bank 3,--,$48.51,"$908,674.65"
Donations directed by individuals,09/23/2023,Deposit,6B946761K9904120E,04 PAYPAL GENERAL UNRESTR,Support Ukraine - Support Ukraine,Contributed income:Donations directed by individuals,PayPal Bank 3,$50.00,"$908,724.65"
PayPal Fees,09/23/2023,Deposit,6B946761K9904120E,04 PAYPAL GENERAL UNRESTR,PayPal fees,OFFICE/GENERAL ADMINISTRATIVE EXPENSES:PayPal Fees,PayPal Bank 3,$1.49,"$908,726.14"
PayPal Bank 3,09/23/2023,Deposit,2EP49106DA773372R,07 1000 DRONES RESTR,"Subject: 1000DRONES
Transaction ID: 2EP49106DA773372R
https://www.paypal.com/activity/payment/2EP49106DA773372R",PayPal Bank 3,--,$100.00,"$908,826.14"
Donations directed by individuals,09/23/2023,Deposit,2EP49106DA773372R,07 1000 DRONES RESTR,1000 DRONES FOR UKRAINE - 1000 DRONES FOR UKRAINE,Contributed income:Donations directed by individuals,PayPal Bank 3,$102.53,"$908,928.67"
PayPal Fees,09/23/2023,Deposit,2EP49106DA773372R,07 1000 DRONES RESTR,PayPal fees,OFFICE/GENERAL ADMINISTRATIVE EXPENSES:PayPal Fees,PayPal Bank 3,$2.53,"$908,931.20"
PayPal Bank 3,09/23/2023,Deposit,5WW65991N4317911W,04 PAYPAL GENERAL UNRESTR,"Subject: GeneralPage
Transaction ID: 5WW65991N4317911W
https://www.paypal.com/activity/payment/5WW65991N4317911W",PayPal Bank 3,--,$98.46,"$909,029.66"
Donations directed by individuals,09/23/2023,Deposit,5WW65991N4317911W,04 PAYPAL GENERAL UNRESTR,Support Ukraine - Support Ukraine,Contributed income:Donations directed by individuals,PayPal Bank 3,$102.53,"$909,132.19"
PayPal Fees,09/23/2023,Deposit,5WW65991N4317911W,04 PAYPAL GENERAL UNRESTR,PayPal fees,OFFICE/GENERAL ADMINISTRATIVE EXPENSES:PayPal Fees,PayPal Bank 3,$4.07,"$909,136.26"
PayPal Bank 3,09/23/2023,Deposit,84466089EX976871M,04 PAYPAL GENERAL UNRESTR,"Subject: Support Ukraine
Transaction ID: 84466089EX976871M
https://www.paypal.com/activity/payment/84466089EX976871M",PayPal Bank 3,--,$99.38,"$909,235.64"
Donations directed by individuals,09/23/2023,Deposit,84466089EX976871M,04 PAYPAL GENERAL UNRESTR,Money in to PayPal,Contributed income:Donations directed by individuals,PayPal Bank 3,$103.48,"$909,339.12"
PayPal Fees,09/23/2023,Deposit,84466089EX976871M,04 PAYPAL GENERAL UNRESTR,PayPal fees,OFFICE/GENERAL ADMINISTRATIVE EXPENSES:PayPal Fees,PayPal Bank 3,$4.10,"$909,343.22"
PayPal Bank 3,09/23/2023,Deposit,5PA16879TR066460J,04 PAYPAL GENERAL UNRESTR,"Subject: Support Ukraine
Transaction ID: 5PA16879TR066460J
https://www.paypal.com/activity/payment/5PA16879TR066460J",PayPal Bank 3,--,$20.95,"$909,364.17"
Donations directed by individuals,09/23/2023,Deposit,5PA16879TR066460J,04 PAYPAL GENERAL UNRESTR,Money in to PayPal,Contributed income:Donations directed by individuals,PayPal Bank 3,$22.22,"$909,386.39"
PayPal Fees,09/23/2023,Deposit,5PA16879TR066460J,04 PAYPAL GENERAL UNRESTR,PayPal fees,OFFICE/GENERAL ADMINISTRATIVE EXPENSES:PayPal Fees,PayPal Bank 3,$1.27,"$909,387.66"
PayPal Bank 3,09/23/2023,Deposit,26R09799C76104222,07 1000 DRONES RESTR,"Subject: 1000DRONES
Transaction ID: 26R09799C76104222
https://www.paypal.com/activity/payment/26R09799C76104222",PayPal Bank 3,--,$100.00,"$909,487.66"
Donations directed by individuals,09/23/2023,Deposit,26R09799C76104222,07 1000 DRONES RESTR,1000 DRONES FOR UKRAINE - 1000 DRONES FOR UKRAINE,Contributed income:Donations directed by individuals,PayPal Bank 3,$102.53,"$909,590.19"
PayPal Fees,09/23/2023,Deposit,26R09799C76104222,07 1000 DRONES RESTR,PayPal fees,OFFICE/GENERAL ADMINISTRATIVE EXPENSES:PayPal Fees,PayPal Bank 3,$2.53,"$909,592.72"
PayPal Bank 3,09/23/2023,Deposit,83N187201S549120G,04 PAYPAL GENERAL UNRESTR,"Subject: GeneralPage
Transaction ID: 83N187201S549120G
https://www.paypal.com/activity/payment/83N187201S549120G",PayPal Bank 3,--,$979.61,"$910,572.33"
Donations directed by individuals,09/23/2023,Deposit,83N187201S549120G,04 PAYPAL GENERAL UNRESTR,Support Ukraine - Support Ukraine,Contributed income:Donations directed by individuals,PayPal Bank 3,"$1,000.00","$911,572.33"
PayPal Fees,09/23/2023,Deposit,83N187201S549120G,04 PAYPAL GENERAL UNRESTR,PayPal fees,OFFICE/GENERAL ADMINISTRATIVE EXPENSES:PayPal Fees,PayPal Bank 3,$20.39,"$911,592.72"
PayPal Bank 3,09/23/2023,Deposit,33765861FR6787714,08 VICTORY DRONES RESTR,"Subject: VICTORY DRONES
Transaction ID: 33765861FR6787714
https://www.paypal.com/activity/payment/33765861FR6787714",PayPal Bank 3,--,$2.97,"$911,595.69"
Donations directed by individuals,09/23/2023,Deposit,33765861FR6787714,08 VICTORY DRONES RESTR,Money in to PayPal,Contributed income:Donations directed by individuals,PayPal Bank 3,$3.59,"$911,599.28"
PayPal Fees,09/23/2023,Deposit,33765861FR6787714,08 VICTORY DRONES RESTR,PayPal fees,OFFICE/GENERAL ADMINISTRATIVE EXPENSES:PayPal Fees,PayPal Bank 3,$0.62,"$911,599.90"
PayPal Bank 3,09/23/2023,Deposit,1P552229DP111282U,04 PAYPAL GENERAL UNRESTR,"Subject: Support Ukraine
Transaction ID: 1P552229DP111282U
https://www.paypal.com/activity/payment/1P552229DP111282U",PayPal Bank 3,--,$14.90,"$911,614.80"
Donations directed by individuals,09/23/2023,Deposit,1P552229DP111282U,04 PAYPAL GENERAL UNRESTR,Money in to PayPal,Contributed income:Donations directed by individuals,PayPal Bank 3,$15.95,"$911,630.75"
PayPal Fees,09/23/2023,Deposit,1P552229DP111282U,04 PAYPAL GENERAL UNRESTR,PayPal fees,OFFICE/GENERAL ADMINISTRATIVE EXPENSES:PayPal Fees,PayPal Bank 3,$1.05,"$911,631.80"
PayPal Bank 3,09/23/2023,Deposit,0TA752610A418533K,04 PAYPAL GENERAL UNRESTR,"Subject: GeneralPage
Transaction ID: 0TA752610A418533K
https://www.paypal.com/activity/payment/0TA752610A418533K",PayPal Bank 3,--,$10.00,"$911,641.80"
Donations directed by individuals,09/23/2023,Deposit,0TA752610A418533K,04 PAYPAL GENERAL UNRESTR,Support Ukraine - Support Ukraine,Contributed income:Donations directed by individuals,PayPal Bank 3,$10.70,"$911,652.50"
PayPal Fees,09/23/2023,Deposit,0TA752610A418533K,04 PAYPAL GENERAL UNRESTR,PayPal fees,OFFICE/GENERAL ADMINISTRATIVE EXPENSES:PayPal Fees,PayPal Bank 3,$0.70,"$911,653.20"
PayPal Bank 3,09/23/2023,Deposit,4GU45865KY334124U,04 PAYPAL GENERAL UNRESTR,"Subject: GeneralPage
Transaction ID: 4GU45865KY334124U
https://www.paypal.com/activity/payment/4GU45865KY334124U",PayPal Bank 3,--,$19.11,"$911,672.31"
Donations directed by individuals,09/23/2023,Deposit,4GU45865KY334124U,04 PAYPAL GENERAL UNRESTR,Support Ukraine - Support Ukraine,Contributed income:Donations directed by individuals,PayPal Bank 3,$20.00,"$911,692.31"
PayPal Fees,09/23/2023,Deposit,4GU45865KY334124U,04 PAYPAL GENERAL UNRESTR,PayPal fees,OFFICE/GENERAL ADMINISTRATIVE EXPENSES:PayPal Fees,PayPal Bank 3,$0.89,"$911,693.20"
PayPal Bank 3,09/23/2023,Deposit,3K659993JD342510P,07 1000 DRONES RESTR,"Subject: 1000DRONES
Transaction ID: 3K659993JD342510P
https://www.paypal.com/activity/payment/3K659993JD342510P",PayPal Bank 3,--,$40.00,"$911,733.20"
Donations directed by individuals,09/23/2023,Deposit,3K659993JD342510P,07 1000 DRONES RESTR,1000 DRONES FOR UKRAINE - 1000 DRONES FOR UKRAINE,Contributed income:Donations directed by individuals,PayPal Bank 3,$41.31,"$911,774.51"
PayPal Fees,09/23/2023,Deposit,3K659993JD342510P,07 1000 DRONES RESTR,PayPal fees,OFFICE/GENERAL ADMINISTRATIVE EXPENSES:PayPal Fees,PayPal Bank 3,$1.31,"$911,775.82"
PayPal Bank 3,09/23/2023,Deposit,0WV599940U585104C,04 PAYPAL GENERAL UNRESTR,"Subject: GeneralPage
Transaction ID: 0WV599940U585104C
https://www.paypal.com/activity/payment/0WV599940U585104C",PayPal Bank 3,--,$25.00,"$911,800.82"
Donations directed by individuals,09/23/2023,Deposit,0WV599940U585104C,04 PAYPAL GENERAL UNRESTR,Support Ukraine - Support Ukraine,Contributed income:Donations directed by individuals,PayPal Bank 3,$26.01,"$911,826.83"
PayPal Fees,09/23/2023,Deposit,0WV599940U585104C,04 PAYPAL GENERAL UNRESTR,PayPal fees,OFFICE/GENERAL ADMINISTRATIVE EXPENSES:PayPal Fees,PayPal Bank 3,$1.01,"$911,827.84"
PayPal Bank 3,09/23/2023,Deposit,5FR896372R403225V,07 1000 DRONES RESTR,"Subject: 1000DRONES
Note: Keep up the efforts!
Transaction ID: 5FR896372R403225V
https://www.paypal.com/activity/payment/5FR896372R403225V",PayPal Bank 3,--,$50.00,"$911,877.84"
Donations directed by individuals,09/23/2023,Deposit,5FR896372R403225V,07 1000 DRONES RESTR,1000 DRONES FOR UKRAINE - 1000 DRONES FOR UKRAINE,Contributed income:Donations directed by individuals,PayPal Bank 3,$51.52,"$911,929.36"
PayPal Fees,09/23/2023,Deposit,5FR896372R403225V,07 1000 DRONES RESTR,PayPal fees,OFFICE/GENERAL ADMINISTRATIVE EXPENSES:PayPal Fees,PayPal Bank 3,$1.52,"$911,930.88"
PayPal Bank 3,09/23/2023,Deposit,2RN51759TG6027126,04 PAYPAL GENERAL UNRESTR,"Subject: GeneralPage
Transaction ID: 2RN51759TG6027126
https://www.paypal.com/activity/payment/2RN51759TG6027126",PayPal Bank 3,--,$98.46,"$912,029.34"
Donations directed by individuals,09/23/2023,Deposit,2RN51759TG6027126,04 PAYPAL GENERAL UNRESTR,Support Ukraine - Support Ukraine,Contributed income:Donations directed by individuals,PayPal Bank 3,$102.53,"$912,131.87"
PayPal Fees,09/23/2023,Deposit,2RN51759TG6027126,04 PAYPAL GENERAL UNRESTR,PayPal fees,OFFICE/GENERAL ADMINISTRATIVE EXPENSES:PayPal Fees,PayPal Bank 3,$4.07,"$912,135.94"
PayPal Bank 3,09/23/2023,Deposit,5T330197UG820070X,07 1000 DRONES RESTR,"Subject: 1000 DRONES FOR UKRAINE
Transaction ID: 5T330197UG820070X
https://www.paypal.com/activity/payment/5T330197UG820070X",PayPal Bank 3,--,$18.81,"$912,154.75"
Donations directed by individuals,09/23/2023,Deposit,5T330197UG820070X,07 1000 DRONES RESTR,Money in to PayPal,Contributed income:Donations directed by individuals,PayPal Bank 3,$20.00,"$912,174.75"
PayPal Fees,09/23/2023,Deposit,5T330197UG820070X,07 1000 DRONES RESTR,PayPal fees,OFFICE/GENERAL ADMINISTRATIVE EXPENSES:PayPal Fees,PayPal Bank 3,$1.19,"$912,175.94"
PayPal Bank 3,09/23/2023,Deposit,18J77972CF9364227,04 PAYPAL GENERAL UNRESTR,"Subject: Support Ukraine
Transaction ID: 18J77972CF9364227
https://www.paypal.com/activity/payment/18J77972CF9364227",PayPal Bank 3,--,$9.93,"$912,185.87"
Donations directed by individuals,09/23/2023,Deposit,18J77972CF9364227,04 PAYPAL GENERAL UNRESTR,Money in to PayPal,Contributed income:Donations directed by individuals,PayPal Bank 3,$10.80,"$912,196.67"
PayPal Fees,09/23/2023,Deposit,18J77972CF9364227,04 PAYPAL GENERAL UNRESTR,PayPal fees,OFFICE/GENERAL ADMINISTRATIVE EXPENSES:PayPal Fees,PayPal Bank 3,$0.87,"$912,197.54"
PayPal Bank 3,09/23/2023,Deposit,8YV9810276530830C,04 PAYPAL GENERAL UNRESTR,"Subject: Support Ukraine
Transaction ID: 8YV9810276530830C
https://www.paypal.com/activity/payment/8YV9810276530830C",PayPal Bank 3,--,$47.70,"$912,245.24"
Donations directed by individuals,09/23/2023,Deposit,8YV9810276530830C,04 PAYPAL GENERAL UNRESTR,Money in to PayPal,Contributed income:Donations directed by individuals,PayPal Bank 3,$49.93,"$912,295.17"
PayPal Fees,09/23/2023,Deposit,8YV9810276530830C,04 PAYPAL GENERAL UNRESTR,PayPal fees,OFFICE/GENERAL ADMINISTRATIVE EXPENSES:PayPal Fees,PayPal Bank 3,$2.23,"$912,297.40"
PayPal Bank 3,09/23/2023,Deposit,07678604JN8369642,04 PAYPAL GENERAL UNRESTR,"Subject: Support Ukraine
Transaction ID: 07678604JN8369642
https://www.paypal.com/activity/payment/07678604JN8369642",PayPal Bank 3,--,$19.87,"$912,317.27"
Donations directed by individuals,09/23/2023,Deposit,07678604JN8369642,04 PAYPAL GENERAL UNRESTR,Money in to PayPal,Contributed income:Donations directed by individuals,PayPal Bank 3,$21.10,"$912,338.37"
PayPal Fees,09/23/2023,Deposit,07678604JN8369642,04 PAYPAL GENERAL UNRESTR,PayPal fees,OFFICE/GENERAL ADMINISTRATIVE EXPENSES:PayPal Fees,PayPal Bank 3,$1.23,"$912,339.60"
PayPal Bank 3,09/23/2023,Deposit,37H36594RR807390K,04 PAYPAL GENERAL UNRESTR,"Subject: GeneralPage
Transaction ID: 37H36594RR807390K
https://www.paypal.com/activity/payment/37H36594RR807390K",PayPal Bank 3,--,$20.00,"$912,359.60"
Donations directed by individuals,09/23/2023,Deposit,37H36594RR807390K,04 PAYPAL GENERAL UNRESTR,Support Ukraine - Support Ukraine,Contributed income:Donations directed by individuals,PayPal Bank 3,$20.91,"$912,380.51"
PayPal Fees,09/23/2023,Deposit,37H36594RR807390K,04 PAYPAL GENERAL UNRESTR,PayPal fees,OFFICE/GENERAL ADMINISTRATIVE EXPENSES:PayPal Fees,PayPal Bank 3,$0.91,"$912,381.42"
PayPal Bank 3,09/23/2023,Deposit,5V9207285B996490E,04 PAYPAL GENERAL UNRESTR,"Subject: GeneralPage
Transaction ID: 5V9207285B996490E
https://www.paypal.com/activity/payment/5V9207285B996490E",PayPal Bank 3,--,$240.78,"$912,622.20"
Donations directed by individuals,09/23/2023,Deposit,5V9207285B996490E,04 PAYPAL GENERAL UNRESTR,Support Ukraine - Support Ukraine,Contributed income:Donations directed by individuals,PayPal Bank 3,$250.00,"$912,872.20"
PayPal Fees,09/23/2023,Deposit,5V9207285B996490E,04 PAYPAL GENERAL UNRESTR,PayPal fees,OFFICE/GENERAL ADMINISTRATIVE EXPENSES:PayPal Fees,PayPal Bank 3,$9.22,"$912,881.42"
PayPal Bank 3,09/23/2023,Deposit,61917329PC2791013,04 PAYPAL GENERAL UNRESTR,"Subject: GeneralPage
Transaction ID: 61917329PC2791013
https://www.paypal.com/activity/payment/61917329PC2791013",PayPal Bank 3,--,$33.29,"$912,914.71"
Donations directed by individuals,09/23/2023,Deposit,61917329PC2791013,04 PAYPAL GENERAL UNRESTR,Support Ukraine - Support Ukraine,Contributed income:Donations directed by individuals,PayPal Bank 3,$35.00,"$912,949.71"
PayPal Fees,09/23/2023,Deposit,61917329PC2791013,04 PAYPAL GENERAL UNRESTR,PayPal fees,OFFICE/GENERAL ADMINISTRATIVE EXPENSES:PayPal Fees,PayPal Bank 3,$1.71,"$912,951.42"
PayPal Bank 3,09/23/2023,Deposit,3S014363KB405321J,04 PAYPAL GENERAL UNRESTR,"Subject: Support Ukraine
Transaction ID: 3S014363KB405321J
https://www.paypal.com/activity/payment/3S014363KB405321J",PayPal Bank 3,--,$9.16,"$912,960.58"
Donations directed by individuals,09/23/2023,Deposit,3S014363KB405321J,04 PAYPAL GENERAL UNRESTR,Money in to PayPal,Contributed income:Donations directed by individuals,PayPal Bank 3,$10.00,"$912,970.58"
PayPal Fees,09/23/2023,Deposit,3S014363KB405321J,04 PAYPAL GENERAL UNRESTR,PayPal fees,OFFICE/GENERAL ADMINISTRATIVE EXPENSES:PayPal Fees,PayPal Bank 3,$0.84,"$912,971.42"
PayPal Bank 3,09/23/2023,Deposit,12V23331W25909314,04 PAYPAL GENERAL UNRESTR,"Subject: Support Ukraine
Transaction ID: 12V23331W25909314
https://www.paypal.com/activity/payment/12V23331W25909314",PayPal Bank 3,--,$9.16,"$912,980.58"
Donations directed by individuals,09/23/2023,Deposit,12V23331W25909314,04 PAYPAL GENERAL UNRESTR,Money in to PayPal,Contributed income:Donations directed by individuals,PayPal Bank 3,$10.00,"$912,990.58"
PayPal Fees,09/23/2023,Deposit,12V23331W25909314,04 PAYPAL GENERAL UNRESTR,PayPal fees,OFFICE/GENERAL ADMINISTRATIVE EXPENSES:PayPal Fees,PayPal Bank 3,$0.84,"$912,991.42"
PayPal Bank 3,09/23/2023,Deposit,7HG12062YJ689072J,04 PAYPAL GENERAL UNRESTR,"Subject: Support Ukraine
Transaction ID: 7HG12062YJ689072J
https://www.paypal.com/activity/payment/7HG12062YJ689072J",PayPal Bank 3,--,$70.08,"$913,061.50"
Donations directed by individuals,09/23/2023,Deposit,7HG12062YJ689072J,04 PAYPAL GENERAL UNRESTR,Money in to PayPal,Contributed income:Donations directed by individuals,PayPal Bank 3,$72.00,"$913,133.50"
PayPal Fees,09/23/2023,Deposit,7HG12062YJ689072J,04 PAYPAL GENERAL UNRESTR,PayPal fees,OFFICE/GENERAL ADMINISTRATIVE EXPENSES:PayPal Fees,PayPal Bank 3,$1.92,"$913,135.42"
PayPal Bank 3,09/23/2023,Deposit,7NX273243G961310U,07 1000 DRONES RESTR,"Subject: 1000DRONES
Transaction ID: 7NX273243G961310U
https://www.paypal.com/activity/payment/7NX273243G961310U",PayPal Bank 3,--,$50.00,"$913,185.42"
Donations directed by individuals,09/23/2023,Deposit,7NX273243G961310U,07 1000 DRONES RESTR,1000 DRONES FOR UKRAINE - 1000 DRONES FOR UKRAINE,Contributed income:Donations directed by individuals,PayPal Bank 3,$51.52,"$913,236.94"
PayPal Fees,09/23/2023,Deposit,7NX273243G961310U,07 1000 DRONES RESTR,PayPal fees,OFFICE/GENERAL ADMINISTRATIVE EXPENSES:PayPal Fees,PayPal Bank 3,$1.52,"$913,238.46"
PayPal Bank 3,09/23/2023,Deposit,1WH08163T02032328,04 PAYPAL GENERAL UNRESTR,"Subject: GeneralPage
Transaction ID: 1WH08163T02032328
https://www.paypal.com/activity/payment/1WH08163T02032328",PayPal Bank 3,--,$98.46,"$913,336.92"
Donations directed by individuals,09/23/2023,Deposit,1WH08163T02032328,04 PAYPAL GENERAL UNRESTR,Support Ukraine - Support Ukraine,Contributed income:Donations directed by individuals,PayPal Bank 3,$102.53,"$913,439.45"
PayPal Fees,09/23/2023,Deposit,1WH08163T02032328,04 PAYPAL GENERAL UNRESTR,PayPal fees,OFFICE/GENERAL ADMINISTRATIVE EXPENSES:PayPal Fees,PayPal Bank 3,$4.07,"$913,443.52"
PayPal Bank 3,09/23/2023,Deposit,4J582708UY6395935,04 PAYPAL GENERAL UNRESTR,"Subject: GeneralPage
Transaction ID: 4J582708UY6395935
https://www.paypal.com/activity/payment/4J582708UY6395935",PayPal Bank 3,--,$14.76,"$913,458.28"
Donations directed by individuals,09/23/2023,Deposit,4J582708UY6395935,04 PAYPAL GENERAL UNRESTR,Support Ukraine - Support Ukraine,Contributed income:Donations directed by individuals,PayPal Bank 3,$15.80,"$913,474.08"
PayPal Fees,09/23/2023,Deposit,4J582708UY6395935,04 PAYPAL GENERAL UNRESTR,PayPal fees,OFFICE/GENERAL ADMINISTRATIVE EXPENSES:PayPal Fees,PayPal Bank 3,$1.04,"$913,475.12"
PayPal Bank 3,09/23/2023,Deposit,1H9309582T195293W,04 PAYPAL GENERAL UNRESTR,"Subject: GeneralPage
Transaction ID: 1H9309582T195293W
https://www.paypal.com/activity/payment/1H9309582T195293W",PayPal Bank 3,--,$13.99,"$913,489.11"
Donations directed by individuals,09/23/2023,Deposit,1H9309582T195293W,04 PAYPAL GENERAL UNRESTR,Support Ukraine - Support Ukraine,Contributed income:Donations directed by individuals,PayPal Bank 3,$15.00,"$913,504.11"
PayPal Fees,09/23/2023,Deposit,1H9309582T195293W,04 PAYPAL GENERAL UNRESTR,PayPal fees,OFFICE/GENERAL ADMINISTRATIVE EXPENSES:PayPal Fees,PayPal Bank 3,$1.01,"$913,505.12"
PayPal Bank 3,09/23/2023,Deposit,2VA91517Y7736632M,04 PAYPAL GENERAL UNRESTR,"Subject: GeneralPage
Transaction ID: 2VA91517Y7736632M
https://www.paypal.com/activity/payment/2VA91517Y7736632M",PayPal Bank 3,--,$19.69,"$913,524.81"
Donations directed by individuals,09/23/2023,Deposit,2VA91517Y7736632M,04 PAYPAL GENERAL UNRESTR,Support Ukraine - Support Ukraine,Contributed income:Donations directed by individuals,PayPal Bank 3,$20.91,"$913,545.72"
PayPal Fees,09/23/2023,Deposit,2VA91517Y7736632M,04 PAYPAL GENERAL UNRESTR,PayPal fees,OFFICE/GENERAL ADMINISTRATIVE EXPENSES:PayPal Fees,PayPal Bank 3,$1.22,"$913,546.94"
PayPal Bank 3,09/23/2023,Deposit,79868079J1552083V,07 1000 DRONES RESTR,"Subject: 1000DRONES
Transaction ID: 79868079J1552083V
https://www.paypal.com/activity/payment/79868079J1552083V",PayPal Bank 3,--,$13.99,"$913,560.93"
Donations directed by individuals,09/23/2023,Deposit,79868079J1552083V,07 1000 DRONES RESTR,1000 DRONES FOR UKRAINE - 1000 DRONES FOR UKRAINE,Contributed income:Donations directed by individuals,PayPal Bank 3,$15.00,"$913,575.93"
PayPal Fees,09/23/2023,Deposit,79868079J1552083V,07 1000 DRONES RESTR,PayPal fees,OFFICE/GENERAL ADMINISTRATIVE EXPENSES:PayPal Fees,PayPal Bank 3,$1.01,"$913,576.94"
PayPal Bank 3,09/23/2023,Deposit,7KN82143DM7337318,08 VICTORY DRONES RESTR,"Subject: VictoryDrones
Note: Mon cœur saigne pour l'Ukraine et ses enfants
Transaction ID: 7KN82143DM7337318
https://www.paypal.com/activity/payment/7KN82143DM7337318",PayPal Bank 3,--,$49.23,"$913,626.17"
Donations directed by individuals,09/23/2023,Deposit,7KN82143DM7337318,08 VICTORY DRONES RESTR,VICTORY DRONES - VICTORY DRONES,Contributed income:Donations directed by individuals,PayPal Bank 3,$51.52,"$913,677.69"
PayPal Fees,09/23/2023,Deposit,7KN82143DM7337318,08 VICTORY DRONES RESTR,PayPal fees,OFFICE/GENERAL ADMINISTRATIVE EXPENSES:PayPal Fees,PayPal Bank 3,$2.29,"$913,679.98"
PayPal Bank 3,09/23/2023,Deposit,46859611XW0374221,08 VICTORY DRONES RESTR,"Subject: GeneralPage
Note: For Victory drones
Transaction ID: 46859611XW0374221
https://www.paypal.com/activity/payment/46859611XW0374221",PayPal Bank 3,--,$98.46,"$913,778.44"
Donations directed by individuals,09/23/2023,Deposit,46859611XW0374221,08 VICTORY DRONES RESTR,Support Ukraine - Support Ukraine,Contributed income:Donations directed by individuals,PayPal Bank 3,$102.53,"$913,880.97"
PayPal Fees,09/23/2023,Deposit,46859611XW0374221,08 VICTORY DRONES RESTR,PayPal fees,OFFICE/GENERAL ADMINISTRATIVE EXPENSES:PayPal Fees,PayPal Bank 3,$4.07,"$913,885.04"
PayPal Bank 3,09/23/2023,Deposit,58N9109608977802L,04 PAYPAL GENERAL UNRESTR,"Subject: Support Ukraine
Transaction ID: 58N9109608977802L
https://www.paypal.com/activity/payment/58N9109608977802L",PayPal Bank 3,--,$23.63,"$913,908.67"
Donations directed by individuals,09/23/2023,Deposit,58N9109608977802L,04 PAYPAL GENERAL UNRESTR,Money in to PayPal,Contributed income:Donations directed by individuals,PayPal Bank 3,$24.99,"$913,933.66"
PayPal Fees,09/23/2023,Deposit,58N9109608977802L,04 PAYPAL GENERAL UNRESTR,PayPal fees,OFFICE/GENERAL ADMINISTRATIVE EXPENSES:PayPal Fees,PayPal Bank 3,$1.36,"$913,935.02"
PayPal Bank 3,09/23/2023,Deposit,1E7087339M483122S,04 PAYPAL GENERAL UNRESTR,"Subject: Support Ukraine
Transaction ID: 1E7087339M483122S
https://www.paypal.com/activity/payment/1E7087339M483122S",PayPal Bank 3,--,$50.47,"$913,985.49"
Donations directed by individuals,09/23/2023,Deposit,1E7087339M483122S,04 PAYPAL GENERAL UNRESTR,Money in to PayPal,Contributed income:Donations directed by individuals,PayPal Bank 3,$51.99,"$914,037.48"
PayPal Fees,09/23/2023,Deposit,1E7087339M483122S,04 PAYPAL GENERAL UNRESTR,PayPal fees,OFFICE/GENERAL ADMINISTRATIVE EXPENSES:PayPal Fees,PayPal Bank 3,$1.52,"$914,039.00"
PayPal Bank 3,09/23/2023,Deposit,3PM027124H5809403,04 PAYPAL GENERAL UNRESTR,"Subject: Support Ukraine
Transaction ID: 3PM027124H5809403
https://www.paypal.com/activity/payment/3PM027124H5809403",PayPal Bank 3,--,$24.84,"$914,063.84"
Donations directed by individuals,09/23/2023,Deposit,3PM027124H5809403,04 PAYPAL GENERAL UNRESTR,Money in to PayPal,Contributed income:Donations directed by individuals,PayPal Bank 3,$26.25,"$914,090.09"
PayPal Fees,09/23/2023,Deposit,3PM027124H5809403,04 PAYPAL GENERAL UNRESTR,PayPal fees,OFFICE/GENERAL ADMINISTRATIVE EXPENSES:PayPal Fees,PayPal Bank 3,$1.41,"$914,091.50"
PayPal Bank 3,09/23/2023,Deposit,1J663185AF925474U,04 PAYPAL GENERAL UNRESTR,"Subject: GeneralPage
Transaction ID: 1J663185AF925474U
https://www.paypal.com/activity/payment/1J663185AF925474U",PayPal Bank 3,--,$50.00,"$914,141.50"
Donations directed by individuals,09/23/2023,Deposit,1J663185AF925474U,04 PAYPAL GENERAL UNRESTR,Support Ukraine - Support Ukraine,Contributed income:Donations directed by individuals,PayPal Bank 3,$51.52,"$914,193.02"
PayPal Fees,09/23/2023,Deposit,1J663185AF925474U,04 PAYPAL GENERAL UNRESTR,PayPal fees,OFFICE/GENERAL ADMINISTRATIVE EXPENSES:PayPal Fees,PayPal Bank 3,$1.52,"$914,194.54"
PayPal Bank 3,09/23/2023,Deposit,6LA55917HM237133U,08 VICTORY DRONES RESTR,"Subject: VictoryDrones
Transaction ID: 6LA55917HM237133U
https://www.paypal.com/activity/payment/6LA55917HM237133U",PayPal Bank 3,--,$19.69,"$914,214.23"
Donations directed by individuals,09/23/2023,Deposit,6LA55917HM237133U,08 VICTORY DRONES RESTR,VICTORY DRONES - VICTORY DRONES,Contributed income:Donations directed by individuals,PayPal Bank 3,$20.91,"$914,235.14"
PayPal Fees,09/23/2023,Deposit,6LA55917HM237133U,08 VICTORY DRONES RESTR,PayPal fees,OFFICE/GENERAL ADMINISTRATIVE EXPENSES:PayPal Fees,PayPal Bank 3,$1.22,"$914,236.36"
PayPal Bank 3,09/23/2023,Deposit,8X691922F2159121A,04 PAYPAL GENERAL UNRESTR,"Subject: GeneralPage
Transaction ID: 8X691922F2159121A
https://www.paypal.com/activity/payment/8X691922F2159121A",PayPal Bank 3,--,$28.46,"$914,264.82"
Donations directed by individuals,09/23/2023,Deposit,8X691922F2159121A,04 PAYPAL GENERAL UNRESTR,Support Ukraine - Support Ukraine,Contributed income:Donations directed by individuals,PayPal Bank 3,$30.00,"$914,294.82"
PayPal Fees,09/23/2023,Deposit,8X691922F2159121A,04 PAYPAL GENERAL UNRESTR,PayPal fees,OFFICE/GENERAL ADMINISTRATIVE EXPENSES:PayPal Fees,PayPal Bank 3,$1.54,"$914,296.36"
PayPal Bank 3,09/23/2023,Deposit,0L6491910N057512B,07 1000 DRONES RESTR,"Subject: 1000DRONES
Transaction ID: 0L6491910N057512B
https://www.paypal.com/activity/payment/0L6491910N057512B",PayPal Bank 3,--,$350.00,"$914,646.36"
Donations directed by individuals,09/23/2023,Deposit,0L6491910N057512B,07 1000 DRONES RESTR,1000 DRONES FOR UKRAINE - 1000 DRONES FOR UKRAINE,Contributed income:Donations directed by individuals,PayPal Bank 3,$357.61,"$915,003.97"
PayPal Fees,09/23/2023,Deposit,0L6491910N057512B,07 1000 DRONES RESTR,PayPal fees,OFFICE/GENERAL ADMINISTRATIVE EXPENSES:PayPal Fees,PayPal Bank 3,$7.61,"$915,011.58"
PayPal Bank 3,09/23/2023,Deposit,5M582547J8243941X,04 PAYPAL GENERAL UNRESTR,"Subject: Support Ukraine
Transaction ID: 5M582547J8243941X
https://www.paypal.com/activity/payment/5M582547J8243941X",PayPal Bank 3,--,$298.14,"$915,309.72"
Donations directed by individuals,09/23/2023,Deposit,5M582547J8243941X,04 PAYPAL GENERAL UNRESTR,Money in to PayPal,Contributed income:Donations directed by individuals,PayPal Bank 3,$309.43,"$915,619.15"
PayPal Fees,09/23/2023,Deposit,5M582547J8243941X,04 PAYPAL GENERAL UNRESTR,PayPal fees,OFFICE/GENERAL ADMINISTRATIVE EXPENSES:PayPal Fees,PayPal Bank 3,$11.29,"$915,630.44"
PayPal Bank 3,09/23/2023,Deposit,90C54420CK002871N,08 VICTORY DRONES RESTR,"Subject: VICTORY DRONES
Transaction ID: 90C54420CK002871N
https://www.paypal.com/activity/payment/90C54420CK002871N",PayPal Bank 3,--,$2.97,"$915,633.41"
Donations directed by individuals,09/23/2023,Deposit,90C54420CK002871N,08 VICTORY DRONES RESTR,Money in to PayPal,Contributed income:Donations directed by individuals,PayPal Bank 3,$3.59,"$915,637.00"
PayPal Fees,09/23/2023,Deposit,90C54420CK002871N,08 VICTORY DRONES RESTR,PayPal fees,OFFICE/GENERAL ADMINISTRATIVE EXPENSES:PayPal Fees,PayPal Bank 3,$0.62,"$915,637.62"
PayPal Bank 3,09/23/2023,Deposit,11620412WD586600A,07 1000 DRONES RESTR,"Subject: 1000DRONES
Transaction ID: 11620412WD586600A
https://www.paypal.com/activity/payment/11620412WD586600A",PayPal Bank 3,--,$76.72,"$915,714.34"
Donations directed by individuals,09/23/2023,Deposit,11620412WD586600A,07 1000 DRONES RESTR,1000 DRONES FOR UKRAINE - 1000 DRONES FOR UKRAINE,Contributed income:Donations directed by individuals,PayPal Bank 3,$80.00,"$915,794.34"
PayPal Fees,09/23/2023,Deposit,11620412WD586600A,07 1000 DRONES RESTR,PayPal fees,OFFICE/GENERAL ADMINISTRATIVE EXPENSES:PayPal Fees,PayPal Bank 3,$3.28,"$915,797.62"
PayPal Bank 3,09/23/2023,Deposit,1CG25991JH2526544,07 1000 DRONES RESTR,"Subject: 1000DRONES
Transaction ID: 1CG25991JH2526544
https://www.paypal.com/activity/payment/1CG25991JH2526544",PayPal Bank 3,--,$33.29,"$915,830.91"
Donations directed by individuals,09/23/2023,Deposit,1CG25991JH2526544,07 1000 DRONES RESTR,1000 DRONES FOR UKRAINE - 1000 DRONES FOR UKRAINE,Contributed income:Donations directed by individuals,PayPal Bank 3,$35.00,"$915,865.91"
PayPal Fees,09/23/2023,Deposit,1CG25991JH2526544,07 1000 DRONES RESTR,PayPal fees,OFFICE/GENERAL ADMINISTRATIVE EXPENSES:PayPal Fees,PayPal Bank 3,$1.71,"$915,867.62"
PayPal Bank 3,09/23/2023,Deposit,4K044405KJ9262848,04 PAYPAL GENERAL UNRESTR,"Subject: GeneralPage
Transaction ID: 4K044405KJ9262848
https://www.paypal.com/activity/payment/4K044405KJ9262848",PayPal Bank 3,--,$196.93,"$916,064.55"
Donations directed by individuals,09/23/2023,Deposit,4K044405KJ9262848,04 PAYPAL GENERAL UNRESTR,Support Ukraine - Support Ukraine,Contributed income:Donations directed by individuals,PayPal Bank 3,$204.56,"$916,269.11"
PayPal Fees,09/23/2023,Deposit,4K044405KJ9262848,04 PAYPAL GENERAL UNRESTR,PayPal fees,OFFICE/GENERAL ADMINISTRATIVE EXPENSES:PayPal Fees,PayPal Bank 3,$7.63,"$916,276.74"
PayPal Bank 3,09/22/2023,Deposit,0HV42330874359326,04 PAYPAL GENERAL UNRESTR,"Transaction ID: 0HV42330874359326
https://www.paypal.com/activity/payment/0HV42330874359326",PayPal Bank 3,Donations directed by individuals,$1.00,"$916,277.74"
Donations directed by individuals,09/22/2023,Deposit,0HV42330874359326,04 PAYPAL GENERAL UNRESTR,Money in to PayPal,Contributed income:Donations directed by individuals,PayPal Bank 3,$1.00,"$916,278.74"
PayPal Bank 3,09/22/2023,Deposit,0AA89879UC6834253,04 PAYPAL GENERAL UNRESTR,"Transaction ID: 0AA89879UC6834253
https://www.paypal.com/activity/payment/0AA89879UC6834253",PayPal Bank 3,--,$0.97,"$916,279.71"
Donations directed by individuals,09/22/2023,Deposit,0AA89879UC6834253,04 PAYPAL GENERAL UNRESTR,Money in to PayPal,Contributed income:Donations directed by individuals,PayPal Bank 3,$1.00,"$916,280.71"
PayPal Fees,09/22/2023,Deposit,0AA89879UC6834253,04 PAYPAL GENERAL UNRESTR,PayPal fees,OFFICE/GENERAL ADMINISTRATIVE EXPENSES:PayPal Fees,PayPal Bank 3,$0.03,"$916,280.74"
PayPal Bank 3,09/22/2023,Deposit,4P401955JK890434L,04 PAYPAL GENERAL UNRESTR,"Note: Charitable donation
Transaction ID: 4P401955JK890434L
https://www.paypal.com/activity/payment/4P401955JK890434L",PayPal Bank 3,--,$1.46,"$916,282.20"
Donations directed by individuals,09/22/2023,Deposit,4P401955JK890434L,04 PAYPAL GENERAL UNRESTR,Money in to PayPal,Contributed income:Donations directed by individuals,PayPal Bank 3,$1.50,"$916,283.70"
PayPal Fees,09/22/2023,Deposit,4P401955JK890434L,04 PAYPAL GENERAL UNRESTR,PayPal fees,OFFICE/GENERAL ADMINISTRATIVE EXPENSES:PayPal Fees,PayPal Bank 3,$0.04,"$916,283.74"
PayPal Bank 3,09/22/2023,Deposit,8WJ42244VJ270542F,04 PAYPAL GENERAL UNRESTR,"Transaction ID: 8WJ42244VJ270542F
https://www.paypal.com/activity/payment/8WJ42244VJ270542F",PayPal Bank 3,--,$0.72,"$916,284.46"
Donations directed by individuals,09/22/2023,Deposit,8WJ42244VJ270542F,04 PAYPAL GENERAL UNRESTR,Support Ukraine - Support Ukraine,Contributed income:Donations directed by individuals,PayPal Bank 3,$1.25,"$916,285.71"
PayPal Fees,09/22/2023,Deposit,8WJ42244VJ270542F,04 PAYPAL GENERAL UNRESTR,PayPal fees,OFFICE/GENERAL ADMINISTRATIVE EXPENSES:PayPal Fees,PayPal Bank 3,$0.53,"$916,286.24"
PayPal Bank 3,09/22/2023,Deposit,6RJ52649XP8481323,07 1000 DRONES RESTR,"Subject: 1000DRONES
Transaction ID: 6RJ52649XP8481323
https://www.paypal.com/activity/payment/6RJ52649XP8481323",PayPal Bank 3,--,$4.37,"$916,290.61"
Donations directed by individuals,09/22/2023,Deposit,6RJ52649XP8481323,07 1000 DRONES RESTR,1000 DRONES FOR UKRAINE - 1000 DRONES FOR UKRAINE,Contributed income:Donations directed by individuals,PayPal Bank 3,$5.00,"$916,295.61"
PayPal Fees,09/22/2023,Deposit,6RJ52649XP8481323,07 1000 DRONES RESTR,PayPal fees,OFFICE/GENERAL ADMINISTRATIVE EXPENSES:PayPal Fees,PayPal Bank 3,$0.63,"$916,296.24"
PayPal Bank 3,09/22/2023,Deposit,2EF777993G965104E,07 1000 DRONES RESTR,"Transaction ID: 2EF777993G965104E
https://www.paypal.com/activity/payment/2EF777993G965104E",PayPal Bank 3,--,$1.45,"$916,297.69"
Donations directed by individuals,09/22/2023,Deposit,2EF777993G965104E,07 1000 DRONES RESTR,1000 DRONES FOR UKRAINE - 1000 DRONES FOR UKRAINE,Contributed income:Donations directed by individuals,PayPal Bank 3,$2.00,"$916,299.69"
PayPal Fees,09/22/2023,Deposit,2EF777993G965104E,07 1000 DRONES RESTR,PayPal fees,OFFICE/GENERAL ADMINISTRATIVE EXPENSES:PayPal Fees,PayPal Bank 3,$0.55,"$916,300.24"
PayPal Bank 3,09/22/2023,Deposit,2RF49709GG496905S,07 1000 DRONES RESTR,"Subject: custom
Transaction ID: 2RF49709GG496905S
https://www.paypal.com/activity/payment/2RF49709GG496905S",PayPal Bank 3,--,$2.42,"$916,302.66"
Donations directed by individuals,09/22/2023,Deposit,2RF49709GG496905S,07 1000 DRONES RESTR,1000 DRONES FOR UKRAINE - 1000 DRONES FOR UKRAINE,Contributed income:Donations directed by individuals,PayPal Bank 3,$3.00,"$916,305.66"
PayPal Fees,09/22/2023,Deposit,2RF49709GG496905S,07 1000 DRONES RESTR,PayPal fees,OFFICE/GENERAL ADMINISTRATIVE EXPENSES:PayPal Fees,PayPal Bank 3,$0.58,"$916,306.24"
PayPal Bank 3,09/22/2023,Deposit,4FF159007F788522X,04 PAYPAL GENERAL UNRESTR,"Note: test2
Transaction ID: 4FF159007F788522X
https://www.paypal.com/activity/payment/4FF159007F788522X",PayPal Bank 3,--,$3.39,"$916,309.63"
Donations directed by individuals,09/22/2023,Deposit,4FF159007F788522X,04 PAYPAL GENERAL UNRESTR,Support Ukraine - Support Ukraine,Contributed income:Donations directed by individuals,PayPal Bank 3,$4.00,"$916,313.63"
PayPal Fees,09/22/2023,Deposit,4FF159007F788522X,04 PAYPAL GENERAL UNRESTR,PayPal fees,OFFICE/GENERAL ADMINISTRATIVE EXPENSES:PayPal Fees,PayPal Bank 3,$0.61,"$916,314.24"
PayPal Bank 3,09/22/2023,Deposit,66F19293T9603492H,04 PAYPAL GENERAL UNRESTR,"Subject: GeneralPage
Transaction ID: 66F19293T9603492H
https://www.paypal.com/activity/payment/66F19293T9603492H",PayPal Bank 3,--,$1.94,"$916,316.18"
Donations directed by individuals,09/22/2023,Deposit,66F19293T9603492H,04 PAYPAL GENERAL UNRESTR,Support Ukraine - Support Ukraine,Contributed income:Donations directed by individuals,PayPal Bank 3,$2.50,"$916,318.68"
PayPal Fees,09/22/2023,Deposit,66F19293T9603492H,04 PAYPAL GENERAL UNRESTR,PayPal fees,OFFICE/GENERAL ADMINISTRATIVE EXPENSES:PayPal Fees,PayPal Bank 3,$0.56,"$916,319.24"
PayPal Bank 3,09/22/2023,Deposit,9FH91472TG424470X,09 MSU RESTR,"Subject: MobileShowers
Transaction ID: 9FH91472TG424470X
https://www.paypal.com/activity/payment/9FH91472TG424470X",PayPal Bank 3,--,$2.91,"$916,322.15"
Donations directed by individuals,09/22/2023,Deposit,9FH91472TG424470X,09 MSU RESTR,Mobile Shower Unit - Mobile Shower Unit,Contributed income:Donations directed by individuals,PayPal Bank 3,$3.50,"$916,325.65"
PayPal Fees,09/22/2023,Deposit,9FH91472TG424470X,09 MSU RESTR,PayPal fees,OFFICE/GENERAL ADMINISTRATIVE EXPENSES:PayPal Fees,PayPal Bank 3,$0.59,"$916,326.24"
PayPal Bank 3,09/22/2023,Deposit,0JM97106YK418792H,04 PAYPAL GENERAL UNRESTR,"Subject: GeneralPage
Transaction ID: 0JM97106YK418792H
https://www.paypal.com/activity/payment/0JM97106YK418792H",PayPal Bank 3,--,$47.31,"$916,373.55"
Donations directed by individuals,09/22/2023,Deposit,0JM97106YK418792H,04 PAYPAL GENERAL UNRESTR,Support Ukraine - Support Ukraine,Contributed income:Donations directed by individuals,PayPal Bank 3,$50.00,"$916,423.55"
PayPal Fees,09/22/2023,Deposit,0JM97106YK418792H,04 PAYPAL GENERAL UNRESTR,PayPal fees,OFFICE/GENERAL ADMINISTRATIVE EXPENSES:PayPal Fees,PayPal Bank 3,$2.69,"$916,426.24"
PayPal Bank 3,09/22/2023,Deposit,44U07303Y8553993T,04 PAYPAL GENERAL UNRESTR,"Subject: GeneralPage
Transaction ID: 44U07303Y8553993T
https://www.paypal.com/activity/payment/44U07303Y8553993T",PayPal Bank 3,--,$50.00,"$916,476.24"
Donations directed by individuals,09/22/2023,Deposit,44U07303Y8553993T,04 PAYPAL GENERAL UNRESTR,Support Ukraine - Support Ukraine,Contributed income:Donations directed by individuals,PayPal Bank 3,$51.99,"$916,528.23"
PayPal Fees,09/22/2023,Deposit,44U07303Y8553993T,04 PAYPAL GENERAL UNRESTR,PayPal fees,OFFICE/GENERAL ADMINISTRATIVE EXPENSES:PayPal Fees,PayPal Bank 3,$1.99,"$916,530.22"
PayPal Bank 3,09/22/2023,Deposit,7NS60564MJ2446452,04 PAYPAL GENERAL UNRESTR,"Subject: GeneralPage
Transaction ID: 7NS60564MJ2446452
https://www.paypal.com/activity/payment/7NS60564MJ2446452",PayPal Bank 3,--,$19.68,"$916,549.90"
Donations directed by individuals,09/22/2023,Deposit,7NS60564MJ2446452,04 PAYPAL GENERAL UNRESTR,Support Ukraine - Support Ukraine,Contributed income:Donations directed by individuals,PayPal Bank 3,$21.10,"$916,571.00"
PayPal Fees,09/22/2023,Deposit,7NS60564MJ2446452,04 PAYPAL GENERAL UNRESTR,PayPal fees,OFFICE/GENERAL ADMINISTRATIVE EXPENSES:PayPal Fees,PayPal Bank 3,$1.42,"$916,572.42"
PayPal Bank 3,09/22/2023,Deposit,7SY36505W01215518,04 PAYPAL GENERAL UNRESTR,"Subject: GeneralPage
Note: Люті Пташки
Transaction ID: 7SY36505W01215518
https://www.paypal.com/activity/payment/7SY36505W01215518",PayPal Bank 3,--,$4.91,"$916,577.33"
Donations directed by individuals,09/22/2023,Deposit,7SY36505W01215518,04 PAYPAL GENERAL UNRESTR,Support Ukraine - Support Ukraine,Contributed income:Donations directed by individuals,PayPal Bank 3,$5.65,"$916,582.98"
PayPal Fees,09/22/2023,Deposit,7SY36505W01215518,04 PAYPAL GENERAL UNRESTR,PayPal fees,OFFICE/GENERAL ADMINISTRATIVE EXPENSES:PayPal Fees,PayPal Bank 3,$0.74,"$916,583.72"
PayPal Bank 3,09/22/2023,Deposit,84T83713CJ921330V,04 PAYPAL GENERAL UNRESTR,"Subject: GeneralPage
Note: Пташки.
Transaction ID: 84T83713CJ921330V
https://www.paypal.com/activity/payment/84T83713CJ921330V",PayPal Bank 3,--,$19.10,"$916,602.82"
Donations directed by individuals,09/22/2023,Deposit,84T83713CJ921330V,04 PAYPAL GENERAL UNRESTR,Support Ukraine - Support Ukraine,Contributed income:Donations directed by individuals,PayPal Bank 3,$20.17,"$916,622.99"
PayPal Fees,09/22/2023,Deposit,84T83713CJ921330V,04 PAYPAL GENERAL UNRESTR,PayPal fees,OFFICE/GENERAL ADMINISTRATIVE EXPENSES:PayPal Fees,PayPal Bank 3,$1.07,"$916,624.06"
PayPal Bank 3,09/22/2023,Deposit,7KR60090A6224784J,04 PAYPAL GENERAL UNRESTR,"Subject: GeneralPage
Transaction ID: 7KR60090A6224784J
https://www.paypal.com/activity/payment/7KR60090A6224784J",PayPal Bank 3,--,$18.63,"$916,642.69"
Donations directed by individuals,09/22/2023,Deposit,7KR60090A6224784J,04 PAYPAL GENERAL UNRESTR,Support Ukraine - Support Ukraine,Contributed income:Donations directed by individuals,PayPal Bank 3,$20.00,"$916,662.69"
PayPal Fees,09/22/2023,Deposit,7KR60090A6224784J,04 PAYPAL GENERAL UNRESTR,PayPal fees,OFFICE/GENERAL ADMINISTRATIVE EXPENSES:PayPal Fees,PayPal Bank 3,$1.37,"$916,664.06"
PayPal Bank 3,09/22/2023,Deposit,14E94277XH613253K,04 PAYPAL GENERAL UNRESTR,"Subject: GeneralPage
Transaction ID: 14E94277XH613253K
https://www.paypal.com/activity/payment/14E94277XH613253K",PayPal Bank 3,--,$19.68,"$916,683.74"
Donations directed by individuals,09/22/2023,Deposit,14E94277XH613253K,04 PAYPAL GENERAL UNRESTR,Support Ukraine - Support Ukraine,Contributed income:Donations directed by individuals,PayPal Bank 3,$21.10,"$916,704.84"
PayPal Fees,09/22/2023,Deposit,14E94277XH613253K,04 PAYPAL GENERAL UNRESTR,PayPal fees,OFFICE/GENERAL ADMINISTRATIVE EXPENSES:PayPal Fees,PayPal Bank 3,$1.42,"$916,706.26"
PayPal Bank 3,09/22/2023,Deposit,8H861756N83160718,04 PAYPAL GENERAL UNRESTR,"Subject: GeneralPage
Transaction ID: 8H861756N83160718
https://www.paypal.com/activity/payment/8H861756N83160718",PayPal Bank 3,--,$48.06,"$916,754.32"
Donations directed by individuals,09/22/2023,Deposit,8H861756N83160718,04 PAYPAL GENERAL UNRESTR,Support Ukraine - Support Ukraine,Contributed income:Donations directed by individuals,PayPal Bank 3,$50.00,"$916,804.32"
PayPal Fees,09/22/2023,Deposit,8H861756N83160718,04 PAYPAL GENERAL UNRESTR,PayPal fees,OFFICE/GENERAL ADMINISTRATIVE EXPENSES:PayPal Fees,PayPal Bank 3,$1.94,"$916,806.26"
PayPal Bank 3,09/22/2023,Deposit,53K30129G6093241W,04 PAYPAL GENERAL UNRESTR,"Subject: GeneralPage
Transaction ID: 53K30129G6093241W
https://www.paypal.com/activity/payment/53K30129G6093241W",PayPal Bank 3,--,$35.00,"$916,841.26"
Donations directed by individuals,09/22/2023,Deposit,53K30129G6093241W,04 PAYPAL GENERAL UNRESTR,Support Ukraine - Support Ukraine,Contributed income:Donations directed by individuals,PayPal Bank 3,$36.55,"$916,877.81"
PayPal Fees,09/22/2023,Deposit,53K30129G6093241W,04 PAYPAL GENERAL UNRESTR,PayPal fees,OFFICE/GENERAL ADMINISTRATIVE EXPENSES:PayPal Fees,PayPal Bank 3,$1.55,"$916,879.36"
PayPal Bank 3,09/22/2023,Deposit,50560152XS4838256,04 PAYPAL GENERAL UNRESTR,"Subject: Support Ukraine
Transaction ID: 50560152XS4838256
https://www.paypal.com/activity/payment/50560152XS4838256",PayPal Bank 3,--,$20.75,"$916,900.11"
Donations directed by individuals,09/22/2023,Deposit,50560152XS4838256,04 PAYPAL GENERAL UNRESTR,Money in to PayPal,Contributed income:Donations directed by individuals,PayPal Bank 3,$22.22,"$916,922.33"
PayPal Fees,09/22/2023,Deposit,50560152XS4838256,04 PAYPAL GENERAL UNRESTR,PayPal fees,OFFICE/GENERAL ADMINISTRATIVE EXPENSES:PayPal Fees,PayPal Bank 3,$1.47,"$916,923.80"
PayPal Bank 3,09/22/2023,Deposit,0L767735Y6221111F,04 PAYPAL GENERAL UNRESTR,"Subject: GeneralPage
Transaction ID: 0L767735Y6221111F
https://www.paypal.com/activity/payment/0L767735Y6221111F",PayPal Bank 3,--,$196.91,"$917,120.71"
Donations directed by individuals,09/22/2023,Deposit,0L767735Y6221111F,04 PAYPAL GENERAL UNRESTR,Support Ukraine - Support Ukraine,Contributed income:Donations directed by individuals,PayPal Bank 3,$206.46,"$917,327.17"
PayPal Fees,09/22/2023,Deposit,0L767735Y6221111F,04 PAYPAL GENERAL UNRESTR,PayPal fees,OFFICE/GENERAL ADMINISTRATIVE EXPENSES:PayPal Fees,PayPal Bank 3,$9.55,"$917,336.72"
PayPal Bank 3,09/22/2023,Deposit,8R219962PY374993X,04 PAYPAL GENERAL UNRESTR,"Subject: GeneralPage
Transaction ID: 8R219962PY374993X
https://www.paypal.com/activity/payment/8R219962PY374993X",PayPal Bank 3,--,$9.07,"$917,345.79"
Donations directed by individuals,09/22/2023,Deposit,8R219962PY374993X,04 PAYPAL GENERAL UNRESTR,Support Ukraine - Support Ukraine,Contributed income:Donations directed by individuals,PayPal Bank 3,$10.00,"$917,355.79"
PayPal Fees,09/22/2023,Deposit,8R219962PY374993X,04 PAYPAL GENERAL UNRESTR,PayPal fees,OFFICE/GENERAL ADMINISTRATIVE EXPENSES:PayPal Fees,PayPal Bank 3,$0.93,"$917,356.72"
PayPal Bank 3,09/22/2023,Deposit,1NC05142YH997404V,04 PAYPAL GENERAL UNRESTR,"Subject: GeneralPage
Transaction ID: 1NC05142YH997404V
https://www.paypal.com/activity/payment/1NC05142YH997404V",PayPal Bank 3,--,$9.38,"$917,366.10"
Donations directed by individuals,09/22/2023,Deposit,1NC05142YH997404V,04 PAYPAL GENERAL UNRESTR,Support Ukraine - Support Ukraine,Contributed income:Donations directed by individuals,PayPal Bank 3,$10.16,"$917,376.26"
PayPal Fees,09/22/2023,Deposit,1NC05142YH997404V,04 PAYPAL GENERAL UNRESTR,PayPal fees,OFFICE/GENERAL ADMINISTRATIVE EXPENSES:PayPal Fees,PayPal Bank 3,$0.78,"$917,377.04"
PayPal Bank 3,09/22/2023,Deposit,9R8007695J744380Y,07 1000 DRONES RESTR,"Subject: 1000DRONES
Transaction ID: 9R8007695J744380Y
https://www.paypal.com/activity/payment/9R8007695J744380Y",PayPal Bank 3,--,$200.00,"$917,577.04"
Donations directed by individuals,09/22/2023,Deposit,9R8007695J744380Y,07 1000 DRONES RESTR,1000 DRONES FOR UKRAINE - 1000 DRONES FOR UKRAINE,Contributed income:Donations directed by individuals,PayPal Bank 3,$206.46,"$917,783.50"
PayPal Fees,09/22/2023,Deposit,9R8007695J744380Y,07 1000 DRONES RESTR,PayPal fees,OFFICE/GENERAL ADMINISTRATIVE EXPENSES:PayPal Fees,PayPal Bank 3,$6.46,"$917,789.96"
PayPal Bank 3,09/22/2023,Deposit,512558065H042980K,04 PAYPAL GENERAL UNRESTR,"Subject: GeneralPage
Transaction ID: 512558065H042980K
https://www.paypal.com/activity/payment/512558065H042980K",PayPal Bank 3,--,$295.36,"$918,085.32"
Donations directed by individuals,09/22/2023,Deposit,512558065H042980K,04 PAYPAL GENERAL UNRESTR,Support Ukraine - Support Ukraine,Contributed income:Donations directed by individuals,PayPal Bank 3,$309.43,"$918,394.75"
PayPal Fees,09/22/2023,Deposit,512558065H042980K,04 PAYPAL GENERAL UNRESTR,PayPal fees,OFFICE/GENERAL ADMINISTRATIVE EXPENSES:PayPal Fees,PayPal Bank 3,$14.07,"$918,408.82"
PayPal Bank 3,09/22/2023,Deposit,9GM05354NJ928712F,07 1000 DRONES RESTR,"Subject: 1000DRONES
Transaction ID: 9GM05354NJ928712F
https://www.paypal.com/activity/payment/9GM05354NJ928712F",PayPal Bank 3,--,$150.00,"$918,558.82"
Donations directed by individuals,09/22/2023,Deposit,9GM05354NJ928712F,07 1000 DRONES RESTR,1000 DRONES FOR UKRAINE - 1000 DRONES FOR UKRAINE,Contributed income:Donations directed by individuals,PayPal Bank 3,$154.97,"$918,713.79"
PayPal Fees,09/22/2023,Deposit,9GM05354NJ928712F,07 1000 DRONES RESTR,PayPal fees,OFFICE/GENERAL ADMINISTRATIVE EXPENSES:PayPal Fees,PayPal Bank 3,$4.97,"$918,718.76"
PayPal Bank 3,09/22/2023,Deposit,98F33477MJ3619639,07 1000 DRONES RESTR,"Subject: 1000DRONES
Note: Летіть соколи!!! Знищіть усю наволоч з Неньки!!
Transaction ID: 98F33477MJ3619639
https://www.paypal.com/activity/payment/98F33477MJ3619639",PayPal Bank 3,--,$100.00,"$918,818.76"
Donations directed by individuals,09/22/2023,Deposit,98F33477MJ3619639,07 1000 DRONES RESTR,1000 DRONES FOR UKRAINE - 1000 DRONES FOR UKRAINE,Contributed income:Donations directed by individuals,PayPal Bank 3,$103.48,"$918,922.24"
PayPal Fees,09/22/2023,Deposit,98F33477MJ3619639,07 1000 DRONES RESTR,PayPal fees,OFFICE/GENERAL ADMINISTRATIVE EXPENSES:PayPal Fees,PayPal Bank 3,$3.48,"$918,925.72"
PayPal Bank 3,09/22/2023,Deposit,8LW55511PT859325M,04 PAYPAL GENERAL UNRESTR,"Subject: GeneralPage
Transaction ID: 8LW55511PT859325M
https://www.paypal.com/activity/payment/8LW55511PT859325M",PayPal Bank 3,--,$48.06,"$918,973.78"
Donations directed by individuals,09/22/2023,Deposit,8LW55511PT859325M,04 PAYPAL GENERAL UNRESTR,Support Ukraine - Support Ukraine,Contributed income:Donations directed by individuals,PayPal Bank 3,$50.00,"$919,023.78"
PayPal Fees,09/22/2023,Deposit,8LW55511PT859325M,04 PAYPAL GENERAL UNRESTR,PayPal fees,OFFICE/GENERAL ADMINISTRATIVE EXPENSES:PayPal Fees,PayPal Bank 3,$1.94,"$919,025.72"
PayPal Bank 3,09/22/2023,Deposit,3TW85559AF991533K,04 PAYPAL GENERAL UNRESTR,"Subject: GeneralPage
Transaction ID: 3TW85559AF991533K
https://www.paypal.com/activity/payment/3TW85559AF991533K",PayPal Bank 3,--,$9.07,"$919,034.79"
Donations directed by individuals,09/22/2023,Deposit,3TW85559AF991533K,04 PAYPAL GENERAL UNRESTR,Support Ukraine - Support Ukraine,Contributed income:Donations directed by individuals,PayPal Bank 3,$10.00,"$919,044.79"
PayPal Fees,09/22/2023,Deposit,3TW85559AF991533K,04 PAYPAL GENERAL UNRESTR,PayPal fees,OFFICE/GENERAL ADMINISTRATIVE EXPENSES:PayPal Fees,PayPal Bank 3,$0.93,"$919,045.72"
PayPal Bank 3,09/22/2023,Deposit,5XH604208A562253K,04 PAYPAL GENERAL UNRESTR,"Subject: GeneralPage
Transaction ID: 5XH604208A562253K
https://www.paypal.com/activity/payment/5XH604208A562253K",PayPal Bank 3,--,$24.61,"$919,070.33"
Donations directed by individuals,09/22/2023,Deposit,5XH604208A562253K,04 PAYPAL GENERAL UNRESTR,Support Ukraine - Support Ukraine,Contributed income:Donations directed by individuals,PayPal Bank 3,$26.25,"$919,096.58"
PayPal Fees,09/22/2023,Deposit,5XH604208A562253K,04 PAYPAL GENERAL UNRESTR,PayPal fees,OFFICE/GENERAL ADMINISTRATIVE EXPENSES:PayPal Fees,PayPal Bank 3,$1.64,"$919,098.22"
PayPal Bank 3,09/22/2023,Deposit,3GU950742M022670B,04 PAYPAL GENERAL UNRESTR,"Subject: GeneralPage
Transaction ID: 3GU950742M022670B
https://www.paypal.com/activity/payment/3GU950742M022670B",PayPal Bank 3,--,$18.63,"$919,116.85"
Donations directed by individuals,09/22/2023,Deposit,3GU950742M022670B,04 PAYPAL GENERAL UNRESTR,Support Ukraine - Support Ukraine,Contributed income:Donations directed by individuals,PayPal Bank 3,$20.00,"$919,136.85"
PayPal Fees,09/22/2023,Deposit,3GU950742M022670B,04 PAYPAL GENERAL UNRESTR,PayPal fees,OFFICE/GENERAL ADMINISTRATIVE EXPENSES:PayPal Fees,PayPal Bank 3,$1.37,"$919,138.22"
PayPal Bank 3,09/22/2023,Deposit,72774626JX7855846,04 PAYPAL GENERAL UNRESTR,"Subject: GeneralPage
Transaction ID: 72774626JX7855846
https://www.paypal.com/activity/payment/72774626JX7855846",PayPal Bank 3,--,$19.68,"$919,157.90"
Donations directed by individuals,09/22/2023,Deposit,72774626JX7855846,04 PAYPAL GENERAL UNRESTR,Support Ukraine - Support Ukraine,Contributed income:Donations directed by individuals,PayPal Bank 3,$21.10,"$919,179.00"
PayPal Fees,09/22/2023,Deposit,72774626JX7855846,04 PAYPAL GENERAL UNRESTR,PayPal fees,OFFICE/GENERAL ADMINISTRATIVE EXPENSES:PayPal Fees,PayPal Bank 3,$1.42,"$919,180.42"
PayPal Bank 3,09/22/2023,Deposit,82783001AN018073E,04 PAYPAL GENERAL UNRESTR,"Subject: GeneralPage
Transaction ID: 82783001AN018073E
https://www.paypal.com/activity/payment/82783001AN018073E",PayPal Bank 3,--,$4.91,"$919,185.33"
Donations directed by individuals,09/22/2023,Deposit,82783001AN018073E,04 PAYPAL GENERAL UNRESTR,Support Ukraine - Support Ukraine,Contributed income:Donations directed by individuals,PayPal Bank 3,$5.65,"$919,190.98"
PayPal Fees,09/22/2023,Deposit,82783001AN018073E,04 PAYPAL GENERAL UNRESTR,PayPal fees,OFFICE/GENERAL ADMINISTRATIVE EXPENSES:PayPal Fees,PayPal Bank 3,$0.74,"$919,191.72"
PayPal Bank 3,09/22/2023,Deposit,2AR79510MK1154237,04 PAYPAL GENERAL UNRESTR,"Subject: GeneralPage
Transaction ID: 2AR79510MK1154237
https://www.paypal.com/activity/payment/2AR79510MK1154237",PayPal Bank 3,--,$2.38,"$919,194.10"
Donations directed by individuals,09/22/2023,Deposit,2AR79510MK1154237,04 PAYPAL GENERAL UNRESTR,Support Ukraine - Support Ukraine,Contributed income:Donations directed by individuals,PayPal Bank 3,$3.00,"$919,197.10"
PayPal Fees,09/22/2023,Deposit,2AR79510MK1154237,04 PAYPAL GENERAL UNRESTR,PayPal fees,OFFICE/GENERAL ADMINISTRATIVE EXPENSES:PayPal Fees,PayPal Bank 3,$0.62,"$919,197.72"
PayPal Bank 3,09/22/2023,Deposit,46H820006S7828536,04 PAYPAL GENERAL UNRESTR,"Subject: GeneralPage
Transaction ID: 46H820006S7828536
https://www.paypal.com/activity/payment/46H820006S7828536",PayPal Bank 3,--,$47.31,"$919,245.03"
Donations directed by individuals,09/22/2023,Deposit,46H820006S7828536,04 PAYPAL GENERAL UNRESTR,Support Ukraine - Support Ukraine,Contributed income:Donations directed by individuals,PayPal Bank 3,$50.00,"$919,295.03"
PayPal Fees,09/22/2023,Deposit,46H820006S7828536,04 PAYPAL GENERAL UNRESTR,PayPal fees,OFFICE/GENERAL ADMINISTRATIVE EXPENSES:PayPal Fees,PayPal Bank 3,$2.69,"$919,297.72"
PayPal Bank 3,09/22/2023,Deposit,2F9962056E6925709,07 1000 DRONES RESTR,"Subject: 1000DRONES
Note: charity
Transaction ID: 2F9962056E6925709
https://www.paypal.com/activity/payment/2F9962056E6925709",PayPal Bank 3,--,$9.84,"$919,307.56"
Donations directed by individuals,09/22/2023,Deposit,2F9962056E6925709,07 1000 DRONES RESTR,1000 DRONES FOR UKRAINE - 1000 DRONES FOR UKRAINE,Contributed income:Donations directed by individuals,PayPal Bank 3,$10.80,"$919,318.36"
PayPal Fees,09/22/2023,Deposit,2F9962056E6925709,07 1000 DRONES RESTR,PayPal fees,OFFICE/GENERAL ADMINISTRATIVE EXPENSES:PayPal Fees,PayPal Bank 3,$0.96,"$919,319.32"
PayPal Bank 3,09/22/2023,Deposit,76937804149483342,04 PAYPAL GENERAL UNRESTR,"Subject: GeneralPage
Transaction ID: 76937804149483342
https://www.paypal.com/activity/payment/76937804149483342",PayPal Bank 3,--,$14.76,"$919,334.08"
Donations directed by individuals,09/22/2023,Deposit,76937804149483342,04 PAYPAL GENERAL UNRESTR,Support Ukraine - Support Ukraine,Contributed income:Donations directed by individuals,PayPal Bank 3,$15.95,"$919,350.03"
PayPal Fees,09/22/2023,Deposit,76937804149483342,04 PAYPAL GENERAL UNRESTR,PayPal fees,OFFICE/GENERAL ADMINISTRATIVE EXPENSES:PayPal Fees,PayPal Bank 3,$1.19,"$919,351.22"
PayPal Bank 3,09/22/2023,Deposit,0TW881165Y916752N,04 PAYPAL GENERAL UNRESTR,"Subject: GeneralPage
Transaction ID: 0TW881165Y916752N
https://www.paypal.com/activity/payment/0TW881165Y916752N",PayPal Bank 3,--,$98.45,"$919,449.67"
Donations directed by individuals,09/22/2023,Deposit,0TW881165Y916752N,04 PAYPAL GENERAL UNRESTR,Support Ukraine - Support Ukraine,Contributed income:Donations directed by individuals,PayPal Bank 3,$103.48,"$919,553.15"
PayPal Fees,09/22/2023,Deposit,0TW881165Y916752N,04 PAYPAL GENERAL UNRESTR,PayPal fees,OFFICE/GENERAL ADMINISTRATIVE EXPENSES:PayPal Fees,PayPal Bank 3,$5.03,"$919,558.18"
PayPal Bank 3,09/22/2023,Deposit,2TM59647S0102361C,04 PAYPAL GENERAL UNRESTR,"Subject: GeneralPage
Note: Charitable donation to Ukrainian defenders
Transaction ID: 2TM59647S0102361C
https://www.paypal.com/activity/payment/2TM59647S0102361C",PayPal Bank 3,--,$98.45,"$919,656.63"
Donations directed by individuals,09/22/2023,Deposit,2TM59647S0102361C,04 PAYPAL GENERAL UNRESTR,Support Ukraine - Support Ukraine,Contributed income:Donations directed by individuals,PayPal Bank 3,$103.48,"$919,760.11"
PayPal Fees,09/22/2023,Deposit,2TM59647S0102361C,04 PAYPAL GENERAL UNRESTR,PayPal fees,OFFICE/GENERAL ADMINISTRATIVE EXPENSES:PayPal Fees,PayPal Bank 3,$5.03,"$919,765.14"
PayPal Bank 3,09/22/2023,Deposit,9W886417HX4120808,04 PAYPAL GENERAL UNRESTR,"Subject: GeneralPage
Transaction ID: 9W886417HX4120808
https://www.paypal.com/activity/payment/9W886417HX4120808",PayPal Bank 3,--,$98.45,"$919,863.59"
Donations directed by individuals,09/22/2023,Deposit,9W886417HX4120808,04 PAYPAL GENERAL UNRESTR,Support Ukraine - Support Ukraine,Contributed income:Donations directed by individuals,PayPal Bank 3,$103.48,"$919,967.07"
PayPal Fees,09/22/2023,Deposit,9W886417HX4120808,04 PAYPAL GENERAL UNRESTR,PayPal fees,OFFICE/GENERAL ADMINISTRATIVE EXPENSES:PayPal Fees,PayPal Bank 3,$5.03,"$919,972.10"
PayPal Bank 3,09/22/2023,Deposit,0UU743164B438782K,04 PAYPAL GENERAL UNRESTR,"Subject: GeneralPage
Transaction ID: 0UU743164B438782K
https://www.paypal.com/activity/payment/0UU743164B438782K",PayPal Bank 3,--,$50.00,"$920,022.10"
Donations directed by individuals,09/22/2023,Deposit,0UU743164B438782K,04 PAYPAL GENERAL UNRESTR,Support Ukraine - Support Ukraine,Contributed income:Donations directed by individuals,PayPal Bank 3,$51.99,"$920,074.09"
PayPal Fees,09/22/2023,Deposit,0UU743164B438782K,04 PAYPAL GENERAL UNRESTR,PayPal fees,OFFICE/GENERAL ADMINISTRATIVE EXPENSES:PayPal Fees,PayPal Bank 3,$1.99,"$920,076.08"
PayPal Bank 3,09/22/2023,Deposit,6CP61379D15078157,04 PAYPAL GENERAL UNRESTR,"Subject: GeneralPage
Transaction ID: 6CP61379D15078157
https://www.paypal.com/activity/payment/6CP61379D15078157",PayPal Bank 3,--,$9.07,"$920,085.15"
Donations directed by individuals,09/22/2023,Deposit,6CP61379D15078157,04 PAYPAL GENERAL UNRESTR,Support Ukraine - Support Ukraine,Contributed income:Donations directed by individuals,PayPal Bank 3,$10.00,"$920,095.15"
PayPal Fees,09/22/2023,Deposit,6CP61379D15078157,04 PAYPAL GENERAL UNRESTR,PayPal fees,OFFICE/GENERAL ADMINISTRATIVE EXPENSES:PayPal Fees,PayPal Bank 3,$0.93,"$920,096.08"
PayPal Bank 3,09/22/2023,Deposit,07H433459W059753W,04 PAYPAL GENERAL UNRESTR,"Subject: GeneralPage
Note: На люті пташки
Transaction ID: 07H433459W059753W
https://www.paypal.com/activity/payment/07H433459W059753W",PayPal Bank 3,--,$9.07,"$920,105.15"
Donations directed by individuals,09/22/2023,Deposit,07H433459W059753W,04 PAYPAL GENERAL UNRESTR,Support Ukraine - Support Ukraine,Contributed income:Donations directed by individuals,PayPal Bank 3,$10.00,"$920,115.15"
PayPal Fees,09/22/2023,Deposit,07H433459W059753W,04 PAYPAL GENERAL UNRESTR,PayPal fees,OFFICE/GENERAL ADMINISTRATIVE EXPENSES:PayPal Fees,PayPal Bank 3,$0.93,"$920,116.08"
PayPal Bank 3,09/22/2023,Deposit,33W119410J994640D,04 PAYPAL GENERAL UNRESTR,"Subject: GeneralPage
Transaction ID: 33W119410J994640D
https://www.paypal.com/activity/payment/33W119410J994640D",PayPal Bank 3,--,$96.62,"$920,212.70"
Donations directed by individuals,09/22/2023,Deposit,33W119410J994640D,04 PAYPAL GENERAL UNRESTR,Support Ukraine - Support Ukraine,Contributed income:Donations directed by individuals,PayPal Bank 3,$100.00,"$920,312.70"
PayPal Fees,09/22/2023,Deposit,33W119410J994640D,04 PAYPAL GENERAL UNRESTR,PayPal fees,OFFICE/GENERAL ADMINISTRATIVE EXPENSES:PayPal Fees,PayPal Bank 3,$3.38,"$920,316.08"
PayPal Bank 3,09/22/2023,Deposit,88V864228U716564Y,04 PAYPAL GENERAL UNRESTR,"Subject: GeneralPage
Transaction ID: 88V864228U716564Y
https://www.paypal.com/activity/payment/88V864228U716564Y",PayPal Bank 3,--,$18.63,"$920,334.71"
Donations directed by individuals,09/22/2023,Deposit,88V864228U716564Y,04 PAYPAL GENERAL UNRESTR,Support Ukraine - Support Ukraine,Contributed income:Donations directed by individuals,PayPal Bank 3,$20.00,"$920,354.71"
PayPal Fees,09/22/2023,Deposit,88V864228U716564Y,04 PAYPAL GENERAL UNRESTR,PayPal fees,OFFICE/GENERAL ADMINISTRATIVE EXPENSES:PayPal Fees,PayPal Bank 3,$1.37,"$920,356.08"
PayPal Bank 3,09/22/2023,Deposit,87K2960894702960P,04 PAYPAL GENERAL UNRESTR,"Subject: GeneralPage
Note: Maria’s Birthday
Transaction ID: 87K2960894702960P
https://www.paypal.com/activity/payment/87K2960894702960P",PayPal Bank 3,--,$50.00,"$920,406.08"
Donations directed by individuals,09/22/2023,Deposit,87K2960894702960P,04 PAYPAL GENERAL UNRESTR,Support Ukraine - Support Ukraine,Contributed income:Donations directed by individuals,PayPal Bank 3,$51.99,"$920,458.07"
PayPal Fees,09/22/2023,Deposit,87K2960894702960P,04 PAYPAL GENERAL UNRESTR,PayPal fees,OFFICE/GENERAL ADMINISTRATIVE EXPENSES:PayPal Fees,PayPal Bank 3,$1.99,"$920,460.06"
PayPal Bank 3,09/22/2023,Deposit,5N977942PY4161037,04 PAYPAL GENERAL UNRESTR,"Subject: GeneralPage
Transaction ID: 5N977942PY4161037
https://www.paypal.com/activity/payment/5N977942PY4161037",PayPal Bank 3,--,$100.00,"$920,560.06"
Donations directed by individuals,09/22/2023,Deposit,5N977942PY4161037,04 PAYPAL GENERAL UNRESTR,Support Ukraine - Support Ukraine,Contributed income:Donations directed by individuals,PayPal Bank 3,$103.48,"$920,663.54"
PayPal Fees,09/22/2023,Deposit,5N977942PY4161037,04 PAYPAL GENERAL UNRESTR,PayPal fees,OFFICE/GENERAL ADMINISTRATIVE EXPENSES:PayPal Fees,PayPal Bank 3,$3.48,"$920,667.02"
PayPal Bank 3,09/22/2023,Deposit,2FA85591YB177193A,04 PAYPAL GENERAL UNRESTR,"Subject: GeneralPage
Transaction ID: 2FA85591YB177193A
https://www.paypal.com/activity/payment/2FA85591YB177193A",PayPal Bank 3,--,$29.53,"$920,696.55"
Donations directed by individuals,09/22/2023,Deposit,2FA85591YB177193A,04 PAYPAL GENERAL UNRESTR,Support Ukraine - Support Ukraine,Contributed income:Donations directed by individuals,PayPal Bank 3,$31.40,"$920,727.95"
PayPal Fees,09/22/2023,Deposit,2FA85591YB177193A,04 PAYPAL GENERAL UNRESTR,PayPal fees,OFFICE/GENERAL ADMINISTRATIVE EXPENSES:PayPal Fees,PayPal Bank 3,$1.87,"$920,729.82"
PayPal Bank 3,09/22/2023,Deposit,5P261190TU2175050,04 PAYPAL GENERAL UNRESTR,"Subject: GeneralPage
Transaction ID: 5P261190TU2175050
https://www.paypal.com/activity/payment/5P261190TU2175050",PayPal Bank 3,--,$30.00,"$920,759.82"
Donations directed by individuals,09/22/2023,Deposit,5P261190TU2175050,04 PAYPAL GENERAL UNRESTR,Support Ukraine - Support Ukraine,Contributed income:Donations directed by individuals,PayPal Bank 3,$31.40,"$920,791.22"
PayPal Fees,09/22/2023,Deposit,5P261190TU2175050,04 PAYPAL GENERAL UNRESTR,PayPal fees,OFFICE/GENERAL ADMINISTRATIVE EXPENSES:PayPal Fees,PayPal Bank 3,$1.40,"$920,792.62"
PayPal Bank 3,09/22/2023,Deposit,84B4026584145823F,04 PAYPAL GENERAL UNRESTR,"Subject: GeneralPage
Note: З днем народження, Маріє�
Transaction ID: 84B4026584145823F
https://www.paypal.com/activity/payment/84B4026584145823F",PayPal Bank 3,--,$18.63,"$920,811.25"
Donations directed by individuals,09/22/2023,Deposit,84B4026584145823F,04 PAYPAL GENERAL UNRESTR,Support Ukraine - Support Ukraine,Contributed income:Donations directed by individuals,PayPal Bank 3,$20.00,"$920,831.25"
PayPal Fees,09/22/2023,Deposit,84B4026584145823F,04 PAYPAL GENERAL UNRESTR,PayPal fees,OFFICE/GENERAL ADMINISTRATIVE EXPENSES:PayPal Fees,PayPal Bank 3,$1.37,"$920,832.62"
PayPal Bank 3,09/22/2023,Deposit,5R515091H4526010V,04 PAYPAL GENERAL UNRESTR,"Subject: GeneralPage
Transaction ID: 5R515091H4526010V
https://www.paypal.com/activity/payment/5R515091H4526010V",PayPal Bank 3,--,$98.45,"$920,931.07"
Donations directed by individuals,09/22/2023,Deposit,5R515091H4526010V,04 PAYPAL GENERAL UNRESTR,Support Ukraine - Support Ukraine,Contributed income:Donations directed by individuals,PayPal Bank 3,$103.48,"$921,034.55"
PayPal Fees,09/22/2023,Deposit,5R515091H4526010V,04 PAYPAL GENERAL UNRESTR,PayPal fees,OFFICE/GENERAL ADMINISTRATIVE EXPENSES:PayPal Fees,PayPal Bank 3,$5.03,"$921,039.58"
PayPal Bank 3,09/22/2023,Deposit,2GY76190804963441,04 PAYPAL GENERAL UNRESTR,"Subject: GeneralPage
Note: З Днем Народження, Маріє!
Transaction ID: 2GY76190804963441
https://www.paypal.com/activity/payment/2GY76190804963441",PayPal Bank 3,--,$47.31,"$921,086.89"
Donations directed by individuals,09/22/2023,Deposit,2GY76190804963441,04 PAYPAL GENERAL UNRESTR,Support Ukraine - Support Ukraine,Contributed income:Donations directed by individuals,PayPal Bank 3,$50.00,"$921,136.89"
PayPal Fees,09/22/2023,Deposit,2GY76190804963441,04 PAYPAL GENERAL UNRESTR,PayPal fees,OFFICE/GENERAL ADMINISTRATIVE EXPENSES:PayPal Fees,PayPal Bank 3,$2.69,"$921,139.58"
PayPal Bank 3,09/22/2023,Deposit,07B83020J87413610,07 1000 DRONES RESTR,"Subject: 1000DRONES
Transaction ID: 07B83020J87413610
https://www.paypal.com/activity/payment/07B83020J87413610",PayPal Bank 3,--,$23.79,"$921,163.37"
Donations directed by individuals,09/22/2023,Deposit,07B83020J87413610,07 1000 DRONES RESTR,1000 DRONES FOR UKRAINE - 1000 DRONES FOR UKRAINE,Contributed income:Donations directed by individuals,PayPal Bank 3,$25.00,"$921,188.37"
PayPal Fees,09/22/2023,Deposit,07B83020J87413610,07 1000 DRONES RESTR,PayPal fees,OFFICE/GENERAL ADMINISTRATIVE EXPENSES:PayPal Fees,PayPal Bank 3,$1.21,"$921,189.58"
PayPal Bank 3,09/22/2023,Deposit,6HX35211GM001514D,07 1000 DRONES RESTR,"Subject: 1000DRONES
Transaction ID: 6HX35211GM001514D
https://www.paypal.com/activity/payment/6HX35211GM001514D",PayPal Bank 3,--,$28.64,"$921,218.22"
Donations directed by individuals,09/22/2023,Deposit,6HX35211GM001514D,07 1000 DRONES RESTR,1000 DRONES FOR UKRAINE - 1000 DRONES FOR UKRAINE,Contributed income:Donations directed by individuals,PayPal Bank 3,$30.00,"$921,248.22"
PayPal Fees,09/22/2023,Deposit,6HX35211GM001514D,07 1000 DRONES RESTR,PayPal fees,OFFICE/GENERAL ADMINISTRATIVE EXPENSES:PayPal Fees,PayPal Bank 3,$1.36,"$921,249.58"
PayPal Bank 3,09/22/2023,Deposit,9FE93419AS622841C,04 PAYPAL GENERAL UNRESTR,"Subject: GeneralPage
Transaction ID: 9FE93419AS622841C
https://www.paypal.com/activity/payment/9FE93419AS622841C",PayPal Bank 3,--,$50.00,"$921,299.58"
Donations directed by individuals,09/22/2023,Deposit,9FE93419AS622841C,04 PAYPAL GENERAL UNRESTR,Support Ukraine - Support Ukraine,Contributed income:Donations directed by individuals,PayPal Bank 3,$51.99,"$921,351.57"
PayPal Fees,09/22/2023,Deposit,9FE93419AS622841C,04 PAYPAL GENERAL UNRESTR,PayPal fees,OFFICE/GENERAL ADMINISTRATIVE EXPENSES:PayPal Fees,PayPal Bank 3,$1.99,"$921,353.56"
PayPal Bank 3,09/22/2023,Deposit,5DM79677J8665364E,04 PAYPAL GENERAL UNRESTR,"Subject: GeneralPage
Transaction ID: 5DM79677J8665364E
https://www.paypal.com/activity/payment/5DM79677J8665364E",PayPal Bank 3,--,$50.00,"$921,403.56"
Donations directed by individuals,09/22/2023,Deposit,5DM79677J8665364E,04 PAYPAL GENERAL UNRESTR,Support Ukraine - Support Ukraine,Contributed income:Donations directed by individuals,PayPal Bank 3,$51.99,"$921,455.55"
PayPal Fees,09/22/2023,Deposit,5DM79677J8665364E,04 PAYPAL GENERAL UNRESTR,PayPal fees,OFFICE/GENERAL ADMINISTRATIVE EXPENSES:PayPal Fees,PayPal Bank 3,$1.99,"$921,457.54"
PayPal Bank 3,09/22/2023,Deposit,2GS02792JA6671926,04 PAYPAL GENERAL UNRESTR,"Subject: GeneralPage
Note: Happy Birthday, Mariya!
Transaction ID: 2GS02792JA6671926
https://www.paypal.com/activity/payment/2GS02792JA6671926",PayPal Bank 3,--,$96.62,"$921,554.16"
Donations directed by individuals,09/22/2023,Deposit,2GS02792JA6671926,04 PAYPAL GENERAL UNRESTR,Support Ukraine - Support Ukraine,Contributed income:Donations directed by individuals,PayPal Bank 3,$100.00,"$921,654.16"
PayPal Fees,09/22/2023,Deposit,2GS02792JA6671926,04 PAYPAL GENERAL UNRESTR,PayPal fees,OFFICE/GENERAL ADMINISTRATIVE EXPENSES:PayPal Fees,PayPal Bank 3,$3.38,"$921,657.54"
PayPal Bank 3,09/22/2023,Deposit,12J68024CC9628533,04 PAYPAL GENERAL UNRESTR,"Subject: GeneralPage
Transaction ID: 12J68024CC9628533
https://www.paypal.com/activity/payment/12J68024CC9628533",PayPal Bank 3,--,$300.00,"$921,957.54"
Donations directed by individuals,09/22/2023,Deposit,12J68024CC9628533,04 PAYPAL GENERAL UNRESTR,Support Ukraine - Support Ukraine,Contributed income:Donations directed by individuals,PayPal Bank 3,$309.43,"$922,266.97"
PayPal Fees,09/22/2023,Deposit,12J68024CC9628533,04 PAYPAL GENERAL UNRESTR,PayPal fees,OFFICE/GENERAL ADMINISTRATIVE EXPENSES:PayPal Fees,PayPal Bank 3,$9.43,"$922,276.40"
PayPal Bank 3,09/22/2023,Deposit,0XG47317GP206745Y,07 1000 DRONES RESTR,"Subject: 1000DRONES
Transaction ID: 0XG47317GP206745Y
https://www.paypal.com/activity/payment/0XG47317GP206745Y",PayPal Bank 3,--,$9.22,"$922,285.62"
Donations directed by individuals,09/22/2023,Deposit,0XG47317GP206745Y,07 1000 DRONES RESTR,1000 DRONES FOR UKRAINE - 1000 DRONES FOR UKRAINE,Contributed income:Donations directed by individuals,PayPal Bank 3,$10.00,"$922,295.62"
PayPal Fees,09/22/2023,Deposit,0XG47317GP206745Y,07 1000 DRONES RESTR,PayPal fees,OFFICE/GENERAL ADMINISTRATIVE EXPENSES:PayPal Fees,PayPal Bank 3,$0.78,"$922,296.40"
PayPal Bank 3,09/22/2023,Deposit,67S940159X641740R,07 1000 DRONES RESTR,"Subject: 1000DRONES
Transaction ID: 67S940159X641740R
https://www.paypal.com/activity/payment/67S940159X641740R",PayPal Bank 3,--,$100.00,"$922,396.40"
Donations directed by individuals,09/22/2023,Deposit,67S940159X641740R,07 1000 DRONES RESTR,1000 DRONES FOR UKRAINE - 1000 DRONES FOR UKRAINE,Contributed income:Donations directed by individuals,PayPal Bank 3,$103.48,"$922,499.88"
PayPal Fees,09/22/2023,Deposit,67S940159X641740R,07 1000 DRONES RESTR,PayPal fees,OFFICE/GENERAL ADMINISTRATIVE EXPENSES:PayPal Fees,PayPal Bank 3,$3.48,"$922,503.36"
PayPal Bank 3,09/22/2023,Deposit,06D890035U0349250,11 VETERANIUS RESTR,"Subject: Veteranius
Transaction ID: 06D890035U0349250
https://www.paypal.com/activity/payment/06D890035U0349250",PayPal Bank 3,--,$20.00,"$922,523.36"
Donations directed by individuals,09/22/2023,Deposit,06D890035U0349250,11 VETERANIUS RESTR,Veteranius - helping veterans to learn and gain experience in IT. - Veteranius - helping veterans to learn and gain experience in IT.,Contributed income:Donations directed by individuals,PayPal Bank 3,$21.10,"$922,544.46"
PayPal Fees,09/22/2023,Deposit,06D890035U0349250,11 VETERANIUS RESTR,PayPal fees,OFFICE/GENERAL ADMINISTRATIVE EXPENSES:PayPal Fees,PayPal Bank 3,$1.10,"$922,545.56"
PayPal Bank 3,09/22/2023,Deposit,56X641800X209802N,07 1000 DRONES RESTR,"Subject: 1000DRONES
Transaction ID: 56X641800X209802N
https://www.paypal.com/activity/payment/56X641800X209802N",PayPal Bank 3,--,$25.00,"$922,570.56"
Donations directed by individuals,09/22/2023,Deposit,56X641800X209802N,07 1000 DRONES RESTR,1000 DRONES FOR UKRAINE - 1000 DRONES FOR UKRAINE,Contributed income:Donations directed by individuals,PayPal Bank 3,$26.25,"$922,596.81"
PayPal Fees,09/22/2023,Deposit,56X641800X209802N,07 1000 DRONES RESTR,PayPal fees,OFFICE/GENERAL ADMINISTRATIVE EXPENSES:PayPal Fees,PayPal Bank 3,$1.25,"$922,598.06"
PayPal Bank 3,09/22/2023,Deposit,0UP65208G74811534,07 1000 DRONES RESTR,"Subject: 1000DRONES
Transaction ID: 0UP65208G74811534
https://www.paypal.com/activity/payment/0UP65208G74811534",PayPal Bank 3,--,$30.00,"$922,628.06"
Donations directed by individuals,09/22/2023,Deposit,0UP65208G74811534,07 1000 DRONES RESTR,1000 DRONES FOR UKRAINE - 1000 DRONES FOR UKRAINE,Contributed income:Donations directed by individuals,PayPal Bank 3,$31.40,"$922,659.46"
PayPal Fees,09/22/2023,Deposit,0UP65208G74811534,07 1000 DRONES RESTR,PayPal fees,OFFICE/GENERAL ADMINISTRATIVE EXPENSES:PayPal Fees,PayPal Bank 3,$1.40,"$922,660.86"
PayPal Bank 3,09/22/2023,Deposit,1NC80872ET105824Y,04 PAYPAL GENERAL UNRESTR,"Subject: GeneralPage
Transaction ID: 1NC80872ET105824Y
https://www.paypal.com/activity/payment/1NC80872ET105824Y",PayPal Bank 3,--,$40.00,"$922,700.86"
Donations directed by individuals,09/22/2023,Deposit,1NC80872ET105824Y,04 PAYPAL GENERAL UNRESTR,Support Ukraine - Support Ukraine,Contributed income:Donations directed by individuals,PayPal Bank 3,$41.69,"$922,742.55"
PayPal Fees,09/22/2023,Deposit,1NC80872ET105824Y,04 PAYPAL GENERAL UNRESTR,PayPal fees,OFFICE/GENERAL ADMINISTRATIVE EXPENSES:PayPal Fees,PayPal Bank 3,$1.69,"$922,744.24"
PayPal Bank 3,09/22/2023,Deposit,3WN68147UY468705T,04 PAYPAL GENERAL UNRESTR,"Transaction ID: 3WN68147UY468705T
https://www.paypal.com/activity/payment/3WN68147UY468705T",PayPal Bank 3,--,$97.01,"$922,841.25"
Donations directed by individuals,09/22/2023,Deposit,3WN68147UY468705T,04 PAYPAL GENERAL UNRESTR,Money in to PayPal,Contributed income:Donations directed by individuals,PayPal Bank 3,$100.00,"$922,941.25"
PayPal Fees,09/22/2023,Deposit,3WN68147UY468705T,04 PAYPAL GENERAL UNRESTR,PayPal fees,OFFICE/GENERAL ADMINISTRATIVE EXPENSES:PayPal Fees,PayPal Bank 3,$2.99,"$922,944.24"
PayPal Bank 3,09/22/2023,Deposit,78N06797HL9738248,04 PAYPAL GENERAL UNRESTR,"Subject: GeneralPage
Transaction ID: 78N06797HL9738248
https://www.paypal.com/activity/payment/78N06797HL9738248",PayPal Bank 3,--,$117.54,"$923,061.78"
Donations directed by individuals,09/22/2023,Deposit,78N06797HL9738248,04 PAYPAL GENERAL UNRESTR,Support Ukraine - Support Ukraine,Contributed income:Donations directed by individuals,PayPal Bank 3,$123.45,"$923,185.23"
PayPal Fees,09/22/2023,Deposit,78N06797HL9738248,04 PAYPAL GENERAL UNRESTR,PayPal fees,OFFICE/GENERAL ADMINISTRATIVE EXPENSES:PayPal Fees,PayPal Bank 3,$5.91,"$923,191.14"
PayPal Bank 3,09/22/2023,Deposit,2HV800517G1396703,04 PAYPAL GENERAL UNRESTR,"Subject: Support Ukraine
Transaction ID: 2HV800517G1396703
https://www.paypal.com/activity/payment/2HV800517G1396703",PayPal Bank 3,--,$24.61,"$923,215.75"
Donations directed by individuals,09/22/2023,Deposit,2HV800517G1396703,04 PAYPAL GENERAL UNRESTR,Money in to PayPal,Contributed income:Donations directed by individuals,PayPal Bank 3,$26.25,"$923,242.00"
PayPal Fees,09/22/2023,Deposit,2HV800517G1396703,04 PAYPAL GENERAL UNRESTR,PayPal fees,OFFICE/GENERAL ADMINISTRATIVE EXPENSES:PayPal Fees,PayPal Bank 3,$1.64,"$923,243.64"
PayPal Bank 3,09/22/2023,Deposit,0VN21464SA872642W,07 1000 DRONES RESTR,"Subject: 1000DRONES
Transaction ID: 0VN21464SA872642W
https://www.paypal.com/activity/payment/0VN21464SA872642W",PayPal Bank 3,--,$9.22,"$923,252.86"
Donations directed by individuals,09/22/2023,Deposit,0VN21464SA872642W,07 1000 DRONES RESTR,1000 DRONES FOR UKRAINE - 1000 DRONES FOR UKRAINE,Contributed income:Donations directed by individuals,PayPal Bank 3,$10.00,"$923,262.86"
PayPal Fees,09/22/2023,Deposit,0VN21464SA872642W,07 1000 DRONES RESTR,PayPal fees,OFFICE/GENERAL ADMINISTRATIVE EXPENSES:PayPal Fees,PayPal Bank 3,$0.78,"$923,263.64"
PayPal Bank 3,09/22/2023,Deposit,8M187574AT955184R,07 1000 DRONES RESTR,"Subject: 1000DRONES
Transaction ID: 8M187574AT955184R
https://www.paypal.com/activity/payment/8M187574AT955184R",PayPal Bank 3,--,$48.06,"$923,311.70"
Donations directed by individuals,09/22/2023,Deposit,8M187574AT955184R,07 1000 DRONES RESTR,1000 DRONES FOR UKRAINE - 1000 DRONES FOR UKRAINE,Contributed income:Donations directed by individuals,PayPal Bank 3,$50.00,"$923,361.70"
PayPal Fees,09/22/2023,Deposit,8M187574AT955184R,07 1000 DRONES RESTR,PayPal fees,OFFICE/GENERAL ADMINISTRATIVE EXPENSES:PayPal Fees,PayPal Bank 3,$1.94,"$923,363.64"
PayPal Bank 3,09/22/2023,Deposit,5NM78294ND926014Y,04 PAYPAL GENERAL UNRESTR,"Subject: GeneralPage
Transaction ID: 5NM78294ND926014Y
https://www.paypal.com/activity/payment/5NM78294ND926014Y",PayPal Bank 3,--,$9.22,"$923,372.86"
Donations directed by individuals,09/22/2023,Deposit,5NM78294ND926014Y,04 PAYPAL GENERAL UNRESTR,Support Ukraine - Support Ukraine,Contributed income:Donations directed by individuals,PayPal Bank 3,$10.00,"$923,382.86"
PayPal Fees,09/22/2023,Deposit,5NM78294ND926014Y,04 PAYPAL GENERAL UNRESTR,PayPal fees,OFFICE/GENERAL ADMINISTRATIVE EXPENSES:PayPal Fees,PayPal Bank 3,$0.78,"$923,383.64"
PayPal Bank 3,09/22/2023,Deposit,5GG81457KB005354U,04 PAYPAL GENERAL UNRESTR,"Transaction ID: 5GG81457KB005354U
https://www.paypal.com/activity/payment/5GG81457KB005354U",PayPal Bank 3,--,$97.01,"$923,480.65"
Donations directed by individuals,09/22/2023,Deposit,5GG81457KB005354U,04 PAYPAL GENERAL UNRESTR,Money in to PayPal,Contributed income:Donations directed by individuals,PayPal Bank 3,$100.00,"$923,580.65"
PayPal Fees,09/22/2023,Deposit,5GG81457KB005354U,04 PAYPAL GENERAL UNRESTR,PayPal fees,OFFICE/GENERAL ADMINISTRATIVE EXPENSES:PayPal Fees,PayPal Bank 3,$2.99,"$923,583.64"
PayPal Bank 3,09/22/2023,Deposit,3R269255CE9352018,04 PAYPAL GENERAL UNRESTR,"Transaction ID: 3R269255CE9352018
https://www.paypal.com/activity/payment/3R269255CE9352018",PayPal Bank 3,--,$48.50,"$923,632.14"
Donations directed by individuals,09/22/2023,Deposit,3R269255CE9352018,04 PAYPAL GENERAL UNRESTR,Money in to PayPal,Contributed income:Donations directed by individuals,PayPal Bank 3,$50.00,"$923,682.14"
PayPal Fees,09/22/2023,Deposit,3R269255CE9352018,04 PAYPAL GENERAL UNRESTR,PayPal fees,OFFICE/GENERAL ADMINISTRATIVE EXPENSES:PayPal Fees,PayPal Bank 3,$1.50,"$923,683.64"
PayPal Bank 3,09/22/2023,Deposit,07247303RU098864Y,11 VETERANIUS RESTR,"Subject: Veteranius
Transaction ID: 07247303RU098864Y
https://www.paypal.com/activity/payment/07247303RU098864Y",PayPal Bank 3,--,$9.22,"$923,692.86"
Donations directed by individuals,09/22/2023,Deposit,07247303RU098864Y,11 VETERANIUS RESTR,Veteranius - helping veterans to learn and gain experience in IT. - Veteranius - helping veterans to learn and gain experience in IT.,Contributed income:Donations directed by individuals,PayPal Bank 3,$10.00,"$923,702.86"
PayPal Fees,09/22/2023,Deposit,07247303RU098864Y,11 VETERANIUS RESTR,PayPal fees,OFFICE/GENERAL ADMINISTRATIVE EXPENSES:PayPal Fees,PayPal Bank 3,$0.78,"$923,703.64"
PayPal Bank 3,09/22/2023,Deposit,21Y17337NP859472P,04 PAYPAL GENERAL UNRESTR,"Transaction ID: 21Y17337NP859472P
https://www.paypal.com/activity/payment/21Y17337NP859472P",PayPal Bank 3,--,$97.01,"$923,800.65"
Donations directed by individuals,09/22/2023,Deposit,21Y17337NP859472P,04 PAYPAL GENERAL UNRESTR,Money in to PayPal,Contributed income:Donations directed by individuals,PayPal Bank 3,$100.00,"$923,900.65"
PayPal Fees,09/22/2023,Deposit,21Y17337NP859472P,04 PAYPAL GENERAL UNRESTR,PayPal fees,OFFICE/GENERAL ADMINISTRATIVE EXPENSES:PayPal Fees,PayPal Bank 3,$2.99,"$923,903.64"
PayPal Bank 3,09/22/2023,Deposit,7RH29875DF462440D,07 1000 DRONES RESTR,"Subject: 1000DRONES
Transaction ID: 7RH29875DF462440D
https://www.paypal.com/activity/payment/7RH29875DF462440D",PayPal Bank 3,--,$18.93,"$923,922.57"
Donations directed by individuals,09/22/2023,Deposit,7RH29875DF462440D,07 1000 DRONES RESTR,1000 DRONES FOR UKRAINE - 1000 DRONES FOR UKRAINE,Contributed income:Donations directed by individuals,PayPal Bank 3,$20.00,"$923,942.57"
PayPal Fees,09/22/2023,Deposit,7RH29875DF462440D,07 1000 DRONES RESTR,PayPal fees,OFFICE/GENERAL ADMINISTRATIVE EXPENSES:PayPal Fees,PayPal Bank 3,$1.07,"$923,943.64"
PayPal Bank 3,09/22/2023,Deposit,1L8260455P948205B,07 1000 DRONES RESTR,"Subject: 1000DRONES
Transaction ID: 1L8260455P948205B
https://www.paypal.com/activity/payment/1L8260455P948205B",PayPal Bank 3,--,$28.64,"$923,972.28"
Donations directed by individuals,09/22/2023,Deposit,1L8260455P948205B,07 1000 DRONES RESTR,1000 DRONES FOR UKRAINE - 1000 DRONES FOR UKRAINE,Contributed income:Donations directed by individuals,PayPal Bank 3,$30.00,"$924,002.28"
PayPal Fees,09/22/2023,Deposit,1L8260455P948205B,07 1000 DRONES RESTR,PayPal fees,OFFICE/GENERAL ADMINISTRATIVE EXPENSES:PayPal Fees,PayPal Bank 3,$1.36,"$924,003.64"
PayPal Bank 3,09/22/2023,Deposit,54706032TL125061W,04 PAYPAL GENERAL UNRESTR,"Transaction ID: 54706032TL125061W
https://www.paypal.com/activity/payment/54706032TL125061W",PayPal Bank 3,--,$19.40,"$924,023.04"
Donations directed by individuals,09/22/2023,Deposit,54706032TL125061W,04 PAYPAL GENERAL UNRESTR,Money in to PayPal,Contributed income:Donations directed by individuals,PayPal Bank 3,$20.00,"$924,043.04"
PayPal Fees,09/22/2023,Deposit,54706032TL125061W,04 PAYPAL GENERAL UNRESTR,PayPal fees,OFFICE/GENERAL ADMINISTRATIVE EXPENSES:PayPal Fees,PayPal Bank 3,$0.60,"$924,043.64"
PayPal Bank 3,09/22/2023,Deposit,68645106W9868733U,04 PAYPAL GENERAL UNRESTR,"Note: For Ukraine
Transaction ID: 68645106W9868733U
https://www.paypal.com/activity/payment/68645106W9868733U",PayPal Bank 3,--,$38.80,"$924,082.44"
Donations directed by individuals,09/22/2023,Deposit,68645106W9868733U,04 PAYPAL GENERAL UNRESTR,Money in to PayPal,Contributed income:Donations directed by individuals,PayPal Bank 3,$40.00,"$924,122.44"
PayPal Fees,09/22/2023,Deposit,68645106W9868733U,04 PAYPAL GENERAL UNRESTR,PayPal fees,OFFICE/GENERAL ADMINISTRATIVE EXPENSES:PayPal Fees,PayPal Bank 3,$1.20,"$924,123.64"
PayPal Bank 3,09/22/2023,Deposit,7SD35651VG565081S,04 PAYPAL GENERAL UNRESTR,"Subject: Support Ukraine
Transaction ID: 7SD35651VG565081S
https://www.paypal.com/activity/payment/7SD35651VG565081S",PayPal Bank 3,--,$50.00,"$924,173.64"
Donations directed by individuals,09/22/2023,Deposit,7SD35651VG565081S,04 PAYPAL GENERAL UNRESTR,Money in to PayPal,Contributed income:Donations directed by individuals,PayPal Bank 3,$51.99,"$924,225.63"
PayPal Fees,09/22/2023,Deposit,7SD35651VG565081S,04 PAYPAL GENERAL UNRESTR,PayPal fees,OFFICE/GENERAL ADMINISTRATIVE EXPENSES:PayPal Fees,PayPal Bank 3,$1.99,"$924,227.62"
PayPal Bank 3,09/22/2023,Deposit,0EX88649X7733440Y,04 PAYPAL GENERAL UNRESTR,"Subject: GeneralPage
Transaction ID: 0EX88649X7733440Y
https://www.paypal.com/activity/payment/0EX88649X7733440Y",PayPal Bank 3,--,$10.00,"$924,237.62"
Donations directed by individuals,09/22/2023,Deposit,0EX88649X7733440Y,04 PAYPAL GENERAL UNRESTR,Support Ukraine - Support Ukraine,Contributed income:Donations directed by individuals,PayPal Bank 3,$10.80,"$924,248.42"
PayPal Fees,09/22/2023,Deposit,0EX88649X7733440Y,04 PAYPAL GENERAL UNRESTR,PayPal fees,OFFICE/GENERAL ADMINISTRATIVE EXPENSES:PayPal Fees,PayPal Bank 3,$0.80,"$924,249.22"
PayPal Bank 3,09/22/2023,Deposit,8G441278KX555713M,07 1000 DRONES RESTR,"Subject: 1000DRONES
Transaction ID: 8G441278KX555713M
https://www.paypal.com/activity/payment/8G441278KX555713M",PayPal Bank 3,--,$96.62,"$924,345.84"
Donations directed by individuals,09/22/2023,Deposit,8G441278KX555713M,07 1000 DRONES RESTR,1000 DRONES FOR UKRAINE - 1000 DRONES FOR UKRAINE,Contributed income:Donations directed by individuals,PayPal Bank 3,$100.00,"$924,445.84"
PayPal Fees,09/22/2023,Deposit,8G441278KX555713M,07 1000 DRONES RESTR,PayPal fees,OFFICE/GENERAL ADMINISTRATIVE EXPENSES:PayPal Fees,PayPal Bank 3,$3.38,"$924,449.22"
PayPal Bank 3,09/22/2023,Deposit,80Y31158HF387350F,04 PAYPAL GENERAL UNRESTR,"Subject: GeneralPage
Transaction ID: 80Y31158HF387350F
https://www.paypal.com/activity/payment/80Y31158HF387350F",PayPal Bank 3,--,$10.00,"$924,459.22"
Donations directed by individuals,09/22/2023,Deposit,80Y31158HF387350F,04 PAYPAL GENERAL UNRESTR,Support Ukraine - Support Ukraine,Contributed income:Donations directed by individuals,PayPal Bank 3,$10.80,"$924,470.02"
PayPal Fees,09/22/2023,Deposit,80Y31158HF387350F,04 PAYPAL GENERAL UNRESTR,PayPal fees,OFFICE/GENERAL ADMINISTRATIVE EXPENSES:PayPal Fees,PayPal Bank 3,$0.80,"$924,470.82"
PayPal Bank 3,09/22/2023,Deposit,40M38986H3646794J,07 1000 DRONES RESTR,"Subject: 1000DRONES
Transaction ID: 40M38986H3646794J
https://www.paypal.com/activity/payment/40M38986H3646794J",PayPal Bank 3,--,$20.00,"$924,490.82"
Donations directed by individuals,09/22/2023,Deposit,40M38986H3646794J,07 1000 DRONES RESTR,1000 DRONES FOR UKRAINE - 1000 DRONES FOR UKRAINE,Contributed income:Donations directed by individuals,PayPal Bank 3,$21.10,"$924,511.92"
PayPal Fees,09/22/2023,Deposit,40M38986H3646794J,07 1000 DRONES RESTR,PayPal fees,OFFICE/GENERAL ADMINISTRATIVE EXPENSES:PayPal Fees,PayPal Bank 3,$1.10,"$924,513.02"
PayPal Bank 3,09/22/2023,Deposit,4881252501302524F,07 1000 DRONES RESTR,"Subject: 1000DRONES
Transaction ID: 4881252501302524F
https://www.paypal.com/activity/payment/4881252501302524F",PayPal Bank 3,--,$9.22,"$924,522.24"
Donations directed by individuals,09/22/2023,Deposit,4881252501302524F,07 1000 DRONES RESTR,1000 DRONES FOR UKRAINE - 1000 DRONES FOR UKRAINE,Contributed income:Donations directed by individuals,PayPal Bank 3,$10.00,"$924,532.24"
PayPal Fees,09/22/2023,Deposit,4881252501302524F,07 1000 DRONES RESTR,PayPal fees,OFFICE/GENERAL ADMINISTRATIVE EXPENSES:PayPal Fees,PayPal Bank 3,$0.78,"$924,533.02"
PayPal Bank 3,09/22/2023,Deposit,2MM55629VA1674223,04 PAYPAL GENERAL UNRESTR,"Subject: GeneralPage
Transaction ID: 2MM55629VA1674223
https://www.paypal.com/activity/payment/2MM55629VA1674223",PayPal Bank 3,--,$96.62,"$924,629.64"
Donations directed by individuals,09/22/2023,Deposit,2MM55629VA1674223,04 PAYPAL GENERAL UNRESTR,Support Ukraine - Support Ukraine,Contributed income:Donations directed by individuals,PayPal Bank 3,$100.00,"$924,729.64"
PayPal Fees,09/22/2023,Deposit,2MM55629VA1674223,04 PAYPAL GENERAL UNRESTR,PayPal fees,OFFICE/GENERAL ADMINISTRATIVE EXPENSES:PayPal Fees,PayPal Bank 3,$3.38,"$924,733.02"
PayPal Bank 3,09/22/2023,Deposit,17G71747SC544061J,04 PAYPAL GENERAL UNRESTR,"Subject: GeneralPage
Transaction ID: 17G71747SC544061J
https://www.paypal.com/activity/payment/17G71747SC544061J",PayPal Bank 3,--,$9.84,"$924,742.86"
Donations directed by individuals,09/22/2023,Deposit,17G71747SC544061J,04 PAYPAL GENERAL UNRESTR,Support Ukraine - Support Ukraine,Contributed income:Donations directed by individuals,PayPal Bank 3,$10.80,"$924,753.66"
PayPal Fees,09/22/2023,Deposit,17G71747SC544061J,04 PAYPAL GENERAL UNRESTR,PayPal fees,OFFICE/GENERAL ADMINISTRATIVE EXPENSES:PayPal Fees,PayPal Bank 3,$0.96,"$924,754.62"
PayPal Bank 3,09/22/2023,Deposit,9BP75565MD6309947,04 PAYPAL GENERAL UNRESTR,"Subject: GeneralPage
Transaction ID: 9BP75565MD6309947
https://www.paypal.com/activity/payment/9BP75565MD6309947",PayPal Bank 3,--,$9.84,"$924,764.46"
Donations directed by individuals,09/22/2023,Deposit,9BP75565MD6309947,04 PAYPAL GENERAL UNRESTR,Support Ukraine - Support Ukraine,Contributed income:Donations directed by individuals,PayPal Bank 3,$10.80,"$924,775.26"
PayPal Fees,09/22/2023,Deposit,9BP75565MD6309947,04 PAYPAL GENERAL UNRESTR,PayPal fees,OFFICE/GENERAL ADMINISTRATIVE EXPENSES:PayPal Fees,PayPal Bank 3,$0.96,"$924,776.22"
PayPal Bank 3,09/22/2023,Deposit,18N475688M130574D,04 PAYPAL GENERAL UNRESTR,"Subject: GeneralPage
Transaction ID: 18N475688M130574D
https://www.paypal.com/activity/payment/18N475688M130574D",PayPal Bank 3,--,$19.17,"$924,795.39"
Donations directed by individuals,09/22/2023,Deposit,18N475688M130574D,04 PAYPAL GENERAL UNRESTR,Support Ukraine - Support Ukraine,Contributed income:Donations directed by individuals,PayPal Bank 3,$20.24,"$924,815.63"
PayPal Fees,09/22/2023,Deposit,18N475688M130574D,04 PAYPAL GENERAL UNRESTR,PayPal fees,OFFICE/GENERAL ADMINISTRATIVE EXPENSES:PayPal Fees,PayPal Bank 3,$1.07,"$924,816.70"
PayPal Bank 3,09/22/2023,Deposit,142680755U317423S,04 PAYPAL GENERAL UNRESTR,"Subject: GeneralPage
Transaction ID: 142680755U317423S
https://www.paypal.com/activity/payment/142680755U317423S",PayPal Bank 3,--,$23.79,"$924,840.49"
Donations directed by individuals,09/22/2023,Deposit,142680755U317423S,04 PAYPAL GENERAL UNRESTR,Support Ukraine - Support Ukraine,Contributed income:Donations directed by individuals,PayPal Bank 3,$25.00,"$924,865.49"
PayPal Fees,09/22/2023,Deposit,142680755U317423S,04 PAYPAL GENERAL UNRESTR,PayPal fees,OFFICE/GENERAL ADMINISTRATIVE EXPENSES:PayPal Fees,PayPal Bank 3,$1.21,"$924,866.70"
PayPal Bank 3,09/22/2023,Deposit,2F131387GJ6017710,04 PAYPAL GENERAL UNRESTR,"Subject: GeneralPage
Transaction ID: 2F131387GJ6017710
https://www.paypal.com/activity/payment/2F131387GJ6017710",PayPal Bank 3,--,$100.00,"$924,966.70"
Donations directed by individuals,09/22/2023,Deposit,2F131387GJ6017710,04 PAYPAL GENERAL UNRESTR,Support Ukraine - Support Ukraine,Contributed income:Donations directed by individuals,PayPal Bank 3,$103.48,"$925,070.18"
PayPal Fees,09/22/2023,Deposit,2F131387GJ6017710,04 PAYPAL GENERAL UNRESTR,PayPal fees,OFFICE/GENERAL ADMINISTRATIVE EXPENSES:PayPal Fees,PayPal Bank 3,$3.48,"$925,073.66"
PayPal Bank 3,09/22/2023,Deposit,8WF43927VV960394B,04 PAYPAL GENERAL UNRESTR,"Subject: GeneralPage
Transaction ID: 8WF43927VV960394B
https://www.paypal.com/activity/payment/8WF43927VV960394B",PayPal Bank 3,--,$95.12,"$925,168.78"
Donations directed by individuals,09/22/2023,Deposit,8WF43927VV960394B,04 PAYPAL GENERAL UNRESTR,Support Ukraine - Support Ukraine,Contributed income:Donations directed by individuals,PayPal Bank 3,$100.00,"$925,268.78"
PayPal Fees,09/22/2023,Deposit,8WF43927VV960394B,04 PAYPAL GENERAL UNRESTR,PayPal fees,OFFICE/GENERAL ADMINISTRATIVE EXPENSES:PayPal Fees,PayPal Bank 3,$4.88,"$925,273.66"
PayPal Bank 3,09/22/2023,Deposit,9DX55998C4076842J,04 PAYPAL GENERAL UNRESTR,"Subject: GeneralPage
Note: Dlja Peremohy Ukrajni
Transaction ID: 9DX55998C4076842J
https://www.paypal.com/activity/payment/9DX55998C4076842J",PayPal Bank 3,--,$246.13,"$925,519.79"
Donations directed by individuals,09/22/2023,Deposit,9DX55998C4076842J,04 PAYPAL GENERAL UNRESTR,Support Ukraine - Support Ukraine,Contributed income:Donations directed by individuals,PayPal Bank 3,$257.94,"$925,777.73"
PayPal Fees,09/22/2023,Deposit,9DX55998C4076842J,04 PAYPAL GENERAL UNRESTR,PayPal fees,OFFICE/GENERAL ADMINISTRATIVE EXPENSES:PayPal Fees,PayPal Bank 3,$11.81,"$925,789.54"
PayPal Bank 3,09/22/2023,Deposit,8RF82337DK472105E,04 PAYPAL GENERAL UNRESTR,"Subject: GeneralPage
Note: Ukraine Strong
Transaction ID: 8RF82337DK472105E
https://www.paypal.com/activity/payment/8RF82337DK472105E",PayPal Bank 3,--,$200.00,"$925,989.54"
Donations directed by individuals,09/22/2023,Deposit,8RF82337DK472105E,04 PAYPAL GENERAL UNRESTR,Support Ukraine - Support Ukraine,Contributed income:Donations directed by individuals,PayPal Bank 3,$206.46,"$926,196.00"
PayPal Fees,09/22/2023,Deposit,8RF82337DK472105E,04 PAYPAL GENERAL UNRESTR,PayPal fees,OFFICE/GENERAL ADMINISTRATIVE EXPENSES:PayPal Fees,PayPal Bank 3,$6.46,"$926,202.46"
PayPal Bank 3,09/22/2023,Deposit,92849379NY251523H,04 PAYPAL GENERAL UNRESTR,"Subject: GeneralPage
Note: Liuti ptashky
Transaction ID: 92849379NY251523H
https://www.paypal.com/activity/payment/92849379NY251523H",PayPal Bank 3,--,$44.29,"$926,246.75"
Donations directed by individuals,09/22/2023,Deposit,92849379NY251523H,04 PAYPAL GENERAL UNRESTR,Support Ukraine - Support Ukraine,Contributed income:Donations directed by individuals,PayPal Bank 3,$46.84,"$926,293.59"
PayPal Fees,09/22/2023,Deposit,92849379NY251523H,04 PAYPAL GENERAL UNRESTR,PayPal fees,OFFICE/GENERAL ADMINISTRATIVE EXPENSES:PayPal Fees,PayPal Bank 3,$2.55,"$926,296.14"
PayPal Bank 3,09/22/2023,Deposit,24H05466E78915840,04 PAYPAL GENERAL UNRESTR,"Subject: GeneralPage
Transaction ID: 24H05466E78915840
https://www.paypal.com/activity/payment/24H05466E78915840",PayPal Bank 3,--,$95.12,"$926,391.26"
Donations directed by individuals,09/22/2023,Deposit,24H05466E78915840,04 PAYPAL GENERAL UNRESTR,Support Ukraine - Support Ukraine,Contributed income:Donations directed by individuals,PayPal Bank 3,$100.00,"$926,491.26"
PayPal Fees,09/22/2023,Deposit,24H05466E78915840,04 PAYPAL GENERAL UNRESTR,PayPal fees,OFFICE/GENERAL ADMINISTRATIVE EXPENSES:PayPal Fees,PayPal Bank 3,$4.88,"$926,496.14"
PayPal Bank 3,09/22/2023,Deposit,59V91817VH0167112,04 PAYPAL GENERAL UNRESTR,"Subject: GeneralPage
Transaction ID: 59V91817VH0167112
https://www.paypal.com/activity/payment/59V91817VH0167112",PayPal Bank 3,--,$29.53,"$926,525.67"
Donations directed by individuals,09/22/2023,Deposit,59V91817VH0167112,04 PAYPAL GENERAL UNRESTR,Support Ukraine - Support Ukraine,Contributed income:Donations directed by individuals,PayPal Bank 3,$31.40,"$926,557.07"
PayPal Fees,09/22/2023,Deposit,59V91817VH0167112,04 PAYPAL GENERAL UNRESTR,PayPal fees,OFFICE/GENERAL ADMINISTRATIVE EXPENSES:PayPal Fees,PayPal Bank 3,$1.87,"$926,558.94"
PayPal Bank 3,09/22/2023,Deposit,8YG04764AJ853973H,04 PAYPAL GENERAL UNRESTR,"Subject: GeneralPage
Transaction ID: 8YG04764AJ853973H
https://www.paypal.com/activity/payment/8YG04764AJ853973H",PayPal Bank 3,--,$96.62,"$926,655.56"
Donations directed by individuals,09/22/2023,Deposit,8YG04764AJ853973H,04 PAYPAL GENERAL UNRESTR,Support Ukraine - Support Ukraine,Contributed income:Donations directed by individuals,PayPal Bank 3,$100.00,"$926,755.56"
PayPal Fees,09/22/2023,Deposit,8YG04764AJ853973H,04 PAYPAL GENERAL UNRESTR,PayPal fees,OFFICE/GENERAL ADMINISTRATIVE EXPENSES:PayPal Fees,PayPal Bank 3,$3.38,"$926,758.94"
PayPal Bank 3,09/22/2023,Deposit,35828543NT836045K,08 VICTORY DRONES RESTR,"Subject: VICTORY DRONES
Transaction ID: 35828543NT836045K
https://www.paypal.com/activity/payment/35828543NT836045K",PayPal Bank 3,--,$100.00,"$926,858.94"
Donations directed by individuals,09/22/2023,Deposit,35828543NT836045K,08 VICTORY DRONES RESTR,Money in to PayPal,Contributed income:Donations directed by individuals,PayPal Bank 3,$103.48,"$926,962.42"
PayPal Fees,09/22/2023,Deposit,35828543NT836045K,08 VICTORY DRONES RESTR,PayPal fees,OFFICE/GENERAL ADMINISTRATIVE EXPENSES:PayPal Fees,PayPal Bank 3,$3.48,"$926,965.90"
PayPal Bank 3,09/22/2023,Deposit,8UW05977A31013801,04 PAYPAL GENERAL UNRESTR,"Subject: GeneralPage
Transaction ID: 8UW05977A31013801
https://www.paypal.com/activity/payment/8UW05977A31013801",PayPal Bank 3,--,$24.61,"$926,990.51"
Donations directed by individuals,09/22/2023,Deposit,8UW05977A31013801,04 PAYPAL GENERAL UNRESTR,Support Ukraine - Support Ukraine,Contributed income:Donations directed by individuals,PayPal Bank 3,$26.25,"$927,016.76"
PayPal Fees,09/22/2023,Deposit,8UW05977A31013801,04 PAYPAL GENERAL UNRESTR,PayPal fees,OFFICE/GENERAL ADMINISTRATIVE EXPENSES:PayPal Fees,PayPal Bank 3,$1.64,"$927,018.40"
PayPal Bank 3,09/22/2023,Deposit,1YX81155BH655573G,04 PAYPAL GENERAL UNRESTR,"Subject: Support Ukraine
Transaction ID: 1YX81155BH655573G
https://www.paypal.com/activity/payment/1YX81155BH655573G",PayPal Bank 3,--,$9.84,"$927,028.24"
Donations directed by individuals,09/22/2023,Deposit,1YX81155BH655573G,04 PAYPAL GENERAL UNRESTR,Money in to PayPal,Contributed income:Donations directed by individuals,PayPal Bank 3,$10.80,"$927,039.04"
PayPal Fees,09/22/2023,Deposit,1YX81155BH655573G,04 PAYPAL GENERAL UNRESTR,PayPal fees,OFFICE/GENERAL ADMINISTRATIVE EXPENSES:PayPal Fees,PayPal Bank 3,$0.96,"$927,040.00"
PayPal Bank 3,09/22/2023,Deposit,0GR32832JG003733X,04 PAYPAL GENERAL UNRESTR,"Subject: GeneralPage
Transaction ID: 0GR32832JG003733X
https://www.paypal.com/activity/payment/0GR32832JG003733X",PayPal Bank 3,--,$18.63,"$927,058.63"
Donations directed by individuals,09/22/2023,Deposit,0GR32832JG003733X,04 PAYPAL GENERAL UNRESTR,Support Ukraine - Support Ukraine,Contributed income:Donations directed by individuals,PayPal Bank 3,$20.00,"$927,078.63"
PayPal Fees,09/22/2023,Deposit,0GR32832JG003733X,04 PAYPAL GENERAL UNRESTR,PayPal fees,OFFICE/GENERAL ADMINISTRATIVE EXPENSES:PayPal Fees,PayPal Bank 3,$1.37,"$927,080.00"
PayPal Bank 3,09/22/2023,Deposit,0FX81998NC559001L,04 PAYPAL GENERAL UNRESTR,"Subject: GeneralPage
Transaction ID: 0FX81998NC559001L
https://www.paypal.com/activity/payment/0FX81998NC559001L",PayPal Bank 3,--,$100.00,"$927,180.00"
Donations directed by individuals,09/22/2023,Deposit,0FX81998NC559001L,04 PAYPAL GENERAL UNRESTR,Support Ukraine - Support Ukraine,Contributed income:Donations directed by individuals,PayPal Bank 3,$103.48,"$927,283.48"
PayPal Fees,09/22/2023,Deposit,0FX81998NC559001L,04 PAYPAL GENERAL UNRESTR,PayPal fees,OFFICE/GENERAL ADMINISTRATIVE EXPENSES:PayPal Fees,PayPal Bank 3,$3.48,"$927,286.96"
PayPal Bank 3,09/22/2023,Deposit,26U48349N8691404V,07 1000 DRONES RESTR,"Subject: 1000DRONES
Transaction ID: 26U48349N8691404V
https://www.paypal.com/activity/payment/26U48349N8691404V",PayPal Bank 3,--,$100.00,"$927,386.96"
Donations directed by individuals,09/22/2023,Deposit,26U48349N8691404V,07 1000 DRONES RESTR,1000 DRONES FOR UKRAINE - 1000 DRONES FOR UKRAINE,Contributed income:Donations directed by individuals,PayPal Bank 3,$103.48,"$927,490.44"
PayPal Fees,09/22/2023,Deposit,26U48349N8691404V,07 1000 DRONES RESTR,PayPal fees,OFFICE/GENERAL ADMINISTRATIVE EXPENSES:PayPal Fees,PayPal Bank 3,$3.48,"$927,493.92"
PayPal Bank 3,09/22/2023,Deposit,0U202243C1725713D,04 PAYPAL GENERAL UNRESTR,"Subject: GeneralPage
Transaction ID: 0U202243C1725713D
https://www.paypal.com/activity/payment/0U202243C1725713D",PayPal Bank 3,--,$71.22,"$927,565.14"
Donations directed by individuals,09/22/2023,Deposit,0U202243C1725713D,04 PAYPAL GENERAL UNRESTR,Support Ukraine - Support Ukraine,Contributed income:Donations directed by individuals,PayPal Bank 3,$75.00,"$927,640.14"
PayPal Fees,09/22/2023,Deposit,0U202243C1725713D,04 PAYPAL GENERAL UNRESTR,PayPal fees,OFFICE/GENERAL ADMINISTRATIVE EXPENSES:PayPal Fees,PayPal Bank 3,$3.78,"$927,643.92"
PayPal Bank 3,09/22/2023,Deposit,7KC66483C6871271C,04 PAYPAL GENERAL UNRESTR,"Subject: GeneralPage
Transaction ID: 7KC66483C6871271C
https://www.paypal.com/activity/payment/7KC66483C6871271C",PayPal Bank 3,--,$96.62,"$927,740.54"
Donations directed by individuals,09/22/2023,Deposit,7KC66483C6871271C,04 PAYPAL GENERAL UNRESTR,Support Ukraine - Support Ukraine,Contributed income:Donations directed by individuals,PayPal Bank 3,$100.00,"$927,840.54"
PayPal Fees,09/22/2023,Deposit,7KC66483C6871271C,04 PAYPAL GENERAL UNRESTR,PayPal fees,OFFICE/GENERAL ADMINISTRATIVE EXPENSES:PayPal Fees,PayPal Bank 3,$3.38,"$927,843.92"
PayPal Bank 3,09/22/2023,Deposit,4EY366765W4879742,04 PAYPAL GENERAL UNRESTR,"Subject: Support Ukraine
Transaction ID: 4EY366765W4879742
https://www.paypal.com/activity/payment/4EY366765W4879742",PayPal Bank 3,--,$29.53,"$927,873.45"
Donations directed by individuals,09/22/2023,Deposit,4EY366765W4879742,04 PAYPAL GENERAL UNRESTR,Money in to PayPal,Contributed income:Donations directed by individuals,PayPal Bank 3,$31.40,"$927,904.85"
PayPal Fees,09/22/2023,Deposit,4EY366765W4879742,04 PAYPAL GENERAL UNRESTR,PayPal fees,OFFICE/GENERAL ADMINISTRATIVE EXPENSES:PayPal Fees,PayPal Bank 3,$1.87,"$927,906.72"
PayPal Bank 3,09/22/2023,Deposit,7RX28609RA4921907,04 PAYPAL GENERAL UNRESTR,"Subject: GeneralPage
Transaction ID: 7RX28609RA4921907
https://www.paypal.com/activity/payment/7RX28609RA4921907",PayPal Bank 3,--,$50.00,"$927,956.72"
Donations directed by individuals,09/22/2023,Deposit,7RX28609RA4921907,04 PAYPAL GENERAL UNRESTR,Support Ukraine - Support Ukraine,Contributed income:Donations directed by individuals,PayPal Bank 3,$51.99,"$928,008.71"
PayPal Fees,09/22/2023,Deposit,7RX28609RA4921907,04 PAYPAL GENERAL UNRESTR,PayPal fees,OFFICE/GENERAL ADMINISTRATIVE EXPENSES:PayPal Fees,PayPal Bank 3,$1.99,"$928,010.70"
PayPal Bank 3,09/22/2023,Deposit,67G33827KT8589325,04 PAYPAL GENERAL UNRESTR,"Subject: GeneralPage
Transaction ID: 67G33827KT8589325
https://www.paypal.com/activity/payment/67G33827KT8589325",PayPal Bank 3,--,$98.45,"$928,109.15"
Donations directed by individuals,09/22/2023,Deposit,67G33827KT8589325,04 PAYPAL GENERAL UNRESTR,Support Ukraine - Support Ukraine,Contributed income:Donations directed by individuals,PayPal Bank 3,$103.48,"$928,212.63"
PayPal Fees,09/22/2023,Deposit,67G33827KT8589325,04 PAYPAL GENERAL UNRESTR,PayPal fees,OFFICE/GENERAL ADMINISTRATIVE EXPENSES:PayPal Fees,PayPal Bank 3,$5.03,"$928,217.66"
PayPal Bank 3,09/22/2023,Deposit,1K318917DR530935J,04 PAYPAL GENERAL UNRESTR,"Subject: GeneralPage
Transaction ID: 1K318917DR530935J
https://www.paypal.com/activity/payment/1K318917DR530935J",PayPal Bank 3,--,$190.73,"$928,408.39"
Donations directed by individuals,09/22/2023,Deposit,1K318917DR530935J,04 PAYPAL GENERAL UNRESTR,Support Ukraine - Support Ukraine,Contributed income:Donations directed by individuals,PayPal Bank 3,$200.00,"$928,608.39"
PayPal Fees,09/22/2023,Deposit,1K318917DR530935J,04 PAYPAL GENERAL UNRESTR,PayPal fees,OFFICE/GENERAL ADMINISTRATIVE EXPENSES:PayPal Fees,PayPal Bank 3,$9.27,"$928,617.66"
PayPal Bank 3,09/22/2023,Deposit,4WY14105S32898233,07 1000 DRONES RESTR,"Subject: 1000DRONES
Transaction ID: 4WY14105S32898233
https://www.paypal.com/activity/payment/4WY14105S32898233",PayPal Bank 3,--,$250.00,"$928,867.66"
Donations directed by individuals,09/22/2023,Deposit,4WY14105S32898233,07 1000 DRONES RESTR,1000 DRONES FOR UKRAINE - 1000 DRONES FOR UKRAINE,Contributed income:Donations directed by individuals,PayPal Bank 3,$257.94,"$929,125.60"
PayPal Fees,09/22/2023,Deposit,4WY14105S32898233,07 1000 DRONES RESTR,PayPal fees,OFFICE/GENERAL ADMINISTRATIVE EXPENSES:PayPal Fees,PayPal Bank 3,$7.94,"$929,133.54"
PayPal Bank 3,09/22/2023,Deposit,9BY59096T6696433B,04 PAYPAL GENERAL UNRESTR,"Subject: GeneralPage
Transaction ID: 9BY59096T6696433B
https://www.paypal.com/activity/payment/9BY59096T6696433B",PayPal Bank 3,--,$47.31,"$929,180.85"
Donations directed by individuals,09/22/2023,Deposit,9BY59096T6696433B,04 PAYPAL GENERAL UNRESTR,Support Ukraine - Support Ukraine,Contributed income:Donations directed by individuals,PayPal Bank 3,$50.00,"$929,230.85"
PayPal Fees,09/22/2023,Deposit,9BY59096T6696433B,04 PAYPAL GENERAL UNRESTR,PayPal fees,OFFICE/GENERAL ADMINISTRATIVE EXPENSES:PayPal Fees,PayPal Bank 3,$2.69,"$929,233.54"
PayPal Bank 3,09/22/2023,Deposit,5L035265W54789510,04 PAYPAL GENERAL UNRESTR,"Subject: Support Ukraine
Transaction ID: 5L035265W54789510
https://www.paypal.com/activity/payment/5L035265W54789510",PayPal Bank 3,--,$4.29,"$929,237.83"
Donations directed by individuals,09/22/2023,Deposit,5L035265W54789510,04 PAYPAL GENERAL UNRESTR,Money in to PayPal,Contributed income:Donations directed by individuals,PayPal Bank 3,$5.00,"$929,242.83"
PayPal Fees,09/22/2023,Deposit,5L035265W54789510,04 PAYPAL GENERAL UNRESTR,PayPal fees,OFFICE/GENERAL ADMINISTRATIVE EXPENSES:PayPal Fees,PayPal Bank 3,$0.71,"$929,243.54"
PayPal Bank 3,09/22/2023,Deposit,83P51623JL6917910,04 PAYPAL GENERAL UNRESTR,"Subject: GeneralPage
Transaction ID: 83P51623JL6917910
https://www.paypal.com/activity/payment/83P51623JL6917910",PayPal Bank 3,--,$9.22,"$929,252.76"
Donations directed by individuals,09/22/2023,Deposit,83P51623JL6917910,04 PAYPAL GENERAL UNRESTR,Support Ukraine - Support Ukraine,Contributed income:Donations directed by individuals,PayPal Bank 3,$10.00,"$929,262.76"
PayPal Fees,09/22/2023,Deposit,83P51623JL6917910,04 PAYPAL GENERAL UNRESTR,PayPal fees,OFFICE/GENERAL ADMINISTRATIVE EXPENSES:PayPal Fees,PayPal Bank 3,$0.78,"$929,263.54"
PayPal Bank 3,09/22/2023,Deposit,0J522931637712152,04 PAYPAL GENERAL UNRESTR,"Subject: GeneralPage
Note: За каховську ГЕС
Transaction ID: 0J522931637712152
https://www.paypal.com/activity/payment/0J522931637712152",PayPal Bank 3,--,$47.31,"$929,310.85"
Donations directed by individuals,09/22/2023,Deposit,0J522931637712152,04 PAYPAL GENERAL UNRESTR,Support Ukraine - Support Ukraine,Contributed income:Donations directed by individuals,PayPal Bank 3,$50.00,"$929,360.85"
PayPal Fees,09/22/2023,Deposit,0J522931637712152,04 PAYPAL GENERAL UNRESTR,PayPal fees,OFFICE/GENERAL ADMINISTRATIVE EXPENSES:PayPal Fees,PayPal Bank 3,$2.69,"$929,363.54"
PayPal Bank 3,09/22/2023,Deposit,7P867305A14479716,04 PAYPAL GENERAL UNRESTR,"Subject: GeneralPage
Transaction ID: 7P867305A14479716
https://www.paypal.com/activity/payment/7P867305A14479716",PayPal Bank 3,--,$96.62,"$929,460.16"
Donations directed by individuals,09/22/2023,Deposit,7P867305A14479716,04 PAYPAL GENERAL UNRESTR,Support Ukraine - Support Ukraine,Contributed income:Donations directed by individuals,PayPal Bank 3,$100.00,"$929,560.16"
PayPal Fees,09/22/2023,Deposit,7P867305A14479716,04 PAYPAL GENERAL UNRESTR,PayPal fees,OFFICE/GENERAL ADMINISTRATIVE EXPENSES:PayPal Fees,PayPal Bank 3,$3.38,"$929,563.54"
PayPal Bank 3,09/22/2023,Deposit,5L101891VF097534J,04 PAYPAL GENERAL UNRESTR,"Subject: GeneralPage
Transaction ID: 5L101891VF097534J
https://www.paypal.com/activity/payment/5L101891VF097534J",PayPal Bank 3,--,$19.68,"$929,583.22"
Donations directed by individuals,09/22/2023,Deposit,5L101891VF097534J,04 PAYPAL GENERAL UNRESTR,Support Ukraine - Support Ukraine,Contributed income:Donations directed by individuals,PayPal Bank 3,$21.10,"$929,604.32"
PayPal Fees,09/22/2023,Deposit,5L101891VF097534J,04 PAYPAL GENERAL UNRESTR,PayPal fees,OFFICE/GENERAL ADMINISTRATIVE EXPENSES:PayPal Fees,PayPal Bank 3,$1.42,"$929,605.74"
PayPal Bank 3,09/22/2023,Deposit,9J277679X1559944P,04 PAYPAL GENERAL UNRESTR,"Subject: GeneralPage
Transaction ID: 9J277679X1559944P
https://www.paypal.com/activity/payment/9J277679X1559944P",PayPal Bank 3,--,$48.06,"$929,653.80"
Donations directed by individuals,09/22/2023,Deposit,9J277679X1559944P,04 PAYPAL GENERAL UNRESTR,Support Ukraine - Support Ukraine,Contributed income:Donations directed by individuals,PayPal Bank 3,$50.00,"$929,703.80"
PayPal Fees,09/22/2023,Deposit,9J277679X1559944P,04 PAYPAL GENERAL UNRESTR,PayPal fees,OFFICE/GENERAL ADMINISTRATIVE EXPENSES:PayPal Fees,PayPal Bank 3,$1.94,"$929,705.74"
PayPal Bank 3,09/22/2023,Deposit,27D61325PF315034M,04 PAYPAL GENERAL UNRESTR,"Subject: Support Ukraine
Transaction ID: 27D61325PF315034M
https://www.paypal.com/activity/payment/27D61325PF315034M",PayPal Bank 3,--,$68.35,"$929,774.09"
Donations directed by individuals,09/22/2023,Deposit,27D61325PF315034M,04 PAYPAL GENERAL UNRESTR,Money in to PayPal,Contributed income:Donations directed by individuals,PayPal Bank 3,$72.00,"$929,846.09"
PayPal Fees,09/22/2023,Deposit,27D61325PF315034M,04 PAYPAL GENERAL UNRESTR,PayPal fees,OFFICE/GENERAL ADMINISTRATIVE EXPENSES:PayPal Fees,PayPal Bank 3,$3.65,"$929,849.74"
PayPal Bank 3,09/22/2023,Deposit,3D615411NC328620N,04 PAYPAL GENERAL UNRESTR,"Subject: GeneralPage
Transaction ID: 3D615411NC328620N
https://www.paypal.com/activity/payment/3D615411NC328620N",PayPal Bank 3,--,$286.34,"$930,136.08"
Donations directed by individuals,09/22/2023,Deposit,3D615411NC328620N,04 PAYPAL GENERAL UNRESTR,Support Ukraine - Support Ukraine,Contributed income:Donations directed by individuals,PayPal Bank 3,$300.00,"$930,436.08"
PayPal Fees,09/22/2023,Deposit,3D615411NC328620N,04 PAYPAL GENERAL UNRESTR,PayPal fees,OFFICE/GENERAL ADMINISTRATIVE EXPENSES:PayPal Fees,PayPal Bank 3,$13.66,"$930,449.74"
PayPal Bank 3,09/22/2023,Deposit,9SM04788L8134264T,04 PAYPAL GENERAL UNRESTR,"Subject: GeneralPage
Transaction ID: 9SM04788L8134264T
https://www.paypal.com/activity/payment/9SM04788L8134264T",PayPal Bank 3,--,$19.68,"$930,469.42"
Donations directed by individuals,09/22/2023,Deposit,9SM04788L8134264T,04 PAYPAL GENERAL UNRESTR,Support Ukraine - Support Ukraine,Contributed income:Donations directed by individuals,PayPal Bank 3,$21.10,"$930,490.52"
PayPal Fees,09/22/2023,Deposit,9SM04788L8134264T,04 PAYPAL GENERAL UNRESTR,PayPal fees,OFFICE/GENERAL ADMINISTRATIVE EXPENSES:PayPal Fees,PayPal Bank 3,$1.42,"$930,491.94"
PayPal Bank 3,09/22/2023,Deposit,3VR31857FX327203W,04 PAYPAL GENERAL UNRESTR,"Subject: GeneralPage
Transaction ID: 3VR31857FX327203W
https://www.paypal.com/activity/payment/3VR31857FX327203W",PayPal Bank 3,--,$23.79,"$930,515.73"
Donations directed by individuals,09/22/2023,Deposit,3VR31857FX327203W,04 PAYPAL GENERAL UNRESTR,Support Ukraine - Support Ukraine,Contributed income:Donations directed by individuals,PayPal Bank 3,$25.00,"$930,540.73"
PayPal Fees,09/22/2023,Deposit,3VR31857FX327203W,04 PAYPAL GENERAL UNRESTR,PayPal fees,OFFICE/GENERAL ADMINISTRATIVE EXPENSES:PayPal Fees,PayPal Bank 3,$1.21,"$930,541.94"
PayPal Bank 3,09/22/2023,Deposit,9J065511F7745160A,04 PAYPAL GENERAL UNRESTR,"Subject: GeneralPage
Transaction ID: 9J065511F7745160A
https://www.paypal.com/activity/payment/9J065511F7745160A",PayPal Bank 3,--,$98.45,"$930,640.39"
Donations directed by individuals,09/22/2023,Deposit,9J065511F7745160A,04 PAYPAL GENERAL UNRESTR,Support Ukraine - Support Ukraine,Contributed income:Donations directed by individuals,PayPal Bank 3,$103.48,"$930,743.87"
PayPal Fees,09/22/2023,Deposit,9J065511F7745160A,04 PAYPAL GENERAL UNRESTR,PayPal fees,OFFICE/GENERAL ADMINISTRATIVE EXPENSES:PayPal Fees,PayPal Bank 3,$5.03,"$930,748.90"
PayPal Bank 3,09/22/2023,Deposit,89M850298K897471M,04 PAYPAL GENERAL UNRESTR,"Subject: GeneralPage
Transaction ID: 89M850298K897471M
https://www.paypal.com/activity/payment/89M850298K897471M",PayPal Bank 3,--,$96.62,"$930,845.52"
Donations directed by individuals,09/22/2023,Deposit,89M850298K897471M,04 PAYPAL GENERAL UNRESTR,Support Ukraine - Support Ukraine,Contributed income:Donations directed by individuals,PayPal Bank 3,$100.00,"$930,945.52"
PayPal Fees,09/22/2023,Deposit,89M850298K897471M,04 PAYPAL GENERAL UNRESTR,PayPal fees,OFFICE/GENERAL ADMINISTRATIVE EXPENSES:PayPal Fees,PayPal Bank 3,$3.38,"$930,948.90"
PayPal Bank 3,09/22/2023,Deposit,7VG756597L8435920,08 VICTORY DRONES RESTR,"Subject: VictoryDrones
Transaction ID: 7VG756597L8435920
https://www.paypal.com/activity/payment/7VG756597L8435920",PayPal Bank 3,--,$49.22,"$930,998.12"
Donations directed by individuals,09/22/2023,Deposit,7VG756597L8435920,08 VICTORY DRONES RESTR,VICTORY DRONES - VICTORY DRONES,Contributed income:Donations directed by individuals,PayPal Bank 3,$51.99,"$931,050.11"
PayPal Fees,09/22/2023,Deposit,7VG756597L8435920,08 VICTORY DRONES RESTR,PayPal fees,OFFICE/GENERAL ADMINISTRATIVE EXPENSES:PayPal Fees,PayPal Bank 3,$2.77,"$931,052.88"
PayPal Bank 3,09/22/2023,Deposit,38V95782FA5982300,08 VICTORY DRONES RESTR,"Subject: VictoryDrones
Transaction ID: 38V95782FA5982300
https://www.paypal.com/activity/payment/38V95782FA5982300",PayPal Bank 3,--,$98.45,"$931,151.33"
Donations directed by individuals,09/22/2023,Deposit,38V95782FA5982300,08 VICTORY DRONES RESTR,VICTORY DRONES - VICTORY DRONES,Contributed income:Donations directed by individuals,PayPal Bank 3,$103.48,"$931,254.81"
PayPal Fees,09/22/2023,Deposit,38V95782FA5982300,08 VICTORY DRONES RESTR,PayPal fees,OFFICE/GENERAL ADMINISTRATIVE EXPENSES:PayPal Fees,PayPal Bank 3,$5.03,"$931,259.84"
PayPal Bank 3,09/22/2023,Deposit,9AX00673K1318502G,04 PAYPAL GENERAL UNRESTR,"Subject: GeneralPage
Transaction ID: 9AX00673K1318502G
https://www.paypal.com/activity/payment/9AX00673K1318502G",PayPal Bank 3,--,$19.68,"$931,279.52"
Donations directed by individuals,09/22/2023,Deposit,9AX00673K1318502G,04 PAYPAL GENERAL UNRESTR,Support Ukraine - Support Ukraine,Contributed income:Donations directed by individuals,PayPal Bank 3,$21.10,"$931,300.62"
PayPal Fees,09/22/2023,Deposit,9AX00673K1318502G,04 PAYPAL GENERAL UNRESTR,PayPal fees,OFFICE/GENERAL ADMINISTRATIVE EXPENSES:PayPal Fees,PayPal Bank 3,$1.42,"$931,302.04"
PayPal Bank 3,09/22/2023,Deposit,3CR08406DR816450K,04 PAYPAL GENERAL UNRESTR,"Subject: Support Ukraine
Transaction ID: 3CR08406DR816450K
https://www.paypal.com/activity/payment/3CR08406DR816450K",PayPal Bank 3,--,$50.00,"$931,352.04"
Donations directed by individuals,09/22/2023,Deposit,3CR08406DR816450K,04 PAYPAL GENERAL UNRESTR,Money in to PayPal,Contributed income:Donations directed by individuals,PayPal Bank 3,$51.99,"$931,404.03"
PayPal Fees,09/22/2023,Deposit,3CR08406DR816450K,04 PAYPAL GENERAL UNRESTR,PayPal fees,OFFICE/GENERAL ADMINISTRATIVE EXPENSES:PayPal Fees,PayPal Bank 3,$1.99,"$931,406.02"
PayPal Bank 3,09/22/2023,Deposit,8ED51655T7716144C,04 PAYPAL GENERAL UNRESTR,"Subject: GeneralPage
Transaction ID: 8ED51655T7716144C
https://www.paypal.com/activity/payment/8ED51655T7716144C",PayPal Bank 3,--,$14.76,"$931,420.78"
Donations directed by individuals,09/22/2023,Deposit,8ED51655T7716144C,04 PAYPAL GENERAL UNRESTR,Support Ukraine - Support Ukraine,Contributed income:Donations directed by individuals,PayPal Bank 3,$15.95,"$931,436.73"
PayPal Fees,09/22/2023,Deposit,8ED51655T7716144C,04 PAYPAL GENERAL UNRESTR,PayPal fees,OFFICE/GENERAL ADMINISTRATIVE EXPENSES:PayPal Fees,PayPal Bank 3,$1.19,"$931,437.92"
PayPal Bank 3,09/22/2023,Deposit,5TY49338M5779122C,04 PAYPAL GENERAL UNRESTR,"Subject: GeneralPage
Transaction ID: 5TY49338M5779122C
https://www.paypal.com/activity/payment/5TY49338M5779122C",PayPal Bank 3,--,$9.84,"$931,447.76"
Donations directed by individuals,09/22/2023,Deposit,5TY49338M5779122C,04 PAYPAL GENERAL UNRESTR,Support Ukraine - Support Ukraine,Contributed income:Donations directed by individuals,PayPal Bank 3,$10.80,"$931,458.56"
PayPal Fees,09/22/2023,Deposit,5TY49338M5779122C,04 PAYPAL GENERAL UNRESTR,PayPal fees,OFFICE/GENERAL ADMINISTRATIVE EXPENSES:PayPal Fees,PayPal Bank 3,$0.96,"$931,459.52"
PayPal Bank 3,09/22/2023,Deposit,6UY42366219720415,04 PAYPAL GENERAL UNRESTR,"Subject: GeneralPage
Note: Хай пташки літають!
Transaction ID: 6UY42366219720415
https://www.paypal.com/activity/payment/6UY42366219720415",PayPal Bank 3,--,$18.63,"$931,478.15"
Donations directed by individuals,09/22/2023,Deposit,6UY42366219720415,04 PAYPAL GENERAL UNRESTR,Support Ukraine - Support Ukraine,Contributed income:Donations directed by individuals,PayPal Bank 3,$20.00,"$931,498.15"
PayPal Fees,09/22/2023,Deposit,6UY42366219720415,04 PAYPAL GENERAL UNRESTR,PayPal fees,OFFICE/GENERAL ADMINISTRATIVE EXPENSES:PayPal Fees,PayPal Bank 3,$1.37,"$931,499.52"
PayPal Bank 3,09/22/2023,Deposit,853452347D162280C,04 PAYPAL GENERAL UNRESTR,"Subject: GeneralPage
Transaction ID: 853452347D162280C
https://www.paypal.com/activity/payment/853452347D162280C",PayPal Bank 3,--,$49.22,"$931,548.74"
Donations directed by individuals,09/22/2023,Deposit,853452347D162280C,04 PAYPAL GENERAL UNRESTR,Support Ukraine - Support Ukraine,Contributed income:Donations directed by individuals,PayPal Bank 3,$51.99,"$931,600.73"
PayPal Fees,09/22/2023,Deposit,853452347D162280C,04 PAYPAL GENERAL UNRESTR,PayPal fees,OFFICE/GENERAL ADMINISTRATIVE EXPENSES:PayPal Fees,PayPal Bank 3,$2.77,"$931,603.50"
PayPal Bank 3,09/22/2023,Deposit,7B004459K71430428,04 PAYPAL GENERAL UNRESTR,"Subject: GeneralPage
Note: For drones
Transaction ID: 7B004459K71430428
https://www.paypal.com/activity/payment/7B004459K71430428",PayPal Bank 3,--,$9.07,"$931,612.57"
Donations directed by individuals,09/22/2023,Deposit,7B004459K71430428,04 PAYPAL GENERAL UNRESTR,Support Ukraine - Support Ukraine,Contributed income:Donations directed by individuals,PayPal Bank 3,$10.00,"$931,622.57"
PayPal Fees,09/22/2023,Deposit,7B004459K71430428,04 PAYPAL GENERAL UNRESTR,PayPal fees,OFFICE/GENERAL ADMINISTRATIVE EXPENSES:PayPal Fees,PayPal Bank 3,$0.93,"$931,623.50"
PayPal Bank 3,09/22/2023,Deposit,87U90035DD569521H,04 PAYPAL GENERAL UNRESTR,"Subject: GeneralPage
Transaction ID: 87U90035DD569521H
https://www.paypal.com/activity/payment/87U90035DD569521H",PayPal Bank 3,--,$95.12,"$931,718.62"
Donations directed by individuals,09/22/2023,Deposit,87U90035DD569521H,04 PAYPAL GENERAL UNRESTR,Support Ukraine - Support Ukraine,Contributed income:Donations directed by individuals,PayPal Bank 3,$100.00,"$931,818.62"
PayPal Fees,09/22/2023,Deposit,87U90035DD569521H,04 PAYPAL GENERAL UNRESTR,PayPal fees,OFFICE/GENERAL ADMINISTRATIVE EXPENSES:PayPal Fees,PayPal Bank 3,$4.88,"$931,823.50"
PayPal Bank 3,09/22/2023,Deposit,97145798B2760835A,04 PAYPAL GENERAL UNRESTR,"Subject: GeneralPage
Transaction ID: 97145798B2760835A
https://www.paypal.com/activity/payment/97145798B2760835A",PayPal Bank 3,--,$18.76,"$931,842.26"
Donations directed by individuals,09/22/2023,Deposit,97145798B2760835A,04 PAYPAL GENERAL UNRESTR,Support Ukraine - Support Ukraine,Contributed income:Donations directed by individuals,PayPal Bank 3,$20.13,"$931,862.39"
PayPal Fees,09/22/2023,Deposit,97145798B2760835A,04 PAYPAL GENERAL UNRESTR,PayPal fees,OFFICE/GENERAL ADMINISTRATIVE EXPENSES:PayPal Fees,PayPal Bank 3,$1.37,"$931,863.76"
PayPal Bank 3,09/22/2023,Deposit,2PP205596H2017815,04 PAYPAL GENERAL UNRESTR,"Subject: GeneralPage
Transaction ID: 2PP205596H2017815
https://www.paypal.com/activity/payment/2PP205596H2017815",PayPal Bank 3,--,$98.45,"$931,962.21"
Donations directed by individuals,09/22/2023,Deposit,2PP205596H2017815,04 PAYPAL GENERAL UNRESTR,Support Ukraine - Support Ukraine,Contributed income:Donations directed by individuals,PayPal Bank 3,$103.48,"$932,065.69"
PayPal Fees,09/22/2023,Deposit,2PP205596H2017815,04 PAYPAL GENERAL UNRESTR,PayPal fees,OFFICE/GENERAL ADMINISTRATIVE EXPENSES:PayPal Fees,PayPal Bank 3,$5.03,"$932,070.72"
PayPal Bank 3,09/22/2023,Deposit,5SJ16692JX3980733,04 PAYPAL GENERAL UNRESTR,"Subject: GeneralPage
Transaction ID: 5SJ16692JX3980733
https://www.paypal.com/activity/payment/5SJ16692JX3980733",PayPal Bank 3,--,$95.12,"$932,165.84"
Donations directed by individuals,09/22/2023,Deposit,5SJ16692JX3980733,04 PAYPAL GENERAL UNRESTR,Support Ukraine - Support Ukraine,Contributed income:Donations directed by individuals,PayPal Bank 3,$100.00,"$932,265.84"
PayPal Fees,09/22/2023,Deposit,5SJ16692JX3980733,04 PAYPAL GENERAL UNRESTR,PayPal fees,OFFICE/GENERAL ADMINISTRATIVE EXPENSES:PayPal Fees,PayPal Bank 3,$4.88,"$932,270.72"
PayPal Bank 3,09/22/2023,Deposit,414303331B325381E,04 PAYPAL GENERAL UNRESTR,"Subject: GeneralPage
Transaction ID: 414303331B325381E
https://www.paypal.com/activity/payment/414303331B325381E",PayPal Bank 3,--,$49.22,"$932,319.94"
Donations directed by individuals,09/22/2023,Deposit,414303331B325381E,04 PAYPAL GENERAL UNRESTR,Support Ukraine - Support Ukraine,Contributed income:Donations directed by individuals,PayPal Bank 3,$51.99,"$932,371.93"
PayPal Fees,09/22/2023,Deposit,414303331B325381E,04 PAYPAL GENERAL UNRESTR,PayPal fees,OFFICE/GENERAL ADMINISTRATIVE EXPENSES:PayPal Fees,PayPal Bank 3,$2.77,"$932,374.70"
PayPal Bank 3,09/22/2023,Deposit,56912678J0340682A,04 PAYPAL GENERAL UNRESTR,"Subject: GeneralPage
Transaction ID: 56912678J0340682A
https://www.paypal.com/activity/payment/56912678J0340682A",PayPal Bank 3,--,$29.53,"$932,404.23"
Donations directed by individuals,09/22/2023,Deposit,56912678J0340682A,04 PAYPAL GENERAL UNRESTR,Support Ukraine - Support Ukraine,Contributed income:Donations directed by individuals,PayPal Bank 3,$31.40,"$932,435.63"
PayPal Fees,09/22/2023,Deposit,56912678J0340682A,04 PAYPAL GENERAL UNRESTR,PayPal fees,OFFICE/GENERAL ADMINISTRATIVE EXPENSES:PayPal Fees,PayPal Bank 3,$1.87,"$932,437.50"
PayPal Bank 3,09/22/2023,Deposit,8AU693557U5823319,04 PAYPAL GENERAL UNRESTR,"Subject: GeneralPage
Transaction ID: 8AU693557U5823319
https://www.paypal.com/activity/payment/8AU693557U5823319",PayPal Bank 3,--,$23.41,"$932,460.91"
Donations directed by individuals,09/22/2023,Deposit,8AU693557U5823319,04 PAYPAL GENERAL UNRESTR,Support Ukraine - Support Ukraine,Contributed income:Donations directed by individuals,PayPal Bank 3,$25.00,"$932,485.91"
PayPal Fees,09/22/2023,Deposit,8AU693557U5823319,04 PAYPAL GENERAL UNRESTR,PayPal fees,OFFICE/GENERAL ADMINISTRATIVE EXPENSES:PayPal Fees,PayPal Bank 3,$1.59,"$932,487.50"
PayPal Bank 3,09/22/2023,Deposit,1PU57320VG757193X,04 PAYPAL GENERAL UNRESTR,"Subject: GeneralPage
Transaction ID: 1PU57320VG757193X
https://www.paypal.com/activity/payment/1PU57320VG757193X",PayPal Bank 3,--,$193.73,"$932,681.23"
Donations directed by individuals,09/22/2023,Deposit,1PU57320VG757193X,04 PAYPAL GENERAL UNRESTR,Support Ukraine - Support Ukraine,Contributed income:Donations directed by individuals,PayPal Bank 3,$200.00,"$932,881.23"
PayPal Fees,09/22/2023,Deposit,1PU57320VG757193X,04 PAYPAL GENERAL UNRESTR,PayPal fees,OFFICE/GENERAL ADMINISTRATIVE EXPENSES:PayPal Fees,PayPal Bank 3,$6.27,"$932,887.50"
PayPal Bank 3,09/22/2023,Deposit,9HF07209AB748654D,04 PAYPAL GENERAL UNRESTR,"Subject: GeneralPage
Transaction ID: 9HF07209AB748654D
https://www.paypal.com/activity/payment/9HF07209AB748654D",PayPal Bank 3,--,$13.85,"$932,901.35"
Donations directed by individuals,09/22/2023,Deposit,9HF07209AB748654D,04 PAYPAL GENERAL UNRESTR,Support Ukraine - Support Ukraine,Contributed income:Donations directed by individuals,PayPal Bank 3,$15.00,"$932,916.35"
PayPal Fees,09/22/2023,Deposit,9HF07209AB748654D,04 PAYPAL GENERAL UNRESTR,PayPal fees,OFFICE/GENERAL ADMINISTRATIVE EXPENSES:PayPal Fees,PayPal Bank 3,$1.15,"$932,917.50"
PayPal Bank 3,09/22/2023,Deposit,3UE288781G148082U,08 VICTORY DRONES RESTR,"Subject: VictoryDrones
Note: На люті пташки! Дякую за працю!
Transaction ID: 3UE288781G148082U
https://www.paypal.com/activity/payment/3UE288781G148082U",PayPal Bank 3,--,$95.12,"$933,012.62"
Donations directed by individuals,09/22/2023,Deposit,3UE288781G148082U,08 VICTORY DRONES RESTR,VICTORY DRONES - VICTORY DRONES,Contributed income:Donations directed by individuals,PayPal Bank 3,$100.00,"$933,112.62"
PayPal Fees,09/22/2023,Deposit,3UE288781G148082U,08 VICTORY DRONES RESTR,PayPal fees,OFFICE/GENERAL ADMINISTRATIVE EXPENSES:PayPal Fees,PayPal Bank 3,$4.88,"$933,117.50"
PayPal Bank 3,09/22/2023,Deposit,3MC108999N613834D,04 PAYPAL GENERAL UNRESTR,"Subject: GeneralPage
Transaction ID: 3MC108999N613834D
https://www.paypal.com/activity/payment/3MC108999N613834D",PayPal Bank 3,--,$95.12,"$933,212.62"
Donations directed by individuals,09/22/2023,Deposit,3MC108999N613834D,04 PAYPAL GENERAL UNRESTR,Support Ukraine - Support Ukraine,Contributed income:Donations directed by individuals,PayPal Bank 3,$100.00,"$933,312.62"
PayPal Fees,09/22/2023,Deposit,3MC108999N613834D,04 PAYPAL GENERAL UNRESTR,PayPal fees,OFFICE/GENERAL ADMINISTRATIVE EXPENSES:PayPal Fees,PayPal Bank 3,$4.88,"$933,317.50"
PayPal Bank 3,09/22/2023,Deposit,46P43942CU036045U,04 PAYPAL GENERAL UNRESTR,"Subject: GeneralPage
Transaction ID: 46P43942CU036045U
https://www.paypal.com/activity/payment/46P43942CU036045U",PayPal Bank 3,--,$10.00,"$933,327.50"
Donations directed by individuals,09/22/2023,Deposit,46P43942CU036045U,04 PAYPAL GENERAL UNRESTR,Support Ukraine - Support Ukraine,Contributed income:Donations directed by individuals,PayPal Bank 3,$10.80,"$933,338.30"
PayPal Fees,09/22/2023,Deposit,46P43942CU036045U,04 PAYPAL GENERAL UNRESTR,PayPal fees,OFFICE/GENERAL ADMINISTRATIVE EXPENSES:PayPal Fees,PayPal Bank 3,$0.80,"$933,339.10"
PayPal Bank 3,09/22/2023,Deposit,90K96459BH218545B,04 PAYPAL GENERAL UNRESTR,"Subject: Support Ukraine
Transaction ID: 90K96459BH218545B
https://www.paypal.com/activity/payment/90K96459BH218545B",PayPal Bank 3,--,$190.73,"$933,529.83"
Donations directed by individuals,09/22/2023,Deposit,90K96459BH218545B,04 PAYPAL GENERAL UNRESTR,Money in to PayPal,Contributed income:Donations directed by individuals,PayPal Bank 3,$200.00,"$933,729.83"
PayPal Fees,09/22/2023,Deposit,90K96459BH218545B,04 PAYPAL GENERAL UNRESTR,PayPal fees,OFFICE/GENERAL ADMINISTRATIVE EXPENSES:PayPal Fees,PayPal Bank 3,$9.27,"$933,739.10"
PayPal Bank 3,09/22/2023,Deposit,72T026395J0754219,04 PAYPAL GENERAL UNRESTR,"Subject: GeneralPage
Note: На пташечки
Transaction ID: 72T026395J0754219
https://www.paypal.com/activity/payment/72T026395J0754219",PayPal Bank 3,--,$50.00,"$933,789.10"
Donations directed by individuals,09/22/2023,Deposit,72T026395J0754219,04 PAYPAL GENERAL UNRESTR,Support Ukraine - Support Ukraine,Contributed income:Donations directed by individuals,PayPal Bank 3,$51.99,"$933,841.09"
PayPal Fees,09/22/2023,Deposit,72T026395J0754219,04 PAYPAL GENERAL UNRESTR,PayPal fees,OFFICE/GENERAL ADMINISTRATIVE EXPENSES:PayPal Fees,PayPal Bank 3,$1.99,"$933,843.08"
PayPal Bank 3,09/22/2023,Deposit,6PH47666TJ3417207,04 PAYPAL GENERAL UNRESTR,"Subject: GeneralPage
Transaction ID: 6PH47666TJ3417207
https://www.paypal.com/activity/payment/6PH47666TJ3417207",PayPal Bank 3,--,$50.00,"$933,893.08"
Donations directed by individuals,09/22/2023,Deposit,6PH47666TJ3417207,04 PAYPAL GENERAL UNRESTR,Support Ukraine - Support Ukraine,Contributed income:Donations directed by individuals,PayPal Bank 3,$51.99,"$933,945.07"
PayPal Fees,09/22/2023,Deposit,6PH47666TJ3417207,04 PAYPAL GENERAL UNRESTR,PayPal fees,OFFICE/GENERAL ADMINISTRATIVE EXPENSES:PayPal Fees,PayPal Bank 3,$1.99,"$933,947.06"
PayPal Bank 3,09/22/2023,Deposit,2KA19732R7523321V,04 PAYPAL GENERAL UNRESTR,"Subject: GeneralPage
Transaction ID: 2KA19732R7523321V
https://www.paypal.com/activity/payment/2KA19732R7523321V",PayPal Bank 3,--,$96.62,"$934,043.68"
Donations directed by individuals,09/22/2023,Deposit,2KA19732R7523321V,04 PAYPAL GENERAL UNRESTR,Support Ukraine - Support Ukraine,Contributed income:Donations directed by individuals,PayPal Bank 3,$100.00,"$934,143.68"
PayPal Fees,09/22/2023,Deposit,2KA19732R7523321V,04 PAYPAL GENERAL UNRESTR,PayPal fees,OFFICE/GENERAL ADMINISTRATIVE EXPENSES:PayPal Fees,PayPal Bank 3,$3.38,"$934,147.06"
PayPal Bank 3,09/22/2023,Deposit,5DB37045AL169863W,04 PAYPAL GENERAL UNRESTR,"Subject: GeneralPage
Note: Help for Ukraine - drones or radio
Transaction ID: 5DB37045AL169863W
https://www.paypal.com/activity/payment/5DB37045AL169863W",PayPal Bank 3,--,$95.12,"$934,242.18"
Donations directed by individuals,09/22/2023,Deposit,5DB37045AL169863W,04 PAYPAL GENERAL UNRESTR,Support Ukraine - Support Ukraine,Contributed income:Donations directed by individuals,PayPal Bank 3,$100.00,"$934,342.18"
PayPal Fees,09/22/2023,Deposit,5DB37045AL169863W,04 PAYPAL GENERAL UNRESTR,PayPal fees,OFFICE/GENERAL ADMINISTRATIVE EXPENSES:PayPal Fees,PayPal Bank 3,$4.88,"$934,347.06"
PayPal Bank 3,09/22/2023,Deposit,58A88861VY7752320,04 PAYPAL GENERAL UNRESTR,"Subject: GeneralPage
Transaction ID: 58A88861VY7752320
https://www.paypal.com/activity/payment/58A88861VY7752320",PayPal Bank 3,--,$9.84,"$934,356.90"
Donations directed by individuals,09/22/2023,Deposit,58A88861VY7752320,04 PAYPAL GENERAL UNRESTR,Support Ukraine - Support Ukraine,Contributed income:Donations directed by individuals,PayPal Bank 3,$10.80,"$934,367.70"
PayPal Fees,09/22/2023,Deposit,58A88861VY7752320,04 PAYPAL GENERAL UNRESTR,PayPal fees,OFFICE/GENERAL ADMINISTRATIVE EXPENSES:PayPal Fees,PayPal Bank 3,$0.96,"$934,368.66"
PayPal Bank 3,09/22/2023,Deposit,9F6850864E080283U,04 PAYPAL GENERAL UNRESTR,"Subject: GeneralPage
Note: Slava Ukraine ❤️
Transaction ID: 9F6850864E080283U
https://www.paypal.com/activity/payment/9F6850864E080283U",PayPal Bank 3,--,$18.93,"$934,387.59"
Donations directed by individuals,09/22/2023,Deposit,9F6850864E080283U,04 PAYPAL GENERAL UNRESTR,Support Ukraine - Support Ukraine,Contributed income:Donations directed by individuals,PayPal Bank 3,$20.00,"$934,407.59"
PayPal Fees,09/22/2023,Deposit,9F6850864E080283U,04 PAYPAL GENERAL UNRESTR,PayPal fees,OFFICE/GENERAL ADMINISTRATIVE EXPENSES:PayPal Fees,PayPal Bank 3,$1.07,"$934,408.66"
PayPal Bank 3,09/22/2023,Deposit,70E00914XW750962K,04 PAYPAL GENERAL UNRESTR,"Subject: GeneralPage
Transaction ID: 70E00914XW750962K
https://www.paypal.com/activity/payment/70E00914XW750962K",PayPal Bank 3,--,$24.61,"$934,433.27"
Donations directed by individuals,09/22/2023,Deposit,70E00914XW750962K,04 PAYPAL GENERAL UNRESTR,Support Ukraine - Support Ukraine,Contributed income:Donations directed by individuals,PayPal Bank 3,$26.25,"$934,459.52"
PayPal Fees,09/22/2023,Deposit,70E00914XW750962K,04 PAYPAL GENERAL UNRESTR,PayPal fees,OFFICE/GENERAL ADMINISTRATIVE EXPENSES:PayPal Fees,PayPal Bank 3,$1.64,"$934,461.16"
PayPal Bank 3,09/22/2023,Deposit,5M177173B1671941H,04 PAYPAL GENERAL UNRESTR,"Subject: GeneralPage
Transaction ID: 5M177173B1671941H
https://www.paypal.com/activity/payment/5M177173B1671941H",PayPal Bank 3,--,$13.85,"$934,475.01"
Donations directed by individuals,09/22/2023,Deposit,5M177173B1671941H,04 PAYPAL GENERAL UNRESTR,Support Ukraine - Support Ukraine,Contributed income:Donations directed by individuals,PayPal Bank 3,$15.00,"$934,490.01"
PayPal Fees,09/22/2023,Deposit,5M177173B1671941H,04 PAYPAL GENERAL UNRESTR,PayPal fees,OFFICE/GENERAL ADMINISTRATIVE EXPENSES:PayPal Fees,PayPal Bank 3,$1.15,"$934,491.16"
PayPal Bank 3,09/22/2023,Deposit,4RV58857WK9494144,04 PAYPAL GENERAL UNRESTR,"Subject: GeneralPage
Transaction ID: 4RV58857WK9494144
https://www.paypal.com/activity/payment/4RV58857WK9494144",PayPal Bank 3,--,$24.61,"$934,515.77"
Donations directed by individuals,09/22/2023,Deposit,4RV58857WK9494144,04 PAYPAL GENERAL UNRESTR,Support Ukraine - Support Ukraine,Contributed income:Donations directed by individuals,PayPal Bank 3,$26.25,"$934,542.02"
PayPal Fees,09/22/2023,Deposit,4RV58857WK9494144,04 PAYPAL GENERAL UNRESTR,PayPal fees,OFFICE/GENERAL ADMINISTRATIVE EXPENSES:PayPal Fees,PayPal Bank 3,$1.64,"$934,543.66"
PayPal Bank 3,09/22/2023,Deposit,9ND56190CP450130E,04 PAYPAL GENERAL UNRESTR,"Subject: GeneralPage
Transaction ID: 9ND56190CP450130E
https://www.paypal.com/activity/payment/9ND56190CP450130E",PayPal Bank 3,--,$47.31,"$934,590.97"
Donations directed by individuals,09/22/2023,Deposit,9ND56190CP450130E,04 PAYPAL GENERAL UNRESTR,Support Ukraine - Support Ukraine,Contributed income:Donations directed by individuals,PayPal Bank 3,$50.00,"$934,640.97"
PayPal Fees,09/22/2023,Deposit,9ND56190CP450130E,04 PAYPAL GENERAL UNRESTR,PayPal fees,OFFICE/GENERAL ADMINISTRATIVE EXPENSES:PayPal Fees,PayPal Bank 3,$2.69,"$934,643.66"
PayPal Bank 3,09/22/2023,Deposit,0LL03304GU8545620,04 PAYPAL GENERAL UNRESTR,"Subject: Support Ukraine
Transaction ID: 0LL03304GU8545620
https://www.paypal.com/activity/payment/0LL03304GU8545620",PayPal Bank 3,--,$18.63,"$934,662.29"
Donations directed by individuals,09/22/2023,Deposit,0LL03304GU8545620,04 PAYPAL GENERAL UNRESTR,Money in to PayPal,Contributed income:Donations directed by individuals,PayPal Bank 3,$20.00,"$934,682.29"
PayPal Fees,09/22/2023,Deposit,0LL03304GU8545620,04 PAYPAL GENERAL UNRESTR,PayPal fees,OFFICE/GENERAL ADMINISTRATIVE EXPENSES:PayPal Fees,PayPal Bank 3,$1.37,"$934,683.66"
PayPal Bank 3,09/22/2023,Deposit,2EA43382GT479102T,04 PAYPAL GENERAL UNRESTR,"Subject: GeneralPage
Transaction ID: 2EA43382GT479102T
https://www.paypal.com/activity/payment/2EA43382GT479102T",PayPal Bank 3,--,$246.13,"$934,929.79"
Donations directed by individuals,09/22/2023,Deposit,2EA43382GT479102T,04 PAYPAL GENERAL UNRESTR,Support Ukraine - Support Ukraine,Contributed income:Donations directed by individuals,PayPal Bank 3,$257.94,"$935,187.73"
PayPal Fees,09/22/2023,Deposit,2EA43382GT479102T,04 PAYPAL GENERAL UNRESTR,PayPal fees,OFFICE/GENERAL ADMINISTRATIVE EXPENSES:PayPal Fees,PayPal Bank 3,$11.81,"$935,199.54"
PayPal Bank 3,09/22/2023,Deposit,8SA8264220360823G,04 PAYPAL GENERAL UNRESTR,"Subject: GeneralPage
Transaction ID: 8SA8264220360823G
https://www.paypal.com/activity/payment/8SA8264220360823G",PayPal Bank 3,--,$95.12,"$935,294.66"
Donations directed by individuals,09/22/2023,Deposit,8SA8264220360823G,04 PAYPAL GENERAL UNRESTR,Support Ukraine - Support Ukraine,Contributed income:Donations directed by individuals,PayPal Bank 3,$100.00,"$935,394.66"
PayPal Fees,09/22/2023,Deposit,8SA8264220360823G,04 PAYPAL GENERAL UNRESTR,PayPal fees,OFFICE/GENERAL ADMINISTRATIVE EXPENSES:PayPal Fees,PayPal Bank 3,$4.88,"$935,399.54"
PayPal Bank 3,09/22/2023,Deposit,87L899984U9956309,04 PAYPAL GENERAL UNRESTR,"Subject: GeneralPage
Transaction ID: 87L899984U9956309
https://www.paypal.com/activity/payment/87L899984U9956309",PayPal Bank 3,--,$9.07,"$935,408.61"
Donations directed by individuals,09/22/2023,Deposit,87L899984U9956309,04 PAYPAL GENERAL UNRESTR,Support Ukraine - Support Ukraine,Contributed income:Donations directed by individuals,PayPal Bank 3,$10.00,"$935,418.61"
PayPal Fees,09/22/2023,Deposit,87L899984U9956309,04 PAYPAL GENERAL UNRESTR,PayPal fees,OFFICE/GENERAL ADMINISTRATIVE EXPENSES:PayPal Fees,PayPal Bank 3,$0.93,"$935,419.54"
PayPal Bank 3,09/22/2023,Deposit,3EE149827L948903F,04 PAYPAL GENERAL UNRESTR,"Subject: Support Ukraine
Transaction ID: 3EE149827L948903F
https://www.paypal.com/activity/payment/3EE149827L948903F",PayPal Bank 3,--,$47.31,"$935,466.85"
Donations directed by individuals,09/22/2023,Deposit,3EE149827L948903F,04 PAYPAL GENERAL UNRESTR,Money in to PayPal,Contributed income:Donations directed by individuals,PayPal Bank 3,$50.00,"$935,516.85"
PayPal Fees,09/22/2023,Deposit,3EE149827L948903F,04 PAYPAL GENERAL UNRESTR,PayPal fees,OFFICE/GENERAL ADMINISTRATIVE EXPENSES:PayPal Fees,PayPal Bank 3,$2.69,"$935,519.54"
PayPal Bank 3,09/22/2023,Deposit,3MH71497NY926132G,04 PAYPAL GENERAL UNRESTR,"Subject: GeneralPage
Transaction ID: 3MH71497NY926132G
https://www.paypal.com/activity/payment/3MH71497NY926132G",PayPal Bank 3,--,$193.73,"$935,713.27"
Donations directed by individuals,09/22/2023,Deposit,3MH71497NY926132G,04 PAYPAL GENERAL UNRESTR,Support Ukraine - Support Ukraine,Contributed income:Donations directed by individuals,PayPal Bank 3,$200.00,"$935,913.27"
PayPal Fees,09/22/2023,Deposit,3MH71497NY926132G,04 PAYPAL GENERAL UNRESTR,PayPal fees,OFFICE/GENERAL ADMINISTRATIVE EXPENSES:PayPal Fees,PayPal Bank 3,$6.27,"$935,919.54"
PayPal Bank 3,09/22/2023,Deposit,3Y275421TU271090K,09 MSU RESTR,"Subject: MobileShowers
Transaction ID: 3Y275421TU271090K
https://www.paypal.com/activity/payment/3Y275421TU271090K",PayPal Bank 3,--,$100.00,"$936,019.54"
Donations directed by individuals,09/22/2023,Deposit,3Y275421TU271090K,09 MSU RESTR,Mobile Shower/Laundry Units - Mobile Shower/Laundry Units,Contributed income:Donations directed by individuals,PayPal Bank 3,$103.48,"$936,123.02"
PayPal Fees,09/22/2023,Deposit,3Y275421TU271090K,09 MSU RESTR,PayPal fees,OFFICE/GENERAL ADMINISTRATIVE EXPENSES:PayPal Fees,PayPal Bank 3,$3.48,"$936,126.50"
PayPal Bank 3,09/22/2023,Deposit,933013636F959612X,04 PAYPAL GENERAL UNRESTR,"Subject: Support Ukraine
Transaction ID: 933013636F959612X
https://www.paypal.com/activity/payment/933013636F959612X",PayPal Bank 3,--,$23.41,"$936,149.91"
Donations directed by individuals,09/22/2023,Deposit,933013636F959612X,04 PAYPAL GENERAL UNRESTR,Money in to PayPal,Contributed income:Donations directed by individuals,PayPal Bank 3,$25.00,"$936,174.91"
PayPal Fees,09/22/2023,Deposit,933013636F959612X,04 PAYPAL GENERAL UNRESTR,PayPal fees,OFFICE/GENERAL ADMINISTRATIVE EXPENSES:PayPal Fees,PayPal Bank 3,$1.59,"$936,176.50"
PayPal Bank 3,09/22/2023,Deposit,4YG83299GG0176530,09 MSU RESTR,"Subject: GeneralPage
Transaction ID: 4YG83299GG0176530
https://www.paypal.com/activity/payment/4YG83299GG0176530",PayPal Bank 3,--,$48.06,"$936,224.56"
Donations directed by individuals,09/22/2023,Deposit,4YG83299GG0176530,09 MSU RESTR,Support Ukraine - Support Ukraine,Contributed income:Donations directed by individuals,PayPal Bank 3,$50.00,"$936,274.56"
PayPal Fees,09/22/2023,Deposit,4YG83299GG0176530,09 MSU RESTR,PayPal fees,OFFICE/GENERAL ADMINISTRATIVE EXPENSES:PayPal Fees,PayPal Bank 3,$1.94,"$936,276.50"
PayPal Bank 3,09/22/2023,Deposit,38N23025HS018782L,04 PAYPAL GENERAL UNRESTR,"Subject: GeneralPage
Note: Слава Україні!
Transaction ID: 38N23025HS018782L
https://www.paypal.com/activity/payment/38N23025HS018782L",PayPal Bank 3,--,$50.00,"$936,326.50"
Donations directed by individuals,09/22/2023,Deposit,38N23025HS018782L,04 PAYPAL GENERAL UNRESTR,Support Ukraine - Support Ukraine,Contributed income:Donations directed by individuals,PayPal Bank 3,$51.99,"$936,378.49"
PayPal Fees,09/22/2023,Deposit,38N23025HS018782L,04 PAYPAL GENERAL UNRESTR,PayPal fees,OFFICE/GENERAL ADMINISTRATIVE EXPENSES:PayPal Fees,PayPal Bank 3,$1.99,"$936,380.48"
PayPal Bank 3,09/22/2023,Deposit,43X98245N2932501D,04 PAYPAL GENERAL UNRESTR,"Subject: Support Ukraine
Transaction ID: 43X98245N2932501D
https://www.paypal.com/activity/payment/43X98245N2932501D",PayPal Bank 3,--,$4.91,"$936,385.39"
Donations directed by individuals,09/22/2023,Deposit,43X98245N2932501D,04 PAYPAL GENERAL UNRESTR,Money in to PayPal,Contributed income:Donations directed by individuals,PayPal Bank 3,$5.65,"$936,391.04"
PayPal Fees,09/22/2023,Deposit,43X98245N2932501D,04 PAYPAL GENERAL UNRESTR,PayPal fees,OFFICE/GENERAL ADMINISTRATIVE EXPENSES:PayPal Fees,PayPal Bank 3,$0.74,"$936,391.78"
PayPal Bank 3,09/22/2023,Deposit,23R43660FN024563C,04 PAYPAL GENERAL UNRESTR,"Subject: GeneralPage
Transaction ID: 23R43660FN024563C
https://www.paypal.com/activity/payment/23R43660FN024563C",PayPal Bank 3,--,$49.22,"$936,441.00"
Donations directed by individuals,09/22/2023,Deposit,23R43660FN024563C,04 PAYPAL GENERAL UNRESTR,Support Ukraine - Support Ukraine,Contributed income:Donations directed by individuals,PayPal Bank 3,$51.99,"$936,492.99"
PayPal Fees,09/22/2023,Deposit,23R43660FN024563C,04 PAYPAL GENERAL UNRESTR,PayPal fees,OFFICE/GENERAL ADMINISTRATIVE EXPENSES:PayPal Fees,PayPal Bank 3,$2.77,"$936,495.76"
PayPal Bank 3,09/22/2023,Deposit,3VK61968UR1073010,04 PAYPAL GENERAL UNRESTR,"Subject: GeneralPage
Transaction ID: 3VK61968UR1073010
https://www.paypal.com/activity/payment/3VK61968UR1073010",PayPal Bank 3,--,$190.73,"$936,686.49"
Donations directed by individuals,09/22/2023,Deposit,3VK61968UR1073010,04 PAYPAL GENERAL UNRESTR,Support Ukraine - Support Ukraine,Contributed income:Donations directed by individuals,PayPal Bank 3,$200.00,"$936,886.49"
PayPal Fees,09/22/2023,Deposit,3VK61968UR1073010,04 PAYPAL GENERAL UNRESTR,PayPal fees,OFFICE/GENERAL ADMINISTRATIVE EXPENSES:PayPal Fees,PayPal Bank 3,$9.27,"$936,895.76"
PayPal Bank 3,09/22/2023,Deposit,1A210650DX088314C,07 1000 DRONES RESTR,"Subject: 1000DRONES
Transaction ID: 1A210650DX088314C
https://www.paypal.com/activity/payment/1A210650DX088314C",PayPal Bank 3,--,$50.00,"$936,945.76"
Donations directed by individuals,09/22/2023,Deposit,1A210650DX088314C,07 1000 DRONES RESTR,1000 DRONES FOR UKRAINE - 1000 DRONES FOR UKRAINE,Contributed income:Donations directed by individuals,PayPal Bank 3,$51.99,"$936,997.75"
PayPal Fees,09/22/2023,Deposit,1A210650DX088314C,07 1000 DRONES RESTR,PayPal fees,OFFICE/GENERAL ADMINISTRATIVE EXPENSES:PayPal Fees,PayPal Bank 3,$1.99,"$936,999.74"
PayPal Bank 3,09/22/2023,Deposit,4TJ49546GW744433W,04 PAYPAL GENERAL UNRESTR,"Subject: GeneralPage
Transaction ID: 4TJ49546GW744433W
https://www.paypal.com/activity/payment/4TJ49546GW744433W",PayPal Bank 3,--,$104.68,"$937,104.42"
Donations directed by individuals,09/22/2023,Deposit,4TJ49546GW744433W,04 PAYPAL GENERAL UNRESTR,Support Ukraine - Support Ukraine,Contributed income:Donations directed by individuals,PayPal Bank 3,$110.00,"$937,214.42"
PayPal Fees,09/22/2023,Deposit,4TJ49546GW744433W,04 PAYPAL GENERAL UNRESTR,PayPal fees,OFFICE/GENERAL ADMINISTRATIVE EXPENSES:PayPal Fees,PayPal Bank 3,$5.32,"$937,219.74"
PayPal Bank 3,09/22/2023,Deposit,3R024815SV016750A,07 1000 DRONES RESTR,"Subject: 1000DRONES
Transaction ID: 3R024815SV016750A
https://www.paypal.com/activity/payment/3R024815SV016750A",PayPal Bank 3,--,$485.06,"$937,704.80"
Donations directed by individuals,09/22/2023,Deposit,3R024815SV016750A,07 1000 DRONES RESTR,1000 DRONES FOR UKRAINE - 1000 DRONES FOR UKRAINE,Contributed income:Donations directed by individuals,PayPal Bank 3,$500.00,"$938,204.80"
PayPal Fees,09/22/2023,Deposit,3R024815SV016750A,07 1000 DRONES RESTR,PayPal fees,OFFICE/GENERAL ADMINISTRATIVE EXPENSES:PayPal Fees,PayPal Bank 3,$14.94,"$938,219.74"
PayPal Bank 3,09/22/2023,Deposit,8YG70447UN707292J,04 PAYPAL GENERAL UNRESTR,"Subject: GeneralPage
Transaction ID: 8YG70447UN707292J
https://www.paypal.com/activity/payment/8YG70447UN707292J",PayPal Bank 3,--,$98.45,"$938,318.19"
Donations directed by individuals,09/22/2023,Deposit,8YG70447UN707292J,04 PAYPAL GENERAL UNRESTR,Support Ukraine - Support Ukraine,Contributed income:Donations directed by individuals,PayPal Bank 3,$103.48,"$938,421.67"
PayPal Fees,09/22/2023,Deposit,8YG70447UN707292J,04 PAYPAL GENERAL UNRESTR,PayPal fees,OFFICE/GENERAL ADMINISTRATIVE EXPENSES:PayPal Fees,PayPal Bank 3,$5.03,"$938,426.70"
PayPal Bank 3,09/22/2023,Deposit,94S80313GK159122L,07 1000 DRONES RESTR,"Subject: 1000DRONES
Transaction ID: 94S80313GK159122L
https://www.paypal.com/activity/payment/94S80313GK159122L",PayPal Bank 3,--,$30.00,"$938,456.70"
Donations directed by individuals,09/22/2023,Deposit,94S80313GK159122L,07 1000 DRONES RESTR,1000 DRONES FOR UKRAINE - 1000 DRONES FOR UKRAINE,Contributed income:Donations directed by individuals,PayPal Bank 3,$31.40,"$938,488.10"
PayPal Fees,09/22/2023,Deposit,94S80313GK159122L,07 1000 DRONES RESTR,PayPal fees,OFFICE/GENERAL ADMINISTRATIVE EXPENSES:PayPal Fees,PayPal Bank 3,$1.40,"$938,489.50"
PayPal Bank 3,09/22/2023,Deposit,5TP56504HG723925L,04 PAYPAL GENERAL UNRESTR,"Subject: GeneralPage
Note: На розйоб русні
Transaction ID: 5TP56504HG723925L
https://www.paypal.com/activity/payment/5TP56504HG723925L",PayPal Bank 3,--,$1.96,"$938,491.46"
Donations directed by individuals,09/22/2023,Deposit,5TP56504HG723925L,04 PAYPAL GENERAL UNRESTR,Support Ukraine - Support Ukraine,Contributed income:Donations directed by individuals,PayPal Bank 3,$2.56,"$938,494.02"
PayPal Fees,09/22/2023,Deposit,5TP56504HG723925L,04 PAYPAL GENERAL UNRESTR,PayPal fees,OFFICE/GENERAL ADMINISTRATIVE EXPENSES:PayPal Fees,PayPal Bank 3,$0.60,"$938,494.62"
PayPal Bank 3,09/22/2023,Deposit,1P586973JW076711V,04 PAYPAL GENERAL UNRESTR,"Subject: Support Ukraine
Transaction ID: 1P586973JW076711V
https://www.paypal.com/activity/payment/1P586973JW076711V",PayPal Bank 3,--,$50.00,"$938,544.62"
Donations directed by individuals,09/22/2023,Deposit,1P586973JW076711V,04 PAYPAL GENERAL UNRESTR,Money in to PayPal,Contributed income:Donations directed by individuals,PayPal Bank 3,$51.99,"$938,596.61"
PayPal Fees,09/22/2023,Deposit,1P586973JW076711V,04 PAYPAL GENERAL UNRESTR,PayPal fees,OFFICE/GENERAL ADMINISTRATIVE EXPENSES:PayPal Fees,PayPal Bank 3,$1.99,"$938,598.60"
PayPal Bank 3,09/22/2023,Deposit,1EN810864A212381U,04 PAYPAL GENERAL UNRESTR,"Subject: GeneralPage
Transaction ID: 1EN810864A212381U
https://www.paypal.com/activity/payment/1EN810864A212381U",PayPal Bank 3,--,$29.53,"$938,628.13"
Donations directed by individuals,09/22/2023,Deposit,1EN810864A212381U,04 PAYPAL GENERAL UNRESTR,Support Ukraine - Support Ukraine,Contributed income:Donations directed by individuals,PayPal Bank 3,$31.40,"$938,659.53"
PayPal Fees,09/22/2023,Deposit,1EN810864A212381U,04 PAYPAL GENERAL UNRESTR,PayPal fees,OFFICE/GENERAL ADMINISTRATIVE EXPENSES:PayPal Fees,PayPal Bank 3,$1.87,"$938,661.40"
PayPal Bank 3,09/22/2023,Deposit,9J793337BU701825D,04 PAYPAL GENERAL UNRESTR,"Subject: GeneralPage
Transaction ID: 9J793337BU701825D
https://www.paypal.com/activity/payment/9J793337BU701825D",PayPal Bank 3,--,$48.06,"$938,709.46"
Donations directed by individuals,09/22/2023,Deposit,9J793337BU701825D,04 PAYPAL GENERAL UNRESTR,Support Ukraine - Support Ukraine,Contributed income:Donations directed by individuals,PayPal Bank 3,$50.00,"$938,759.46"
PayPal Fees,09/22/2023,Deposit,9J793337BU701825D,04 PAYPAL GENERAL UNRESTR,PayPal fees,OFFICE/GENERAL ADMINISTRATIVE EXPENSES:PayPal Fees,PayPal Bank 3,$1.94,"$938,761.40"
PayPal Bank 3,09/22/2023,Deposit,0UG62099W7571541M,04 PAYPAL GENERAL UNRESTR,"Subject: GeneralPage
Transaction ID: 0UG62099W7571541M
https://www.paypal.com/activity/payment/0UG62099W7571541M",PayPal Bank 3,--,$96.62,"$938,858.02"
Donations directed by individuals,09/22/2023,Deposit,0UG62099W7571541M,04 PAYPAL GENERAL UNRESTR,Support Ukraine - Support Ukraine,Contributed income:Donations directed by individuals,PayPal Bank 3,$100.00,"$938,958.02"
PayPal Fees,09/22/2023,Deposit,0UG62099W7571541M,04 PAYPAL GENERAL UNRESTR,PayPal fees,OFFICE/GENERAL ADMINISTRATIVE EXPENSES:PayPal Fees,PayPal Bank 3,$3.38,"$938,961.40"
PayPal Bank 3,09/22/2023,Deposit,64926847BA042831F,07 1000 DRONES RESTR,"Subject: 1000DRONES
Transaction ID: 64926847BA042831F
https://www.paypal.com/activity/payment/64926847BA042831F",PayPal Bank 3,--,$100.00,"$939,061.40"
Donations directed by individuals,09/22/2023,Deposit,64926847BA042831F,07 1000 DRONES RESTR,1000 DRONES FOR UKRAINE - 1000 DRONES FOR UKRAINE,Contributed income:Donations directed by individuals,PayPal Bank 3,$103.48,"$939,164.88"
PayPal Fees,09/22/2023,Deposit,64926847BA042831F,07 1000 DRONES RESTR,PayPal fees,OFFICE/GENERAL ADMINISTRATIVE EXPENSES:PayPal Fees,PayPal Bank 3,$3.48,"$939,168.36"
PayPal Bank 3,09/22/2023,Deposit,1VY12512D1706093V,04 PAYPAL GENERAL UNRESTR,"Subject: Support Ukraine
Transaction ID: 1VY12512D1706093V
https://www.paypal.com/activity/payment/1VY12512D1706093V",PayPal Bank 3,--,$25.00,"$939,193.36"
Donations directed by individuals,09/22/2023,Deposit,1VY12512D1706093V,04 PAYPAL GENERAL UNRESTR,Money in to PayPal,Contributed income:Donations directed by individuals,PayPal Bank 3,$26.25,"$939,219.61"
PayPal Fees,09/22/2023,Deposit,1VY12512D1706093V,04 PAYPAL GENERAL UNRESTR,PayPal fees,OFFICE/GENERAL ADMINISTRATIVE EXPENSES:PayPal Fees,PayPal Bank 3,$1.25,"$939,220.86"
PayPal Bank 3,09/22/2023,Deposit,2V324450U79310835,04 PAYPAL GENERAL UNRESTR,"Subject: GeneralPage
Transaction ID: 2V324450U79310835
https://www.paypal.com/activity/payment/2V324450U79310835",PayPal Bank 3,--,$477.56,"$939,698.42"
Donations directed by individuals,09/22/2023,Deposit,2V324450U79310835,04 PAYPAL GENERAL UNRESTR,Support Ukraine - Support Ukraine,Contributed income:Donations directed by individuals,PayPal Bank 3,$500.00,"$940,198.42"
PayPal Fees,09/22/2023,Deposit,2V324450U79310835,04 PAYPAL GENERAL UNRESTR,PayPal fees,OFFICE/GENERAL ADMINISTRATIVE EXPENSES:PayPal Fees,PayPal Bank 3,$22.44,"$940,220.86"
PayPal Bank 3,09/22/2023,Deposit,9BE87499MP656021M,04 PAYPAL GENERAL UNRESTR,"Subject: GeneralPage
Transaction ID: 9BE87499MP656021M
https://www.paypal.com/activity/payment/9BE87499MP656021M",PayPal Bank 3,--,$18.63,"$940,239.49"
Donations directed by individuals,09/22/2023,Deposit,9BE87499MP656021M,04 PAYPAL GENERAL UNRESTR,Support Ukraine - Support Ukraine,Contributed income:Donations directed by individuals,PayPal Bank 3,$20.00,"$940,259.49"
PayPal Fees,09/22/2023,Deposit,9BE87499MP656021M,04 PAYPAL GENERAL UNRESTR,PayPal fees,OFFICE/GENERAL ADMINISTRATIVE EXPENSES:PayPal Fees,PayPal Bank 3,$1.37,"$940,260.86"
PayPal Bank 3,09/22/2023,Deposit,8CW76394AE185454U,04 PAYPAL GENERAL UNRESTR,"Subject: GeneralPage
Transaction ID: 8CW76394AE185454U
https://www.paypal.com/activity/payment/8CW76394AE185454U",PayPal Bank 3,--,$9.84,"$940,270.70"
Donations directed by individuals,09/22/2023,Deposit,8CW76394AE185454U,04 PAYPAL GENERAL UNRESTR,Support Ukraine - Support Ukraine,Contributed income:Donations directed by individuals,PayPal Bank 3,$10.80,"$940,281.50"
PayPal Fees,09/22/2023,Deposit,8CW76394AE185454U,04 PAYPAL GENERAL UNRESTR,PayPal fees,OFFICE/GENERAL ADMINISTRATIVE EXPENSES:PayPal Fees,PayPal Bank 3,$0.96,"$940,282.46"
PayPal Bank 3,09/22/2023,Deposit,12061336V30498904,04 PAYPAL GENERAL UNRESTR,"Subject: GeneralPage
Transaction ID: 12061336V30498904
https://www.paypal.com/activity/payment/12061336V30498904",PayPal Bank 3,--,$49.22,"$940,331.68"
Donations directed by individuals,09/22/2023,Deposit,12061336V30498904,04 PAYPAL GENERAL UNRESTR,Support Ukraine - Support Ukraine,Contributed income:Donations directed by individuals,PayPal Bank 3,$51.99,"$940,383.67"
PayPal Fees,09/22/2023,Deposit,12061336V30498904,04 PAYPAL GENERAL UNRESTR,PayPal fees,OFFICE/GENERAL ADMINISTRATIVE EXPENSES:PayPal Fees,PayPal Bank 3,$2.77,"$940,386.44"
PayPal Bank 3,09/22/2023,Deposit,4TC19961LB341443A,04 PAYPAL GENERAL UNRESTR,"Subject: GeneralPage
Transaction ID: 4TC19961LB341443A
https://www.paypal.com/activity/payment/4TC19961LB341443A",PayPal Bank 3,--,$95.12,"$940,481.56"
Donations directed by individuals,09/22/2023,Deposit,4TC19961LB341443A,04 PAYPAL GENERAL UNRESTR,Support Ukraine - Support Ukraine,Contributed income:Donations directed by individuals,PayPal Bank 3,$100.00,"$940,581.56"
PayPal Fees,09/22/2023,Deposit,4TC19961LB341443A,04 PAYPAL GENERAL UNRESTR,PayPal fees,OFFICE/GENERAL ADMINISTRATIVE EXPENSES:PayPal Fees,PayPal Bank 3,$4.88,"$940,586.44"
PayPal Bank 3,09/22/2023,Deposit,31Y41334UW849574P,07 1000 DRONES RESTR,"Subject: 1000DRONES
Note: Happy Birthday Dobrum Lyudyam :)
Transaction ID: 31Y41334UW849574P
https://www.paypal.com/activity/payment/31Y41334UW849574P",PayPal Bank 3,--,$40.00,"$940,626.44"
Donations directed by individuals,09/22/2023,Deposit,31Y41334UW849574P,07 1000 DRONES RESTR,1000 DRONES FOR UKRAINE - 1000 DRONES FOR UKRAINE,Contributed income:Donations directed by individuals,PayPal Bank 3,$41.69,"$940,668.13"
PayPal Fees,09/22/2023,Deposit,31Y41334UW849574P,07 1000 DRONES RESTR,PayPal fees,OFFICE/GENERAL ADMINISTRATIVE EXPENSES:PayPal Fees,PayPal Bank 3,$1.69,"$940,669.82"
PayPal Bank 3,09/22/2023,Deposit,7AE81890CU825733A,04 PAYPAL GENERAL UNRESTR,"Subject: GeneralPage
Transaction ID: 7AE81890CU825733A
https://www.paypal.com/activity/payment/7AE81890CU825733A",PayPal Bank 3,--,$100.00,"$940,769.82"
Donations directed by individuals,09/22/2023,Deposit,7AE81890CU825733A,04 PAYPAL GENERAL UNRESTR,Support Ukraine - Support Ukraine,Contributed income:Donations directed by individuals,PayPal Bank 3,$103.48,"$940,873.30"
PayPal Fees,09/22/2023,Deposit,7AE81890CU825733A,04 PAYPAL GENERAL UNRESTR,PayPal fees,OFFICE/GENERAL ADMINISTRATIVE EXPENSES:PayPal Fees,PayPal Bank 3,$3.48,"$940,876.78"
PayPal Bank 3,09/22/2023,Deposit,80X74463L92161906,07 1000 DRONES RESTR,"Subject: 1000DRONES
Note: For Alex Sin birthday
Transaction ID: 80X74463L92161906
https://www.paypal.com/activity/payment/80X74463L92161906",PayPal Bank 3,--,$23.79,"$940,900.57"
Donations directed by individuals,09/22/2023,Deposit,80X74463L92161906,07 1000 DRONES RESTR,1000 DRONES FOR UKRAINE - 1000 DRONES FOR UKRAINE,Contributed income:Donations directed by individuals,PayPal Bank 3,$25.00,"$940,925.57"
PayPal Fees,09/22/2023,Deposit,80X74463L92161906,07 1000 DRONES RESTR,PayPal fees,OFFICE/GENERAL ADMINISTRATIVE EXPENSES:PayPal Fees,PayPal Bank 3,$1.21,"$940,926.78"
PayPal Bank 3,09/22/2023,Deposit,4VP96622E72548730,04 PAYPAL GENERAL UNRESTR,"Subject: GeneralPage
Transaction ID: 4VP96622E72548730
https://www.paypal.com/activity/payment/4VP96622E72548730",PayPal Bank 3,--,$4.29,"$940,931.07"
Donations directed by individuals,09/22/2023,Deposit,4VP96622E72548730,04 PAYPAL GENERAL UNRESTR,Support Ukraine - Support Ukraine,Contributed income:Donations directed by individuals,PayPal Bank 3,$5.00,"$940,936.07"
PayPal Fees,09/22/2023,Deposit,4VP96622E72548730,04 PAYPAL GENERAL UNRESTR,PayPal fees,OFFICE/GENERAL ADMINISTRATIVE EXPENSES:PayPal Fees,PayPal Bank 3,$0.71,"$940,936.78"
PayPal Bank 3,09/22/2023,Deposit,44929002AD129390N,04 PAYPAL GENERAL UNRESTR,"Subject: GeneralPage
Transaction ID: 44929002AD129390N
https://www.paypal.com/activity/payment/44929002AD129390N",PayPal Bank 3,--,$190.73,"$941,127.51"
Donations directed by individuals,09/22/2023,Deposit,44929002AD129390N,04 PAYPAL GENERAL UNRESTR,Support Ukraine - Support Ukraine,Contributed income:Donations directed by individuals,PayPal Bank 3,$200.00,"$941,327.51"
PayPal Fees,09/22/2023,Deposit,44929002AD129390N,04 PAYPAL GENERAL UNRESTR,PayPal fees,OFFICE/GENERAL ADMINISTRATIVE EXPENSES:PayPal Fees,PayPal Bank 3,$9.27,"$941,336.78"
PayPal Bank 3,09/22/2023,Deposit,7UG99699TP456293N,04 PAYPAL GENERAL UNRESTR,"Subject: GeneralPage
Transaction ID: 7UG99699TP456293N
https://www.paypal.com/activity/payment/7UG99699TP456293N",PayPal Bank 3,--,$49.22,"$941,386.00"
Donations directed by individuals,09/22/2023,Deposit,7UG99699TP456293N,04 PAYPAL GENERAL UNRESTR,Support Ukraine - Support Ukraine,Contributed income:Donations directed by individuals,PayPal Bank 3,$51.99,"$941,437.99"
PayPal Fees,09/22/2023,Deposit,7UG99699TP456293N,04 PAYPAL GENERAL UNRESTR,PayPal fees,OFFICE/GENERAL ADMINISTRATIVE EXPENSES:PayPal Fees,PayPal Bank 3,$2.77,"$941,440.76"
PayPal Bank 3,09/22/2023,Deposit,1PY3008272369630N,07 1000 DRONES RESTR,"Subject: 1000DRONES
Transaction ID: 1PY3008272369630N
https://www.paypal.com/activity/payment/1PY3008272369630N",PayPal Bank 3,--,$19.68,"$941,460.44"
Donations directed by individuals,09/22/2023,Deposit,1PY3008272369630N,07 1000 DRONES RESTR,1000 DRONES FOR UKRAINE - 1000 DRONES FOR UKRAINE,Contributed income:Donations directed by individuals,PayPal Bank 3,$21.10,"$941,481.54"
PayPal Fees,09/22/2023,Deposit,1PY3008272369630N,07 1000 DRONES RESTR,PayPal fees,OFFICE/GENERAL ADMINISTRATIVE EXPENSES:PayPal Fees,PayPal Bank 3,$1.42,"$941,482.96"
PayPal Bank 3,09/22/2023,Deposit,77354439399152731,08 VICTORY DRONES RESTR,"Subject: GeneralPage
Note: Для пташок.   Діаспора з Wilmington
Transaction ID: 77354439399152731
https://www.paypal.com/activity/payment/77354439399152731",PayPal Bank 3,--,$40.00,"$941,522.96"
Donations directed by individuals,09/22/2023,Deposit,77354439399152731,08 VICTORY DRONES RESTR,Support Ukraine - Support Ukraine,Contributed income:Donations directed by individuals,PayPal Bank 3,$41.69,"$941,564.65"
PayPal Fees,09/22/2023,Deposit,77354439399152731,08 VICTORY DRONES RESTR,PayPal fees,OFFICE/GENERAL ADMINISTRATIVE EXPENSES:PayPal Fees,PayPal Bank 3,$1.69,"$941,566.34"
PayPal Bank 3,09/22/2023,Deposit,7B674732TH0898947,04 PAYPAL GENERAL UNRESTR,"Subject: GeneralPage
Transaction ID: 7B674732TH0898947
https://www.paypal.com/activity/payment/7B674732TH0898947",PayPal Bank 3,--,$190.73,"$941,757.07"
Donations directed by individuals,09/22/2023,Deposit,7B674732TH0898947,04 PAYPAL GENERAL UNRESTR,Support Ukraine - Support Ukraine,Contributed income:Donations directed by individuals,PayPal Bank 3,$200.00,"$941,957.07"
PayPal Fees,09/22/2023,Deposit,7B674732TH0898947,04 PAYPAL GENERAL UNRESTR,PayPal fees,OFFICE/GENERAL ADMINISTRATIVE EXPENSES:PayPal Fees,PayPal Bank 3,$9.27,"$941,966.34"
PayPal Bank 3,09/22/2023,Deposit,2LK79528LY325854Y,04 PAYPAL GENERAL UNRESTR,"Subject: GeneralPage
Transaction ID: 2LK79528LY325854Y
https://www.paypal.com/activity/payment/2LK79528LY325854Y",PayPal Bank 3,--,$47.31,"$942,013.65"
Donations directed by individuals,09/22/2023,Deposit,2LK79528LY325854Y,04 PAYPAL GENERAL UNRESTR,Support Ukraine - Support Ukraine,Contributed income:Donations directed by individuals,PayPal Bank 3,$50.00,"$942,063.65"
PayPal Fees,09/22/2023,Deposit,2LK79528LY325854Y,04 PAYPAL GENERAL UNRESTR,PayPal fees,OFFICE/GENERAL ADMINISTRATIVE EXPENSES:PayPal Fees,PayPal Bank 3,$2.69,"$942,066.34"
PayPal Bank 3,09/22/2023,Deposit,9G934766W9725003J,07 1000 DRONES RESTR,"Subject: 1000DRONES
Transaction ID: 9G934766W9725003J
https://www.paypal.com/activity/payment/9G934766W9725003J",PayPal Bank 3,--,$50.00,"$942,116.34"
Donations directed by individuals,09/22/2023,Deposit,9G934766W9725003J,07 1000 DRONES RESTR,1000 DRONES FOR UKRAINE - 1000 DRONES FOR UKRAINE,Contributed income:Donations directed by individuals,PayPal Bank 3,$51.99,"$942,168.33"
PayPal Fees,09/22/2023,Deposit,9G934766W9725003J,07 1000 DRONES RESTR,PayPal fees,OFFICE/GENERAL ADMINISTRATIVE EXPENSES:PayPal Fees,PayPal Bank 3,$1.99,"$942,170.32"
PayPal Bank 3,09/22/2023,Deposit,9P575095S0707893U,08 VICTORY DRONES RESTR,"Subject: VictoryDrones
Transaction ID: 9P575095S0707893U
https://www.paypal.com/activity/payment/9P575095S0707893U",PayPal Bank 3,--,$98.45,"$942,268.77"
Donations directed by individuals,09/22/2023,Deposit,9P575095S0707893U,08 VICTORY DRONES RESTR,VICTORY DRONES - VICTORY DRONES,Contributed income:Donations directed by individuals,PayPal Bank 3,$103.48,"$942,372.25"
PayPal Fees,09/22/2023,Deposit,9P575095S0707893U,08 VICTORY DRONES RESTR,PayPal fees,OFFICE/GENERAL ADMINISTRATIVE EXPENSES:PayPal Fees,PayPal Bank 3,$5.03,"$942,377.28"
PayPal Bank 3,09/22/2023,Deposit,6G954126L3575832M,04 PAYPAL GENERAL UNRESTR,"Subject: GeneralPage
Transaction ID: 6G954126L3575832M
https://www.paypal.com/activity/payment/6G954126L3575832M",PayPal Bank 3,--,$14.76,"$942,392.04"
Donations directed by individuals,09/22/2023,Deposit,6G954126L3575832M,04 PAYPAL GENERAL UNRESTR,Support Ukraine - Support Ukraine,Contributed income:Donations directed by individuals,PayPal Bank 3,$15.95,"$942,407.99"
PayPal Fees,09/22/2023,Deposit,6G954126L3575832M,04 PAYPAL GENERAL UNRESTR,PayPal fees,OFFICE/GENERAL ADMINISTRATIVE EXPENSES:PayPal Fees,PayPal Bank 3,$1.19,"$942,409.18"
PayPal Bank 3,09/22/2023,Deposit,3KR46468JV4599338,04 PAYPAL GENERAL UNRESTR,"Subject: GeneralPage
Note: На захист неньки і смерть ворогам
Transaction ID: 3KR46468JV4599338
https://www.paypal.com/activity/payment/3KR46468JV4599338",PayPal Bank 3,--,$286.34,"$942,695.52"
Donations directed by individuals,09/22/2023,Deposit,3KR46468JV4599338,04 PAYPAL GENERAL UNRESTR,Support Ukraine - Support Ukraine,Contributed income:Donations directed by individuals,PayPal Bank 3,$300.00,"$942,995.52"
PayPal Fees,09/22/2023,Deposit,3KR46468JV4599338,04 PAYPAL GENERAL UNRESTR,PayPal fees,OFFICE/GENERAL ADMINISTRATIVE EXPENSES:PayPal Fees,PayPal Bank 3,$13.66,"$943,009.18"
PayPal Bank 3,09/22/2023,Deposit,90G567415Y0551113,04 PAYPAL GENERAL UNRESTR,"Subject: GeneralPage
Transaction ID: 90G567415Y0551113
https://www.paypal.com/activity/payment/90G567415Y0551113",PayPal Bank 3,--,$492.26,"$943,501.44"
Donations directed by individuals,09/22/2023,Deposit,90G567415Y0551113,04 PAYPAL GENERAL UNRESTR,Support Ukraine - Support Ukraine,Contributed income:Donations directed by individuals,PayPal Bank 3,$515.38,"$944,016.82"
PayPal Fees,09/22/2023,Deposit,90G567415Y0551113,04 PAYPAL GENERAL UNRESTR,PayPal fees,OFFICE/GENERAL ADMINISTRATIVE EXPENSES:PayPal Fees,PayPal Bank 3,$23.12,"$944,039.94"
PayPal Bank 3,09/22/2023,Deposit,2GG145851S285642R,04 PAYPAL GENERAL UNRESTR,"Subject: Support Ukraine
Transaction ID: 2GG145851S285642R
https://www.paypal.com/activity/payment/2GG145851S285642R",PayPal Bank 3,--,$20.75,"$944,060.69"
Donations directed by individuals,09/22/2023,Deposit,2GG145851S285642R,04 PAYPAL GENERAL UNRESTR,Money in to PayPal,Contributed income:Donations directed by individuals,PayPal Bank 3,$22.22,"$944,082.91"
PayPal Fees,09/22/2023,Deposit,2GG145851S285642R,04 PAYPAL GENERAL UNRESTR,PayPal fees,OFFICE/GENERAL ADMINISTRATIVE EXPENSES:PayPal Fees,PayPal Bank 3,$1.47,"$944,084.38"
PayPal Bank 3,09/22/2023,Deposit,5RK9538353502761E,07 1000 DRONES RESTR,"Subject: 1000DRONES
Transaction ID: 5RK9538353502761E
https://www.paypal.com/activity/payment/5RK9538353502761E",PayPal Bank 3,--,$20.00,"$944,104.38"
Donations directed by individuals,09/22/2023,Deposit,5RK9538353502761E,07 1000 DRONES RESTR,1000 DRONES FOR UKRAINE - 1000 DRONES FOR UKRAINE,Contributed income:Donations directed by individuals,PayPal Bank 3,$21.10,"$944,125.48"
PayPal Fees,09/22/2023,Deposit,5RK9538353502761E,07 1000 DRONES RESTR,PayPal fees,OFFICE/GENERAL ADMINISTRATIVE EXPENSES:PayPal Fees,PayPal Bank 3,$1.10,"$944,126.58"
PayPal Bank 3,09/22/2023,Deposit,5EW10668BX6467119,04 PAYPAL GENERAL UNRESTR,"Subject: GeneralPage
Transaction ID: 5EW10668BX6467119
https://www.paypal.com/activity/payment/5EW10668BX6467119",PayPal Bank 3,--,$196.91,"$944,323.49"
Donations directed by individuals,09/22/2023,Deposit,5EW10668BX6467119,04 PAYPAL GENERAL UNRESTR,Support Ukraine - Support Ukraine,Contributed income:Donations directed by individuals,PayPal Bank 3,$206.46,"$944,529.95"
PayPal Fees,09/22/2023,Deposit,5EW10668BX6467119,04 PAYPAL GENERAL UNRESTR,PayPal fees,OFFICE/GENERAL ADMINISTRATIVE EXPENSES:PayPal Fees,PayPal Bank 3,$9.55,"$944,539.50"
PayPal Bank 3,09/22/2023,Deposit,41790330R17771809,07 1000 DRONES RESTR,"Subject: 1000DRONES
Transaction ID: 41790330R17771809
https://www.paypal.com/activity/payment/41790330R17771809",PayPal Bank 3,--,$49.22,"$944,588.72"
Donations directed by individuals,09/22/2023,Deposit,41790330R17771809,07 1000 DRONES RESTR,1000 DRONES FOR UKRAINE - 1000 DRONES FOR UKRAINE,Contributed income:Donations directed by individuals,PayPal Bank 3,$51.99,"$944,640.71"
PayPal Fees,09/22/2023,Deposit,41790330R17771809,07 1000 DRONES RESTR,PayPal fees,OFFICE/GENERAL ADMINISTRATIVE EXPENSES:PayPal Fees,PayPal Bank 3,$2.77,"$944,643.48"
PayPal Bank 3,09/22/2023,Deposit,0UB37905AY493961X,04 PAYPAL GENERAL UNRESTR,"Subject: GeneralPage
Transaction ID: 0UB37905AY493961X
https://www.paypal.com/activity/payment/0UB37905AY493961X",PayPal Bank 3,--,$295.36,"$944,938.84"
Donations directed by individuals,09/22/2023,Deposit,0UB37905AY493961X,04 PAYPAL GENERAL UNRESTR,Support Ukraine - Support Ukraine,Contributed income:Donations directed by individuals,PayPal Bank 3,$309.43,"$945,248.27"
PayPal Fees,09/22/2023,Deposit,0UB37905AY493961X,04 PAYPAL GENERAL UNRESTR,PayPal fees,OFFICE/GENERAL ADMINISTRATIVE EXPENSES:PayPal Fees,PayPal Bank 3,$14.07,"$945,262.34"
PayPal Bank 3,09/22/2023,Deposit,2A623416958046331,04 PAYPAL GENERAL UNRESTR,"Subject: GeneralPage
Transaction ID: 2A623416958046331
https://www.paypal.com/activity/payment/2A623416958046331",PayPal Bank 3,--,$98.45,"$945,360.79"
Donations directed by individuals,09/22/2023,Deposit,2A623416958046331,04 PAYPAL GENERAL UNRESTR,Support Ukraine - Support Ukraine,Contributed income:Donations directed by individuals,PayPal Bank 3,$103.48,"$945,464.27"
PayPal Fees,09/22/2023,Deposit,2A623416958046331,04 PAYPAL GENERAL UNRESTR,PayPal fees,OFFICE/GENERAL ADMINISTRATIVE EXPENSES:PayPal Fees,PayPal Bank 3,$5.03,"$945,469.30"
PayPal Bank 3,09/22/2023,Deposit,6JT50752VR228990E,04 PAYPAL GENERAL UNRESTR,"Subject: GeneralPage
Transaction ID: 6JT50752VR228990E
https://www.paypal.com/activity/payment/6JT50752VR228990E",PayPal Bank 3,--,$49.22,"$945,518.52"
Donations directed by individuals,09/22/2023,Deposit,6JT50752VR228990E,04 PAYPAL GENERAL UNRESTR,Support Ukraine - Support Ukraine,Contributed income:Donations directed by individuals,PayPal Bank 3,$51.99,"$945,570.51"
PayPal Fees,09/22/2023,Deposit,6JT50752VR228990E,04 PAYPAL GENERAL UNRESTR,PayPal fees,OFFICE/GENERAL ADMINISTRATIVE EXPENSES:PayPal Fees,PayPal Bank 3,$2.77,"$945,573.28"
PayPal Bank 3,09/22/2023,Deposit,76427796F4886732T,04 PAYPAL GENERAL UNRESTR,"Subject: GeneralPage
Transaction ID: 76427796F4886732T
https://www.paypal.com/activity/payment/76427796F4886732T",PayPal Bank 3,--,$19.68,"$945,592.96"
Donations directed by individuals,09/22/2023,Deposit,76427796F4886732T,04 PAYPAL GENERAL UNRESTR,Support Ukraine - Support Ukraine,Contributed income:Donations directed by individuals,PayPal Bank 3,$21.10,"$945,614.06"
PayPal Fees,09/22/2023,Deposit,76427796F4886732T,04 PAYPAL GENERAL UNRESTR,PayPal fees,OFFICE/GENERAL ADMINISTRATIVE EXPENSES:PayPal Fees,PayPal Bank 3,$1.42,"$945,615.48"
PayPal Bank 3,09/22/2023,Deposit,40R47565WH287543R,07 1000 DRONES RESTR,"Subject: 1000DRONES
Transaction ID: 40R47565WH287543R
https://www.paypal.com/activity/payment/40R47565WH287543R",PayPal Bank 3,--,$25.00,"$945,640.48"
Donations directed by individuals,09/22/2023,Deposit,40R47565WH287543R,07 1000 DRONES RESTR,1000 DRONES FOR UKRAINE - 1000 DRONES FOR UKRAINE,Contributed income:Donations directed by individuals,PayPal Bank 3,$26.25,"$945,666.73"
PayPal Fees,09/22/2023,Deposit,40R47565WH287543R,07 1000 DRONES RESTR,PayPal fees,OFFICE/GENERAL ADMINISTRATIVE EXPENSES:PayPal Fees,PayPal Bank 3,$1.25,"$945,667.98"
PayPal Bank 3,09/22/2023,Deposit,04M605240N4612641,07 1000 DRONES RESTR,"Subject: 1000DRONES
Transaction ID: 04M605240N4612641
https://www.paypal.com/activity/payment/04M605240N4612641",PayPal Bank 3,--,$50.00,"$945,717.98"
Donations directed by individuals,09/22/2023,Deposit,04M605240N4612641,07 1000 DRONES RESTR,1000 DRONES FOR UKRAINE - 1000 DRONES FOR UKRAINE,Contributed income:Donations directed by individuals,PayPal Bank 3,$51.99,"$945,769.97"
PayPal Fees,09/22/2023,Deposit,04M605240N4612641,07 1000 DRONES RESTR,PayPal fees,OFFICE/GENERAL ADMINISTRATIVE EXPENSES:PayPal Fees,PayPal Bank 3,$1.99,"$945,771.96"
PayPal Bank 3,09/22/2023,Deposit,5F331525YL878060N,07 1000 DRONES RESTR,"Subject: 1000DRONES
Note: До перемоги .   Захисти вас Господь
Transaction ID: 5F331525YL878060N
https://www.paypal.com/activity/payment/5F331525YL878060N",PayPal Bank 3,--,$20.54,"$945,792.50"
Donations directed by individuals,09/22/2023,Deposit,5F331525YL878060N,07 1000 DRONES RESTR,1000 DRONES FOR UKRAINE - 1000 DRONES FOR UKRAINE,Contributed income:Donations directed by individuals,PayPal Bank 3,$22.00,"$945,814.50"
PayPal Fees,09/22/2023,Deposit,5F331525YL878060N,07 1000 DRONES RESTR,PayPal fees,OFFICE/GENERAL ADMINISTRATIVE EXPENSES:PayPal Fees,PayPal Bank 3,$1.46,"$945,815.96"
PayPal Bank 3,09/22/2023,Deposit,2YV724471U767473C,04 PAYPAL GENERAL UNRESTR,"Subject: GeneralPage
Transaction ID: 2YV724471U767473C
https://www.paypal.com/activity/payment/2YV724471U767473C",PayPal Bank 3,--,$9.84,"$945,825.80"
Donations directed by individuals,09/22/2023,Deposit,2YV724471U767473C,04 PAYPAL GENERAL UNRESTR,Support Ukraine - Support Ukraine,Contributed income:Donations directed by individuals,PayPal Bank 3,$10.80,"$945,836.60"
PayPal Fees,09/22/2023,Deposit,2YV724471U767473C,04 PAYPAL GENERAL UNRESTR,PayPal fees,OFFICE/GENERAL ADMINISTRATIVE EXPENSES:PayPal Fees,PayPal Bank 3,$0.96,"$945,837.56"
PayPal Bank 3,09/22/2023,Deposit,2N036370EX9879348,04 PAYPAL GENERAL UNRESTR,"Subject: GeneralPage
Transaction ID: 2N036370EX9879348
https://www.paypal.com/activity/payment/2N036370EX9879348",PayPal Bank 3,--,$85.00,"$945,922.56"
Donations directed by individuals,09/22/2023,Deposit,2N036370EX9879348,04 PAYPAL GENERAL UNRESTR,Support Ukraine - Support Ukraine,Contributed income:Donations directed by individuals,PayPal Bank 3,$88.03,"$946,010.59"
PayPal Fees,09/22/2023,Deposit,2N036370EX9879348,04 PAYPAL GENERAL UNRESTR,PayPal fees,OFFICE/GENERAL ADMINISTRATIVE EXPENSES:PayPal Fees,PayPal Bank 3,$3.03,"$946,013.62"
PayPal Bank 3,09/22/2023,Deposit,89M342361N1415036,07 1000 DRONES RESTR,"Subject: 1000DRONES
Note: Supplies for Ukrainian Heroes
Transaction ID: 89M342361N1415036
https://www.paypal.com/activity/payment/89M342361N1415036",PayPal Bank 3,--,$14.76,"$946,028.38"
Donations directed by individuals,09/22/2023,Deposit,89M342361N1415036,07 1000 DRONES RESTR,1000 DRONES FOR UKRAINE - 1000 DRONES FOR UKRAINE,Contributed income:Donations directed by individuals,PayPal Bank 3,$15.95,"$946,044.33"
PayPal Fees,09/22/2023,Deposit,89M342361N1415036,07 1000 DRONES RESTR,PayPal fees,OFFICE/GENERAL ADMINISTRATIVE EXPENSES:PayPal Fees,PayPal Bank 3,$1.19,"$946,045.52"
PayPal Bank 3,09/22/2023,Deposit,66H69369S39122140,07 1000 DRONES RESTR,"Subject: 1000DRONES
Transaction ID: 66H69369S39122140
https://www.paypal.com/activity/payment/66H69369S39122140",PayPal Bank 3,--,$48.06,"$946,093.58"
Donations directed by individuals,09/22/2023,Deposit,66H69369S39122140,07 1000 DRONES RESTR,1000 DRONES FOR UKRAINE - 1000 DRONES FOR UKRAINE,Contributed income:Donations directed by individuals,PayPal Bank 3,$50.00,"$946,143.58"
PayPal Fees,09/22/2023,Deposit,66H69369S39122140,07 1000 DRONES RESTR,PayPal fees,OFFICE/GENERAL ADMINISTRATIVE EXPENSES:PayPal Fees,PayPal Bank 3,$1.94,"$946,145.52"
PayPal Bank 3,09/22/2023,Deposit,66D03025GH5580734,07 1000 DRONES RESTR,"Subject: 1000DRONES
Transaction ID: 66D03025GH5580734
https://www.paypal.com/activity/payment/66D03025GH5580734",PayPal Bank 3,--,$9.22,"$946,154.74"
Donations directed by individuals,09/22/2023,Deposit,66D03025GH5580734,07 1000 DRONES RESTR,1000 DRONES FOR UKRAINE - 1000 DRONES FOR UKRAINE,Contributed income:Donations directed by individuals,PayPal Bank 3,$10.00,"$946,164.74"
PayPal Fees,09/22/2023,Deposit,66D03025GH5580734,07 1000 DRONES RESTR,PayPal fees,OFFICE/GENERAL ADMINISTRATIVE EXPENSES:PayPal Fees,PayPal Bank 3,$0.78,"$946,165.52"
PayPal Bank 3,09/22/2023,Deposit,42X80841FM761911U,07 1000 DRONES RESTR,"Subject: 1000DRONES
Transaction ID: 42X80841FM761911U
https://www.paypal.com/activity/payment/42X80841FM761911U",PayPal Bank 3,--,$5.00,"$946,170.52"
Donations directed by individuals,09/22/2023,Deposit,42X80841FM761911U,07 1000 DRONES RESTR,1000 DRONES FOR UKRAINE - 1000 DRONES FOR UKRAINE,Contributed income:Donations directed by individuals,PayPal Bank 3,$5.65,"$946,176.17"
PayPal Fees,09/22/2023,Deposit,42X80841FM761911U,07 1000 DRONES RESTR,PayPal fees,OFFICE/GENERAL ADMINISTRATIVE EXPENSES:PayPal Fees,PayPal Bank 3,$0.65,"$946,176.82"
PayPal Bank 3,09/22/2023,Deposit,29J78079EY463291S,04 PAYPAL GENERAL UNRESTR,"Subject: GeneralPage
Transaction ID: 29J78079EY463291S
https://www.paypal.com/activity/payment/29J78079EY463291S",PayPal Bank 3,--,$49.22,"$946,226.04"
Donations directed by individuals,09/22/2023,Deposit,29J78079EY463291S,04 PAYPAL GENERAL UNRESTR,Support Ukraine - Support Ukraine,Contributed income:Donations directed by individuals,PayPal Bank 3,$51.99,"$946,278.03"
PayPal Fees,09/22/2023,Deposit,29J78079EY463291S,04 PAYPAL GENERAL UNRESTR,PayPal fees,OFFICE/GENERAL ADMINISTRATIVE EXPENSES:PayPal Fees,PayPal Bank 3,$2.77,"$946,280.80"
PayPal Bank 3,09/22/2023,Deposit,62538682VW9006506,04 PAYPAL GENERAL UNRESTR,"Subject: GeneralPage
Transaction ID: 62538682VW9006506
https://www.paypal.com/activity/payment/62538682VW9006506",PayPal Bank 3,--,$96.62,"$946,377.42"
Donations directed by individuals,09/22/2023,Deposit,62538682VW9006506,04 PAYPAL GENERAL UNRESTR,Support Ukraine - Support Ukraine,Contributed income:Donations directed by individuals,PayPal Bank 3,$100.00,"$946,477.42"
PayPal Fees,09/22/2023,Deposit,62538682VW9006506,04 PAYPAL GENERAL UNRESTR,PayPal fees,OFFICE/GENERAL ADMINISTRATIVE EXPENSES:PayPal Fees,PayPal Bank 3,$3.38,"$946,480.80"
PayPal Bank 3,09/22/2023,Deposit,72565085SJ207243F,04 PAYPAL GENERAL UNRESTR,"Subject: Support Ukraine
Transaction ID: 72565085SJ207243F
https://www.paypal.com/activity/payment/72565085SJ207243F",PayPal Bank 3,--,$9.07,"$946,489.87"
Donations directed by individuals,09/22/2023,Deposit,72565085SJ207243F,04 PAYPAL GENERAL UNRESTR,Money in to PayPal,Contributed income:Donations directed by individuals,PayPal Bank 3,$10.00,"$946,499.87"
PayPal Fees,09/22/2023,Deposit,72565085SJ207243F,04 PAYPAL GENERAL UNRESTR,PayPal fees,OFFICE/GENERAL ADMINISTRATIVE EXPENSES:PayPal Fees,PayPal Bank 3,$0.93,"$946,500.80"
PayPal Bank 3,09/22/2023,Deposit,2C2669903U282674K,04 PAYPAL GENERAL UNRESTR,"Subject: Support Ukraine
Transaction ID: 2C2669903U282674K
https://www.paypal.com/activity/payment/2C2669903U282674K",PayPal Bank 3,--,$50.00,"$946,550.80"
Donations directed by individuals,09/22/2023,Deposit,2C2669903U282674K,04 PAYPAL GENERAL UNRESTR,Money in to PayPal,Contributed income:Donations directed by individuals,PayPal Bank 3,$51.99,"$946,602.79"
PayPal Fees,09/22/2023,Deposit,2C2669903U282674K,04 PAYPAL GENERAL UNRESTR,PayPal fees,OFFICE/GENERAL ADMINISTRATIVE EXPENSES:PayPal Fees,PayPal Bank 3,$1.99,"$946,604.78"
PayPal Bank 3,09/22/2023,Deposit,17C80770MV596380R,04 PAYPAL GENERAL UNRESTR,"Subject: Support Ukraine
Transaction ID: 17C80770MV596380R
https://www.paypal.com/activity/payment/17C80770MV596380R",PayPal Bank 3,--,$24.61,"$946,629.39"
Donations directed by individuals,09/22/2023,Deposit,17C80770MV596380R,04 PAYPAL GENERAL UNRESTR,Money in to PayPal,Contributed income:Donations directed by individuals,PayPal Bank 3,$26.25,"$946,655.64"
PayPal Fees,09/22/2023,Deposit,17C80770MV596380R,04 PAYPAL GENERAL UNRESTR,PayPal fees,OFFICE/GENERAL ADMINISTRATIVE EXPENSES:PayPal Fees,PayPal Bank 3,$1.64,"$946,657.28"
PayPal Bank 3,09/22/2023,Deposit,7D8785103J5355458,07 1000 DRONES RESTR,"Subject: 1000DRONES
Transaction ID: 7D8785103J5355458
https://www.paypal.com/activity/payment/7D8785103J5355458",PayPal Bank 3,--,$25.00,"$946,682.28"
Donations directed by individuals,09/22/2023,Deposit,7D8785103J5355458,07 1000 DRONES RESTR,1000 DRONES FOR UKRAINE - 1000 DRONES FOR UKRAINE,Contributed income:Donations directed by individuals,PayPal Bank 3,$26.25,"$946,708.53"
PayPal Fees,09/22/2023,Deposit,7D8785103J5355458,07 1000 DRONES RESTR,PayPal fees,OFFICE/GENERAL ADMINISTRATIVE EXPENSES:PayPal Fees,PayPal Bank 3,$1.25,"$946,709.78"
PayPal Bank 3,09/22/2023,Deposit,97L26642WD961411A,04 PAYPAL GENERAL UNRESTR,"Subject: GeneralPage
Transaction ID: 97L26642WD961411A
https://www.paypal.com/activity/payment/97L26642WD961411A",PayPal Bank 3,--,$50.00,"$946,759.78"
Donations directed by individuals,09/22/2023,Deposit,97L26642WD961411A,04 PAYPAL GENERAL UNRESTR,Support Ukraine - Support Ukraine,Contributed income:Donations directed by individuals,PayPal Bank 3,$51.99,"$946,811.77"
PayPal Fees,09/22/2023,Deposit,97L26642WD961411A,04 PAYPAL GENERAL UNRESTR,PayPal fees,OFFICE/GENERAL ADMINISTRATIVE EXPENSES:PayPal Fees,PayPal Bank 3,$1.99,"$946,813.76"
PayPal Bank 3,09/22/2023,Deposit,8W779099GE117983G,04 PAYPAL GENERAL UNRESTR,"Subject: GeneralPage
Transaction ID: 8W779099GE117983G
https://www.paypal.com/activity/payment/8W779099GE117983G",PayPal Bank 3,--,$95.12,"$946,908.88"
Donations directed by individuals,09/22/2023,Deposit,8W779099GE117983G,04 PAYPAL GENERAL UNRESTR,Support Ukraine - Support Ukraine,Contributed income:Donations directed by individuals,PayPal Bank 3,$100.00,"$947,008.88"
PayPal Fees,09/22/2023,Deposit,8W779099GE117983G,04 PAYPAL GENERAL UNRESTR,PayPal fees,OFFICE/GENERAL ADMINISTRATIVE EXPENSES:PayPal Fees,PayPal Bank 3,$4.88,"$947,013.76"
PayPal Bank 3,09/22/2023,Deposit,82A68234JB691554M,04 PAYPAL GENERAL UNRESTR,"Subject: GeneralPage
Transaction ID: 82A68234JB691554M
https://www.paypal.com/activity/payment/82A68234JB691554M",PayPal Bank 3,--,$196.91,"$947,210.67"
Donations directed by individuals,09/22/2023,Deposit,82A68234JB691554M,04 PAYPAL GENERAL UNRESTR,Support Ukraine - Support Ukraine,Contributed income:Donations directed by individuals,PayPal Bank 3,$206.46,"$947,417.13"
PayPal Fees,09/22/2023,Deposit,82A68234JB691554M,04 PAYPAL GENERAL UNRESTR,PayPal fees,OFFICE/GENERAL ADMINISTRATIVE EXPENSES:PayPal Fees,PayPal Bank 3,$9.55,"$947,426.68"
PayPal Bank 3,09/22/2023,Deposit,8TL226657H2113203,04 PAYPAL GENERAL UNRESTR,"Subject: GeneralPage
Transaction ID: 8TL226657H2113203
https://www.paypal.com/activity/payment/8TL226657H2113203",PayPal Bank 3,--,$102.45,"$947,529.13"
Donations directed by individuals,09/22/2023,Deposit,8TL226657H2113203,04 PAYPAL GENERAL UNRESTR,Support Ukraine - Support Ukraine,Contributed income:Donations directed by individuals,PayPal Bank 3,$106.00,"$947,635.13"
PayPal Fees,09/22/2023,Deposit,8TL226657H2113203,04 PAYPAL GENERAL UNRESTR,PayPal fees,OFFICE/GENERAL ADMINISTRATIVE EXPENSES:PayPal Fees,PayPal Bank 3,$3.55,"$947,638.68"
PayPal Bank 3,09/22/2023,Deposit,7TJ06042CE980661U,04 PAYPAL GENERAL UNRESTR,"Subject: GeneralPage
Transaction ID: 7TJ06042CE980661U
https://www.paypal.com/activity/payment/7TJ06042CE980661U",PayPal Bank 3,--,$96.62,"$947,735.30"
Donations directed by individuals,09/22/2023,Deposit,7TJ06042CE980661U,04 PAYPAL GENERAL UNRESTR,Support Ukraine - Support Ukraine,Contributed income:Donations directed by individuals,PayPal Bank 3,$100.00,"$947,835.30"
PayPal Fees,09/22/2023,Deposit,7TJ06042CE980661U,04 PAYPAL GENERAL UNRESTR,PayPal fees,OFFICE/GENERAL ADMINISTRATIVE EXPENSES:PayPal Fees,PayPal Bank 3,$3.38,"$947,838.68"
PayPal Bank 3,09/22/2023,Deposit,0YF09188L07121309,04 PAYPAL GENERAL UNRESTR,"Subject: Support Ukraine
Transaction ID: 0YF09188L07121309
https://www.paypal.com/activity/payment/0YF09188L07121309",PayPal Bank 3,--,$47.31,"$947,885.99"
Donations directed by individuals,09/22/2023,Deposit,0YF09188L07121309,04 PAYPAL GENERAL UNRESTR,Money in to PayPal,Contributed income:Donations directed by individuals,PayPal Bank 3,$50.00,"$947,935.99"
PayPal Fees,09/22/2023,Deposit,0YF09188L07121309,04 PAYPAL GENERAL UNRESTR,PayPal fees,OFFICE/GENERAL ADMINISTRATIVE EXPENSES:PayPal Fees,PayPal Bank 3,$2.69,"$947,938.68"
PayPal Bank 3,09/22/2023,Deposit,6XV42432H0870221R,04 PAYPAL GENERAL UNRESTR,"Subject: GeneralPage
Transaction ID: 6XV42432H0870221R
https://www.paypal.com/activity/payment/6XV42432H0870221R",PayPal Bank 3,--,$47.31,"$947,985.99"
Donations directed by individuals,09/22/2023,Deposit,6XV42432H0870221R,04 PAYPAL GENERAL UNRESTR,Support Ukraine - Support Ukraine,Contributed income:Donations directed by individuals,PayPal Bank 3,$50.00,"$948,035.99"
PayPal Fees,09/22/2023,Deposit,6XV42432H0870221R,04 PAYPAL GENERAL UNRESTR,PayPal fees,OFFICE/GENERAL ADMINISTRATIVE EXPENSES:PayPal Fees,PayPal Bank 3,$2.69,"$948,038.68"
PayPal Bank 3,09/22/2023,Deposit,99J37941UA659423P,04 PAYPAL GENERAL UNRESTR,"Subject: GeneralPage
Transaction ID: 99J37941UA659423P
https://www.paypal.com/activity/payment/99J37941UA659423P",PayPal Bank 3,--,$42.53,"$948,081.21"
Donations directed by individuals,09/22/2023,Deposit,99J37941UA659423P,04 PAYPAL GENERAL UNRESTR,Support Ukraine - Support Ukraine,Contributed income:Donations directed by individuals,PayPal Bank 3,$45.00,"$948,126.21"
PayPal Fees,09/22/2023,Deposit,99J37941UA659423P,04 PAYPAL GENERAL UNRESTR,PayPal fees,OFFICE/GENERAL ADMINISTRATIVE EXPENSES:PayPal Fees,PayPal Bank 3,$2.47,"$948,128.68"
PayPal Bank 3,09/22/2023,Deposit,5XV78737C3804783F,04 PAYPAL GENERAL UNRESTR,"Subject: GeneralPage
Transaction ID: 5XV78737C3804783F
https://www.paypal.com/activity/payment/5XV78737C3804783F",PayPal Bank 3,--,$295.36,"$948,424.04"
Donations directed by individuals,09/22/2023,Deposit,5XV78737C3804783F,04 PAYPAL GENERAL UNRESTR,Support Ukraine - Support Ukraine,Contributed income:Donations directed by individuals,PayPal Bank 3,$309.43,"$948,733.47"
PayPal Fees,09/22/2023,Deposit,5XV78737C3804783F,04 PAYPAL GENERAL UNRESTR,PayPal fees,OFFICE/GENERAL ADMINISTRATIVE EXPENSES:PayPal Fees,PayPal Bank 3,$14.07,"$948,747.54"
PayPal Bank 3,09/22/2023,Deposit,2LD77574LD387461G,04 PAYPAL GENERAL UNRESTR,"Subject: GeneralPage
Note: For Angry Birds.   From Sasha Dovzhyk.   Slava Ukraini! Martin Lohrer
Transaction ID: 2LD77574LD387461G
https://www.paypal.com/activity/payment/2LD77574LD387461G",PayPal Bank 3,--,$994.58,"$949,742.12"
Donations directed by individuals,09/22/2023,Deposit,2LD77574LD387461G,04 PAYPAL GENERAL UNRESTR,Support Ukraine - Support Ukraine,Contributed income:Donations directed by individuals,PayPal Bank 3,"$1,040.76","$950,782.88"
PayPal Fees,09/22/2023,Deposit,2LD77574LD387461G,04 PAYPAL GENERAL UNRESTR,PayPal fees,OFFICE/GENERAL ADMINISTRATIVE EXPENSES:PayPal Fees,PayPal Bank 3,$46.18,"$950,829.06"
PayPal Bank 3,09/22/2023,Deposit,98V909275B325961F,04 PAYPAL GENERAL UNRESTR,"Subject: GeneralPage
Note: Люті Пташки ��
Transaction ID: 98V909275B325961F
https://www.paypal.com/activity/payment/98V909275B325961F",PayPal Bank 3,--,$500.00,"$951,329.06"
Donations directed by individuals,09/22/2023,Deposit,98V909275B325961F,04 PAYPAL GENERAL UNRESTR,Support Ukraine - Support Ukraine,Contributed income:Donations directed by individuals,PayPal Bank 3,$515.38,"$951,844.44"
PayPal Fees,09/22/2023,Deposit,98V909275B325961F,04 PAYPAL GENERAL UNRESTR,PayPal fees,OFFICE/GENERAL ADMINISTRATIVE EXPENSES:PayPal Fees,PayPal Bank 3,$15.38,"$951,859.82"
PayPal Bank 3,09/22/2023,Deposit,4EX964657F3761311,04 PAYPAL GENERAL UNRESTR,"Subject: GeneralPage
Transaction ID: 4EX964657F3761311
https://www.paypal.com/activity/payment/4EX964657F3761311",PayPal Bank 3,--,$30.00,"$951,889.82"
Donations directed by individuals,09/22/2023,Deposit,4EX964657F3761311,04 PAYPAL GENERAL UNRESTR,Support Ukraine - Support Ukraine,Contributed income:Donations directed by individuals,PayPal Bank 3,$31.40,"$951,921.22"
PayPal Fees,09/22/2023,Deposit,4EX964657F3761311,04 PAYPAL GENERAL UNRESTR,PayPal fees,OFFICE/GENERAL ADMINISTRATIVE EXPENSES:PayPal Fees,PayPal Bank 3,$1.40,"$951,922.62"
PayPal Bank 3,09/22/2023,Deposit,3BE95191SX641741C,04 PAYPAL GENERAL UNRESTR,"Subject: GeneralPage
Transaction ID: 3BE95191SX641741C
https://www.paypal.com/activity/payment/3BE95191SX641741C",PayPal Bank 3,--,$14.76,"$951,937.38"
Donations directed by individuals,09/22/2023,Deposit,3BE95191SX641741C,04 PAYPAL GENERAL UNRESTR,Support Ukraine - Support Ukraine,Contributed income:Donations directed by individuals,PayPal Bank 3,$15.95,"$951,953.33"
PayPal Fees,09/22/2023,Deposit,3BE95191SX641741C,04 PAYPAL GENERAL UNRESTR,PayPal fees,OFFICE/GENERAL ADMINISTRATIVE EXPENSES:PayPal Fees,PayPal Bank 3,$1.19,"$951,954.52"
PayPal Bank 3,09/22/2023,Deposit,8VX5974100957144H,04 PAYPAL GENERAL UNRESTR,"Subject: GeneralPage
Transaction ID: 8VX5974100957144H
https://www.paypal.com/activity/payment/8VX5974100957144H",PayPal Bank 3,--,$47.31,"$952,001.83"
Donations directed by individuals,09/22/2023,Deposit,8VX5974100957144H,04 PAYPAL GENERAL UNRESTR,Support Ukraine - Support Ukraine,Contributed income:Donations directed by individuals,PayPal Bank 3,$50.00,"$952,051.83"
PayPal Fees,09/22/2023,Deposit,8VX5974100957144H,04 PAYPAL GENERAL UNRESTR,PayPal fees,OFFICE/GENERAL ADMINISTRATIVE EXPENSES:PayPal Fees,PayPal Bank 3,$2.69,"$952,054.52"
PayPal Bank 3,09/22/2023,Deposit,5BF57335UK302950T,04 PAYPAL GENERAL UNRESTR,"Subject: GeneralPage
Transaction ID: 5BF57335UK302950T
https://www.paypal.com/activity/payment/5BF57335UK302950T",PayPal Bank 3,--,$28.19,"$952,082.71"
Donations directed by individuals,09/22/2023,Deposit,5BF57335UK302950T,04 PAYPAL GENERAL UNRESTR,Support Ukraine - Support Ukraine,Contributed income:Donations directed by individuals,PayPal Bank 3,$30.00,"$952,112.71"
PayPal Fees,09/22/2023,Deposit,5BF57335UK302950T,04 PAYPAL GENERAL UNRESTR,PayPal fees,OFFICE/GENERAL ADMINISTRATIVE EXPENSES:PayPal Fees,PayPal Bank 3,$1.81,"$952,114.52"
PayPal Bank 3,09/22/2023,Deposit,88R72027XJ8218152,04 PAYPAL GENERAL UNRESTR,"Subject: GeneralPage
Transaction ID: 88R72027XJ8218152
https://www.paypal.com/activity/payment/88R72027XJ8218152",PayPal Bank 3,--,$96.62,"$952,211.14"
Donations directed by individuals,09/22/2023,Deposit,88R72027XJ8218152,04 PAYPAL GENERAL UNRESTR,Support Ukraine - Support Ukraine,Contributed income:Donations directed by individuals,PayPal Bank 3,$100.00,"$952,311.14"
PayPal Fees,09/22/2023,Deposit,88R72027XJ8218152,04 PAYPAL GENERAL UNRESTR,PayPal fees,OFFICE/GENERAL ADMINISTRATIVE EXPENSES:PayPal Fees,PayPal Bank 3,$3.38,"$952,314.52"
PayPal Bank 3,09/22/2023,Deposit,4MN32152SX955471L,04 PAYPAL GENERAL UNRESTR,"Subject: GeneralPage
Transaction ID: 4MN32152SX955471L
https://www.paypal.com/activity/payment/4MN32152SX955471L",PayPal Bank 3,--,$50.00,"$952,364.52"
Donations directed by individuals,09/22/2023,Deposit,4MN32152SX955471L,04 PAYPAL GENERAL UNRESTR,Support Ukraine - Support Ukraine,Contributed income:Donations directed by individuals,PayPal Bank 3,$51.99,"$952,416.51"
PayPal Fees,09/22/2023,Deposit,4MN32152SX955471L,04 PAYPAL GENERAL UNRESTR,PayPal fees,OFFICE/GENERAL ADMINISTRATIVE EXPENSES:PayPal Fees,PayPal Bank 3,$1.99,"$952,418.50"
PayPal Bank 3,09/22/2023,Deposit,70A72190YN600950P,04 PAYPAL GENERAL UNRESTR,"Subject: GeneralPage
Transaction ID: 70A72190YN600950P
https://www.paypal.com/activity/payment/70A72190YN600950P",PayPal Bank 3,--,$9.07,"$952,427.57"
Donations directed by individuals,09/22/2023,Deposit,70A72190YN600950P,04 PAYPAL GENERAL UNRESTR,Support Ukraine - Support Ukraine,Contributed income:Donations directed by individuals,PayPal Bank 3,$10.00,"$952,437.57"
PayPal Fees,09/22/2023,Deposit,70A72190YN600950P,04 PAYPAL GENERAL UNRESTR,PayPal fees,OFFICE/GENERAL ADMINISTRATIVE EXPENSES:PayPal Fees,PayPal Bank 3,$0.93,"$952,438.50"
PayPal Bank 3,09/22/2023,Deposit,2DY63223TM858493R,04 PAYPAL GENERAL UNRESTR,"Subject: GeneralPage
Transaction ID: 2DY63223TM858493R
https://www.paypal.com/activity/payment/2DY63223TM858493R",PayPal Bank 3,--,$20.00,"$952,458.50"
Donations directed by individuals,09/22/2023,Deposit,2DY63223TM858493R,04 PAYPAL GENERAL UNRESTR,Support Ukraine - Support Ukraine,Contributed income:Donations directed by individuals,PayPal Bank 3,$21.10,"$952,479.60"
PayPal Fees,09/22/2023,Deposit,2DY63223TM858493R,04 PAYPAL GENERAL UNRESTR,PayPal fees,OFFICE/GENERAL ADMINISTRATIVE EXPENSES:PayPal Fees,PayPal Bank 3,$1.10,"$952,480.70"
PayPal Bank 3,09/22/2023,Deposit,0FH76093L51733101,04 PAYPAL GENERAL UNRESTR,"Subject: GeneralPage
Transaction ID: 0FH76093L51733101
https://www.paypal.com/activity/payment/0FH76093L51733101",PayPal Bank 3,--,$98.45,"$952,579.15"
Donations directed by individuals,09/22/2023,Deposit,0FH76093L51733101,04 PAYPAL GENERAL UNRESTR,Support Ukraine - Support Ukraine,Contributed income:Donations directed by individuals,PayPal Bank 3,$103.48,"$952,682.63"
PayPal Fees,09/22/2023,Deposit,0FH76093L51733101,04 PAYPAL GENERAL UNRESTR,PayPal fees,OFFICE/GENERAL ADMINISTRATIVE EXPENSES:PayPal Fees,PayPal Bank 3,$5.03,"$952,687.66"
PayPal Bank 3,09/22/2023,Deposit,0CG2119248214310C,04 PAYPAL GENERAL UNRESTR,"Subject: GeneralPage
Transaction ID: 0CG2119248214310C
https://www.paypal.com/activity/payment/0CG2119248214310C",PayPal Bank 3,--,$95.12,"$952,782.78"
Donations directed by individuals,09/22/2023,Deposit,0CG2119248214310C,04 PAYPAL GENERAL UNRESTR,Support Ukraine - Support Ukraine,Contributed income:Donations directed by individuals,PayPal Bank 3,$100.00,"$952,882.78"
PayPal Fees,09/22/2023,Deposit,0CG2119248214310C,04 PAYPAL GENERAL UNRESTR,PayPal fees,OFFICE/GENERAL ADMINISTRATIVE EXPENSES:PayPal Fees,PayPal Bank 3,$4.88,"$952,887.66"
PayPal Bank 3,09/22/2023,Deposit,80A025750J500623F,04 PAYPAL GENERAL UNRESTR,"Subject: GeneralPage
Transaction ID: 80A025750J500623F
https://www.paypal.com/activity/payment/80A025750J500623F",PayPal Bank 3,--,$9.07,"$952,896.73"
Donations directed by individuals,09/22/2023,Deposit,80A025750J500623F,04 PAYPAL GENERAL UNRESTR,Support Ukraine - Support Ukraine,Contributed income:Donations directed by individuals,PayPal Bank 3,$10.00,"$952,906.73"
PayPal Fees,09/22/2023,Deposit,80A025750J500623F,04 PAYPAL GENERAL UNRESTR,PayPal fees,OFFICE/GENERAL ADMINISTRATIVE EXPENSES:PayPal Fees,PayPal Bank 3,$0.93,"$952,907.66"
PayPal Bank 3,09/22/2023,Deposit,4JL04943YH006240P,04 PAYPAL GENERAL UNRESTR,"Subject: GeneralPage
Transaction ID: 4JL04943YH006240P
https://www.paypal.com/activity/payment/4JL04943YH006240P",PayPal Bank 3,--,$14.76,"$952,922.42"
Donations directed by individuals,09/22/2023,Deposit,4JL04943YH006240P,04 PAYPAL GENERAL UNRESTR,Support Ukraine - Support Ukraine,Contributed income:Donations directed by individuals,PayPal Bank 3,$15.95,"$952,938.37"
PayPal Fees,09/22/2023,Deposit,4JL04943YH006240P,04 PAYPAL GENERAL UNRESTR,PayPal fees,OFFICE/GENERAL ADMINISTRATIVE EXPENSES:PayPal Fees,PayPal Bank 3,$1.19,"$952,939.56"
PayPal Bank 3,09/22/2023,Deposit,51M38814SL765063F,04 PAYPAL GENERAL UNRESTR,"Subject: GeneralPage
Transaction ID: 51M38814SL765063F
https://www.paypal.com/activity/payment/51M38814SL765063F",PayPal Bank 3,--,$300.00,"$953,239.56"
Donations directed by individuals,09/22/2023,Deposit,51M38814SL765063F,04 PAYPAL GENERAL UNRESTR,Support Ukraine - Support Ukraine,Contributed income:Donations directed by individuals,PayPal Bank 3,$309.43,"$953,548.99"
PayPal Fees,09/22/2023,Deposit,51M38814SL765063F,04 PAYPAL GENERAL UNRESTR,PayPal fees,OFFICE/GENERAL ADMINISTRATIVE EXPENSES:PayPal Fees,PayPal Bank 3,$9.43,"$953,558.42"
PayPal Bank 3,09/22/2023,Deposit,05499389C0518881F,04 PAYPAL GENERAL UNRESTR,"Subject: GeneralPage
Transaction ID: 05499389C0518881F
https://www.paypal.com/activity/payment/05499389C0518881F",PayPal Bank 3,--,$95.12,"$953,653.54"
Donations directed by individuals,09/22/2023,Deposit,05499389C0518881F,04 PAYPAL GENERAL UNRESTR,Support Ukraine - Support Ukraine,Contributed income:Donations directed by individuals,PayPal Bank 3,$100.00,"$953,753.54"
PayPal Fees,09/22/2023,Deposit,05499389C0518881F,04 PAYPAL GENERAL UNRESTR,PayPal fees,OFFICE/GENERAL ADMINISTRATIVE EXPENSES:PayPal Fees,PayPal Bank 3,$4.88,"$953,758.42"
PayPal Bank 3,09/22/2023,Deposit,1XT62662FB366225Y,04 PAYPAL GENERAL UNRESTR,"Subject: GeneralPage
Note: Ми переможемо.
Transaction ID: 1XT62662FB366225Y
https://www.paypal.com/activity/payment/1XT62662FB366225Y",PayPal Bank 3,--,$190.73,"$953,949.15"
Donations directed by individuals,09/22/2023,Deposit,1XT62662FB366225Y,04 PAYPAL GENERAL UNRESTR,Support Ukraine - Support Ukraine,Contributed income:Donations directed by individuals,PayPal Bank 3,$200.00,"$954,149.15"
PayPal Fees,09/22/2023,Deposit,1XT62662FB366225Y,04 PAYPAL GENERAL UNRESTR,PayPal fees,OFFICE/GENERAL ADMINISTRATIVE EXPENSES:PayPal Fees,PayPal Bank 3,$9.27,"$954,158.42"
PayPal Bank 3,09/22/2023,Deposit,0Y733672AJ748812W,08 VICTORY DRONES RESTR,"Subject: VICTORY DRONES
Transaction ID: 0Y733672AJ748812W
https://www.paypal.com/activity/payment/0Y733672AJ748812W",PayPal Bank 3,--,$100.00,"$954,258.42"
Donations directed by individuals,09/22/2023,Deposit,0Y733672AJ748812W,08 VICTORY DRONES RESTR,Money in to PayPal,Contributed income:Donations directed by individuals,PayPal Bank 3,$103.48,"$954,361.90"
PayPal Fees,09/22/2023,Deposit,0Y733672AJ748812W,08 VICTORY DRONES RESTR,PayPal fees,OFFICE/GENERAL ADMINISTRATIVE EXPENSES:PayPal Fees,PayPal Bank 3,$3.48,"$954,365.38"
PayPal Bank 3,09/22/2023,Deposit,7HB57059SM714743R,07 1000 DRONES RESTR,"Subject: 1000DRONES
Note: Слава героям
Transaction ID: 7HB57059SM714743R
https://www.paypal.com/activity/payment/7HB57059SM714743R",PayPal Bank 3,--,$50.00,"$954,415.38"
Donations directed by individuals,09/22/2023,Deposit,7HB57059SM714743R,07 1000 DRONES RESTR,1000 DRONES FOR UKRAINE - 1000 DRONES FOR UKRAINE,Contributed income:Donations directed by individuals,PayPal Bank 3,$51.99,"$954,467.37"
PayPal Fees,09/22/2023,Deposit,7HB57059SM714743R,07 1000 DRONES RESTR,PayPal fees,OFFICE/GENERAL ADMINISTRATIVE EXPENSES:PayPal Fees,PayPal Bank 3,$1.99,"$954,469.36"
PayPal Bank 3,09/22/2023,Deposit,22T99695A3220662T,04 PAYPAL GENERAL UNRESTR,"Subject: GeneralPage
Transaction ID: 22T99695A3220662T
https://www.paypal.com/activity/payment/22T99695A3220662T",PayPal Bank 3,--,$50.00,"$954,519.36"
Donations directed by individuals,09/22/2023,Deposit,22T99695A3220662T,04 PAYPAL GENERAL UNRESTR,Support Ukraine - Support Ukraine,Contributed income:Donations directed by individuals,PayPal Bank 3,$51.99,"$954,571.35"
PayPal Fees,09/22/2023,Deposit,22T99695A3220662T,04 PAYPAL GENERAL UNRESTR,PayPal fees,OFFICE/GENERAL ADMINISTRATIVE EXPENSES:PayPal Fees,PayPal Bank 3,$1.99,"$954,573.34"
PayPal Bank 3,09/22/2023,Deposit,6J042545AX873720B,04 PAYPAL GENERAL UNRESTR,"Subject: GeneralPage
Transaction ID: 6J042545AX873720B
https://www.paypal.com/activity/payment/6J042545AX873720B",PayPal Bank 3,--,$10.00,"$954,583.34"
Donations directed by individuals,09/22/2023,Deposit,6J042545AX873720B,04 PAYPAL GENERAL UNRESTR,Support Ukraine - Support Ukraine,Contributed income:Donations directed by individuals,PayPal Bank 3,$10.80,"$954,594.14"
PayPal Fees,09/22/2023,Deposit,6J042545AX873720B,04 PAYPAL GENERAL UNRESTR,PayPal fees,OFFICE/GENERAL ADMINISTRATIVE EXPENSES:PayPal Fees,PayPal Bank 3,$0.80,"$954,594.94"
PayPal Bank 3,09/22/2023,Deposit,7E143065673282902,04 PAYPAL GENERAL UNRESTR,"Subject: GeneralPage
Transaction ID: 7E143065673282902
https://www.paypal.com/activity/payment/7E143065673282902",PayPal Bank 3,--,$4.29,"$954,599.23"
Donations directed by individuals,09/22/2023,Deposit,7E143065673282902,04 PAYPAL GENERAL UNRESTR,Support Ukraine - Support Ukraine,Contributed income:Donations directed by individuals,PayPal Bank 3,$5.00,"$954,604.23"
PayPal Fees,09/22/2023,Deposit,7E143065673282902,04 PAYPAL GENERAL UNRESTR,PayPal fees,OFFICE/GENERAL ADMINISTRATIVE EXPENSES:PayPal Fees,PayPal Bank 3,$0.71,"$954,604.94"
PayPal Bank 3,09/22/2023,Deposit,3LT35620N3992273U,04 PAYPAL GENERAL UNRESTR,"Subject: GeneralPage
Transaction ID: 3LT35620N3992273U
https://www.paypal.com/activity/payment/3LT35620N3992273U",PayPal Bank 3,--,$19.68,"$954,624.62"
Donations directed by individuals,09/22/2023,Deposit,3LT35620N3992273U,04 PAYPAL GENERAL UNRESTR,Support Ukraine - Support Ukraine,Contributed income:Donations directed by individuals,PayPal Bank 3,$21.10,"$954,645.72"
PayPal Fees,09/22/2023,Deposit,3LT35620N3992273U,04 PAYPAL GENERAL UNRESTR,PayPal fees,OFFICE/GENERAL ADMINISTRATIVE EXPENSES:PayPal Fees,PayPal Bank 3,$1.42,"$954,647.14"
PayPal Bank 3,09/22/2023,Deposit,68E79011LT664441F,04 PAYPAL GENERAL UNRESTR,"Subject: GeneralPage
Transaction ID: 68E79011LT664441F
https://www.paypal.com/activity/payment/68E79011LT664441F",PayPal Bank 3,--,$9.84,"$954,656.98"
Donations directed by individuals,09/22/2023,Deposit,68E79011LT664441F,04 PAYPAL GENERAL UNRESTR,Support Ukraine - Support Ukraine,Contributed income:Donations directed by individuals,PayPal Bank 3,$10.80,"$954,667.78"
PayPal Fees,09/22/2023,Deposit,68E79011LT664441F,04 PAYPAL GENERAL UNRESTR,PayPal fees,OFFICE/GENERAL ADMINISTRATIVE EXPENSES:PayPal Fees,PayPal Bank 3,$0.96,"$954,668.74"
PayPal Bank 3,09/22/2023,Deposit,62U70074NG588442W,04 PAYPAL GENERAL UNRESTR,"Subject: Support Ukraine
Transaction ID: 62U70074NG588442W
https://www.paypal.com/activity/payment/62U70074NG588442W",PayPal Bank 3,--,$9.84,"$954,678.58"
Donations directed by individuals,09/22/2023,Deposit,62U70074NG588442W,04 PAYPAL GENERAL UNRESTR,Money in to PayPal,Contributed income:Donations directed by individuals,PayPal Bank 3,$10.80,"$954,689.38"
PayPal Fees,09/22/2023,Deposit,62U70074NG588442W,04 PAYPAL GENERAL UNRESTR,PayPal fees,OFFICE/GENERAL ADMINISTRATIVE EXPENSES:PayPal Fees,PayPal Bank 3,$0.96,"$954,690.34"
PayPal Bank 3,09/22/2023,Deposit,88R446250Y7316242,04 PAYPAL GENERAL UNRESTR,"Subject: Support Ukraine
Transaction ID: 88R446250Y7316242
https://www.paypal.com/activity/payment/88R446250Y7316242",PayPal Bank 3,--,$24.61,"$954,714.95"
Donations directed by individuals,09/22/2023,Deposit,88R446250Y7316242,04 PAYPAL GENERAL UNRESTR,Money in to PayPal,Contributed income:Donations directed by individuals,PayPal Bank 3,$26.25,"$954,741.20"
PayPal Fees,09/22/2023,Deposit,88R446250Y7316242,04 PAYPAL GENERAL UNRESTR,PayPal fees,OFFICE/GENERAL ADMINISTRATIVE EXPENSES:PayPal Fees,PayPal Bank 3,$1.64,"$954,742.84"
PayPal Bank 3,09/22/2023,Deposit,4DU45549MF817090U,04 PAYPAL GENERAL UNRESTR,"Subject: GeneralPage
Transaction ID: 4DU45549MF817090U
https://www.paypal.com/activity/payment/4DU45549MF817090U",PayPal Bank 3,--,$295.36,"$955,038.20"
Donations directed by individuals,09/22/2023,Deposit,4DU45549MF817090U,04 PAYPAL GENERAL UNRESTR,Support Ukraine - Support Ukraine,Contributed income:Donations directed by individuals,PayPal Bank 3,$309.43,"$955,347.63"
PayPal Fees,09/22/2023,Deposit,4DU45549MF817090U,04 PAYPAL GENERAL UNRESTR,PayPal fees,OFFICE/GENERAL ADMINISTRATIVE EXPENSES:PayPal Fees,PayPal Bank 3,$14.07,"$955,361.70"
PayPal Bank 3,09/22/2023,Deposit,37M9982877917680H,04 PAYPAL GENERAL UNRESTR,"Subject: GeneralPage
Transaction ID: 37M9982877917680H
https://www.paypal.com/activity/payment/37M9982877917680H",PayPal Bank 3,--,$47.31,"$955,409.01"
Donations directed by individuals,09/22/2023,Deposit,37M9982877917680H,04 PAYPAL GENERAL UNRESTR,Support Ukraine - Support Ukraine,Contributed income:Donations directed by individuals,PayPal Bank 3,$50.00,"$955,459.01"
PayPal Fees,09/22/2023,Deposit,37M9982877917680H,04 PAYPAL GENERAL UNRESTR,PayPal fees,OFFICE/GENERAL ADMINISTRATIVE EXPENSES:PayPal Fees,PayPal Bank 3,$2.69,"$955,461.70"
PayPal Bank 3,09/22/2023,Deposit,2J0737363Y461772B,04 PAYPAL GENERAL UNRESTR,"Subject: GeneralPage
Transaction ID: 2J0737363Y461772B
https://www.paypal.com/activity/payment/2J0737363Y461772B",PayPal Bank 3,--,$50.00,"$955,511.70"
Donations directed by individuals,09/22/2023,Deposit,2J0737363Y461772B,04 PAYPAL GENERAL UNRESTR,Support Ukraine - Support Ukraine,Contributed income:Donations directed by individuals,PayPal Bank 3,$51.99,"$955,563.69"
PayPal Fees,09/22/2023,Deposit,2J0737363Y461772B,04 PAYPAL GENERAL UNRESTR,PayPal fees,OFFICE/GENERAL ADMINISTRATIVE EXPENSES:PayPal Fees,PayPal Bank 3,$1.99,"$955,565.68"
PayPal Bank 3,09/22/2023,Deposit,8DP06760HA213550T,04 PAYPAL GENERAL UNRESTR,"Subject: GeneralPage
Transaction ID: 8DP06760HA213550T
https://www.paypal.com/activity/payment/8DP06760HA213550T",PayPal Bank 3,--,$95.12,"$955,660.80"
Donations directed by individuals,09/22/2023,Deposit,8DP06760HA213550T,04 PAYPAL GENERAL UNRESTR,Support Ukraine - Support Ukraine,Contributed income:Donations directed by individuals,PayPal Bank 3,$100.00,"$955,760.80"
PayPal Fees,09/22/2023,Deposit,8DP06760HA213550T,04 PAYPAL GENERAL UNRESTR,PayPal fees,OFFICE/GENERAL ADMINISTRATIVE EXPENSES:PayPal Fees,PayPal Bank 3,$4.88,"$955,765.68"
PayPal Bank 3,09/22/2023,Deposit,79T58871KV7282044,04 PAYPAL GENERAL UNRESTR,"Subject: GeneralPage
Note: Donation
Transaction ID: 79T58871KV7282044
https://www.paypal.com/activity/payment/79T58871KV7282044",PayPal Bank 3,--,$49.22,"$955,814.90"
Donations directed by individuals,09/22/2023,Deposit,79T58871KV7282044,04 PAYPAL GENERAL UNRESTR,Support Ukraine - Support Ukraine,Contributed income:Donations directed by individuals,PayPal Bank 3,$51.99,"$955,866.89"
PayPal Fees,09/22/2023,Deposit,79T58871KV7282044,04 PAYPAL GENERAL UNRESTR,PayPal fees,OFFICE/GENERAL ADMINISTRATIVE EXPENSES:PayPal Fees,PayPal Bank 3,$2.77,"$955,869.66"
PayPal Bank 3,09/22/2023,Deposit,18A67829770385820,07 1000 DRONES RESTR,"Subject: GeneralPage
Note: На дрони
Transaction ID: 18A67829770385820
https://www.paypal.com/activity/payment/18A67829770385820",PayPal Bank 3,--,$60.00,"$955,929.66"
Donations directed by individuals,09/22/2023,Deposit,18A67829770385820,07 1000 DRONES RESTR,Support Ukraine - Support Ukraine,Contributed income:Donations directed by individuals,PayPal Bank 3,$62.29,"$955,991.95"
PayPal Fees,09/22/2023,Deposit,18A67829770385820,07 1000 DRONES RESTR,PayPal fees,OFFICE/GENERAL ADMINISTRATIVE EXPENSES:PayPal Fees,PayPal Bank 3,$2.29,"$955,994.24"
PayPal Bank 3,09/22/2023,Deposit,6T766570VD482513B,04 PAYPAL GENERAL UNRESTR,"Subject: GeneralPage
Transaction ID: 6T766570VD482513B
https://www.paypal.com/activity/payment/6T766570VD482513B",PayPal Bank 3,--,"$1,000.00","$956,994.24"
Donations directed by individuals,09/22/2023,Deposit,6T766570VD482513B,04 PAYPAL GENERAL UNRESTR,Support Ukraine - Support Ukraine,Contributed income:Donations directed by individuals,PayPal Bank 3,"$1,030.26","$958,024.50"
PayPal Fees,09/22/2023,Deposit,6T766570VD482513B,04 PAYPAL GENERAL UNRESTR,PayPal fees,OFFICE/GENERAL ADMINISTRATIVE EXPENSES:PayPal Fees,PayPal Bank 3,$30.26,"$958,054.76"
PayPal Bank 3,09/22/2023,Deposit,55A40333WE240125A,04 PAYPAL GENERAL UNRESTR,"Subject: GeneralPage
Transaction ID: 55A40333WE240125A
https://www.paypal.com/activity/payment/55A40333WE240125A",PayPal Bank 3,--,$100.00,"$958,154.76"
Donations directed by individuals,09/22/2023,Deposit,55A40333WE240125A,04 PAYPAL GENERAL UNRESTR,Support Ukraine - Support Ukraine,Contributed income:Donations directed by individuals,PayPal Bank 3,$103.48,"$958,258.24"
PayPal Fees,09/22/2023,Deposit,55A40333WE240125A,04 PAYPAL GENERAL UNRESTR,PayPal fees,OFFICE/GENERAL ADMINISTRATIVE EXPENSES:PayPal Fees,PayPal Bank 3,$3.48,"$958,261.72"
PayPal Bank 3,09/22/2023,Deposit,6FG66895L05966507,04 PAYPAL GENERAL UNRESTR,"Subject: GeneralPage
Transaction ID: 6FG66895L05966507
https://www.paypal.com/activity/payment/6FG66895L05966507",PayPal Bank 3,--,$9.22,"$958,270.94"
Donations directed by individuals,09/22/2023,Deposit,6FG66895L05966507,04 PAYPAL GENERAL UNRESTR,Support Ukraine - Support Ukraine,Contributed income:Donations directed by individuals,PayPal Bank 3,$10.00,"$958,280.94"
PayPal Fees,09/22/2023,Deposit,6FG66895L05966507,04 PAYPAL GENERAL UNRESTR,PayPal fees,OFFICE/GENERAL ADMINISTRATIVE EXPENSES:PayPal Fees,PayPal Bank 3,$0.78,"$958,281.72"
PayPal Bank 3,09/22/2023,Deposit,1YC99974WR7018030,04 PAYPAL GENERAL UNRESTR,"Subject: GeneralPage
Transaction ID: 1YC99974WR7018030
https://www.paypal.com/activity/payment/1YC99974WR7018030",PayPal Bank 3,--,$309.29,"$958,591.01"
Donations directed by individuals,09/22/2023,Deposit,1YC99974WR7018030,04 PAYPAL GENERAL UNRESTR,Support Ukraine - Support Ukraine,Contributed income:Donations directed by individuals,PayPal Bank 3,$324.00,"$958,915.01"
PayPal Fees,09/22/2023,Deposit,1YC99974WR7018030,04 PAYPAL GENERAL UNRESTR,PayPal fees,OFFICE/GENERAL ADMINISTRATIVE EXPENSES:PayPal Fees,PayPal Bank 3,$14.71,"$958,929.72"
PayPal Bank 3,09/22/2023,Deposit,8MT22434X3405901G,04 PAYPAL GENERAL UNRESTR,"Subject: GeneralPage
Transaction ID: 8MT22434X3405901G
https://www.paypal.com/activity/payment/8MT22434X3405901G",PayPal Bank 3,--,$200.00,"$959,129.72"
Donations directed by individuals,09/22/2023,Deposit,8MT22434X3405901G,04 PAYPAL GENERAL UNRESTR,Support Ukraine - Support Ukraine,Contributed income:Donations directed by individuals,PayPal Bank 3,$206.46,"$959,336.18"
PayPal Fees,09/22/2023,Deposit,8MT22434X3405901G,04 PAYPAL GENERAL UNRESTR,PayPal fees,OFFICE/GENERAL ADMINISTRATIVE EXPENSES:PayPal Fees,PayPal Bank 3,$6.46,"$959,342.64"
PayPal Bank 3,09/22/2023,Deposit,7PB45841N2255362C,04 PAYPAL GENERAL UNRESTR,"Subject: GeneralPage
Transaction ID: 7PB45841N2255362C
https://www.paypal.com/activity/payment/7PB45841N2255362C",PayPal Bank 3,--,$50.00,"$959,392.64"
Donations directed by individuals,09/22/2023,Deposit,7PB45841N2255362C,04 PAYPAL GENERAL UNRESTR,Support Ukraine - Support Ukraine,Contributed income:Donations directed by individuals,PayPal Bank 3,$51.99,"$959,444.63"
PayPal Fees,09/22/2023,Deposit,7PB45841N2255362C,04 PAYPAL GENERAL UNRESTR,PayPal fees,OFFICE/GENERAL ADMINISTRATIVE EXPENSES:PayPal Fees,PayPal Bank 3,$1.99,"$959,446.62"
PayPal Bank 3,09/22/2023,Deposit,650606103C4454220,04 PAYPAL GENERAL UNRESTR,"Subject: GeneralPage
Transaction ID: 650606103C4454220
https://www.paypal.com/activity/payment/650606103C4454220",PayPal Bank 3,--,$4.29,"$959,450.91"
Donations directed by individuals,09/22/2023,Deposit,650606103C4454220,04 PAYPAL GENERAL UNRESTR,Support Ukraine - Support Ukraine,Contributed income:Donations directed by individuals,PayPal Bank 3,$5.00,"$959,455.91"
PayPal Fees,09/22/2023,Deposit,650606103C4454220,04 PAYPAL GENERAL UNRESTR,PayPal fees,OFFICE/GENERAL ADMINISTRATIVE EXPENSES:PayPal Fees,PayPal Bank 3,$0.71,"$959,456.62"
PayPal Bank 3,09/22/2023,Deposit,0DL42607RN849551L,07 1000 DRONES RESTR,"Subject: 1000DRONES
Note: Please, use it for 1000 drones project
Transaction ID: 0DL42607RN849551L
https://www.paypal.com/activity/payment/0DL42607RN849551L",PayPal Bank 3,--,$250.00,"$959,706.62"
Donations directed by individuals,09/22/2023,Deposit,0DL42607RN849551L,07 1000 DRONES RESTR,1000 DRONES FOR UKRAINE - 1000 DRONES FOR UKRAINE,Contributed income:Donations directed by individuals,PayPal Bank 3,$257.94,"$959,964.56"
PayPal Fees,09/22/2023,Deposit,0DL42607RN849551L,07 1000 DRONES RESTR,PayPal fees,OFFICE/GENERAL ADMINISTRATIVE EXPENSES:PayPal Fees,PayPal Bank 3,$7.94,"$959,972.50"
PayPal Bank 3,09/22/2023,Deposit,46R29326G5970974T,04 PAYPAL GENERAL UNRESTR,"Subject: GeneralPage
Transaction ID: 46R29326G5970974T
https://www.paypal.com/activity/payment/46R29326G5970974T",PayPal Bank 3,--,$196.91,"$960,169.41"
Donations directed by individuals,09/22/2023,Deposit,46R29326G5970974T,04 PAYPAL GENERAL UNRESTR,Support Ukraine - Support Ukraine,Contributed income:Donations directed by individuals,PayPal Bank 3,$206.46,"$960,375.87"
PayPal Fees,09/22/2023,Deposit,46R29326G5970974T,04 PAYPAL GENERAL UNRESTR,PayPal fees,OFFICE/GENERAL ADMINISTRATIVE EXPENSES:PayPal Fees,PayPal Bank 3,$9.55,"$960,385.42"
PayPal Bank 3,09/22/2023,Deposit,5JV46588W6831142V,04 PAYPAL GENERAL UNRESTR,"Subject: GeneralPage
Transaction ID: 5JV46588W6831142V
https://www.paypal.com/activity/payment/5JV46588W6831142V",PayPal Bank 3,--,$59.07,"$960,444.49"
Donations directed by individuals,09/22/2023,Deposit,5JV46588W6831142V,04 PAYPAL GENERAL UNRESTR,Support Ukraine - Support Ukraine,Contributed income:Donations directed by individuals,PayPal Bank 3,$62.29,"$960,506.78"
PayPal Fees,09/22/2023,Deposit,5JV46588W6831142V,04 PAYPAL GENERAL UNRESTR,PayPal fees,OFFICE/GENERAL ADMINISTRATIVE EXPENSES:PayPal Fees,PayPal Bank 3,$3.22,"$960,510.00"
PayPal Bank 3,09/22/2023,Deposit,9Y845883Y0615392K,07 1000 DRONES RESTR,"Subject: 1000DRONES
Transaction ID: 9Y845883Y0615392K
https://www.paypal.com/activity/payment/9Y845883Y0615392K",PayPal Bank 3,--,$96.62,"$960,606.62"
Donations directed by individuals,09/22/2023,Deposit,9Y845883Y0615392K,07 1000 DRONES RESTR,1000 DRONES FOR UKRAINE - 1000 DRONES FOR UKRAINE,Contributed income:Donations directed by individuals,PayPal Bank 3,$100.00,"$960,706.62"
PayPal Fees,09/22/2023,Deposit,9Y845883Y0615392K,07 1000 DRONES RESTR,PayPal fees,OFFICE/GENERAL ADMINISTRATIVE EXPENSES:PayPal Fees,PayPal Bank 3,$3.38,"$960,710.00"
PayPal Bank 3,09/22/2023,Deposit,0G042750TL522281W,04 PAYPAL GENERAL UNRESTR,"Subject: GeneralPage
Transaction ID: 0G042750TL522281W
https://www.paypal.com/activity/payment/0G042750TL522281W",PayPal Bank 3,--,$50.00,"$960,760.00"
Donations directed by individuals,09/22/2023,Deposit,0G042750TL522281W,04 PAYPAL GENERAL UNRESTR,Support Ukraine - Support Ukraine,Contributed income:Donations directed by individuals,PayPal Bank 3,$51.99,"$960,811.99"
PayPal Fees,09/22/2023,Deposit,0G042750TL522281W,04 PAYPAL GENERAL UNRESTR,PayPal fees,OFFICE/GENERAL ADMINISTRATIVE EXPENSES:PayPal Fees,PayPal Bank 3,$1.99,"$960,813.98"
PayPal Bank 3,09/22/2023,Deposit,4EF86051BH146503E,04 PAYPAL GENERAL UNRESTR,"Subject: GeneralPage
Transaction ID: 4EF86051BH146503E
https://www.paypal.com/activity/payment/4EF86051BH146503E",PayPal Bank 3,--,$9.84,"$960,823.82"
Donations directed by individuals,09/22/2023,Deposit,4EF86051BH146503E,04 PAYPAL GENERAL UNRESTR,Support Ukraine - Support Ukraine,Contributed income:Donations directed by individuals,PayPal Bank 3,$10.80,"$960,834.62"
PayPal Fees,09/22/2023,Deposit,4EF86051BH146503E,04 PAYPAL GENERAL UNRESTR,PayPal fees,OFFICE/GENERAL ADMINISTRATIVE EXPENSES:PayPal Fees,PayPal Bank 3,$0.96,"$960,835.58"
PayPal Bank 3,09/22/2023,Deposit,21U29675HP241023U,04 PAYPAL GENERAL UNRESTR,"Subject: GeneralPage
Note: Thank you for the t-shirt!
Transaction ID: 21U29675HP241023U
https://www.paypal.com/activity/payment/21U29675HP241023U",PayPal Bank 3,--,$50.00,"$960,885.58"
Donations directed by individuals,09/22/2023,Deposit,21U29675HP241023U,04 PAYPAL GENERAL UNRESTR,Support Ukraine - Support Ukraine,Contributed income:Donations directed by individuals,PayPal Bank 3,$51.99,"$960,937.57"
PayPal Fees,09/22/2023,Deposit,21U29675HP241023U,04 PAYPAL GENERAL UNRESTR,PayPal fees,OFFICE/GENERAL ADMINISTRATIVE EXPENSES:PayPal Fees,PayPal Bank 3,$1.99,"$960,939.56"
PayPal Bank 3,09/22/2023,Deposit,9YP68072543870357,04 PAYPAL GENERAL UNRESTR,"Subject: GeneralPage
Note: Slava Ukraine
Transaction ID: 9YP68072543870357
https://www.paypal.com/activity/payment/9YP68072543870357",PayPal Bank 3,--,$47.31,"$960,986.87"
Donations directed by individuals,09/22/2023,Deposit,9YP68072543870357,04 PAYPAL GENERAL UNRESTR,Support Ukraine - Support Ukraine,Contributed income:Donations directed by individuals,PayPal Bank 3,$50.00,"$961,036.87"
PayPal Fees,09/22/2023,Deposit,9YP68072543870357,04 PAYPAL GENERAL UNRESTR,PayPal fees,OFFICE/GENERAL ADMINISTRATIVE EXPENSES:PayPal Fees,PayPal Bank 3,$2.69,"$961,039.56"
PayPal Bank 3,09/22/2023,Deposit,7KG23107D52272627,08 VICTORY DRONES RESTR,"Subject: VictoryDrones
Transaction ID: 7KG23107D52272627
https://www.paypal.com/activity/payment/7KG23107D52272627",PayPal Bank 3,--,$147.68,"$961,187.24"
Donations directed by individuals,09/22/2023,Deposit,7KG23107D52272627,08 VICTORY DRONES RESTR,VICTORY DRONES - VICTORY DRONES,Contributed income:Donations directed by individuals,PayPal Bank 3,$154.97,"$961,342.21"
PayPal Fees,09/22/2023,Deposit,7KG23107D52272627,08 VICTORY DRONES RESTR,PayPal fees,OFFICE/GENERAL ADMINISTRATIVE EXPENSES:PayPal Fees,PayPal Bank 3,$7.29,"$961,349.50"
PayPal Bank 3,09/22/2023,Deposit,6WD9090860272945L,07 1000 DRONES RESTR,"Subject: 1000 DRONES FOR UKRAINE
Transaction ID: 6WD9090860272945L
https://www.paypal.com/activity/payment/6WD9090860272945L",PayPal Bank 3,--,$24.61,"$961,374.11"
Donations directed by individuals,09/22/2023,Deposit,6WD9090860272945L,07 1000 DRONES RESTR,Money in to PayPal,Contributed income:Donations directed by individuals,PayPal Bank 3,$26.25,"$961,400.36"
PayPal Fees,09/22/2023,Deposit,6WD9090860272945L,07 1000 DRONES RESTR,PayPal fees,OFFICE/GENERAL ADMINISTRATIVE EXPENSES:PayPal Fees,PayPal Bank 3,$1.64,"$961,402.00"
PayPal Bank 3,09/22/2023,Deposit,8K996993MM0083000,04 PAYPAL GENERAL UNRESTR,"Subject: GeneralPage
Transaction ID: 8K996993MM0083000
https://www.paypal.com/activity/payment/8K996993MM0083000",PayPal Bank 3,--,$18.63,"$961,420.63"
Donations directed by individuals,09/22/2023,Deposit,8K996993MM0083000,04 PAYPAL GENERAL UNRESTR,Support Ukraine - Support Ukraine,Contributed income:Donations directed by individuals,PayPal Bank 3,$20.00,"$961,440.63"
PayPal Fees,09/22/2023,Deposit,8K996993MM0083000,04 PAYPAL GENERAL UNRESTR,PayPal fees,OFFICE/GENERAL ADMINISTRATIVE EXPENSES:PayPal Fees,PayPal Bank 3,$1.37,"$961,442.00"
PayPal Bank 3,09/22/2023,Deposit,7MW98715D4012090M,04 PAYPAL GENERAL UNRESTR,"Transaction ID: 7MW98715D4012090M
https://www.paypal.com/activity/payment/7MW98715D4012090M",PayPal Bank 3,--,"$1,486.04","$962,928.04"
Donations directed by individuals,09/22/2023,Deposit,7MW98715D4012090M,04 PAYPAL GENERAL UNRESTR,Money in to PayPal,Contributed income:Donations directed by individuals,PayPal Bank 3,"$1,555.90","$964,483.94"
PayPal Fees,09/22/2023,Deposit,7MW98715D4012090M,04 PAYPAL GENERAL UNRESTR,PayPal fees,OFFICE/GENERAL ADMINISTRATIVE EXPENSES:PayPal Fees,PayPal Bank 3,$69.86,"$964,553.80"
PayPal Bank 3,09/22/2023,Deposit,4423625751190935J,04 PAYPAL GENERAL UNRESTR,"Subject: GeneralPage
Transaction ID: 4423625751190935J
https://www.paypal.com/activity/payment/4423625751190935J",PayPal Bank 3,--,$485.06,"$965,038.86"
Donations directed by individuals,09/22/2023,Deposit,4423625751190935J,04 PAYPAL GENERAL UNRESTR,Support Ukraine - Support Ukraine,Contributed income:Donations directed by individuals,PayPal Bank 3,$500.00,"$965,538.86"
PayPal Fees,09/22/2023,Deposit,4423625751190935J,04 PAYPAL GENERAL UNRESTR,PayPal fees,OFFICE/GENERAL ADMINISTRATIVE EXPENSES:PayPal Fees,PayPal Bank 3,$14.94,"$965,553.80"
PayPal Bank 3,09/22/2023,Deposit,5W864208RS8400105,04 PAYPAL GENERAL UNRESTR,"Subject: GeneralPage
Transaction ID: 5W864208RS8400105
https://www.paypal.com/activity/payment/5W864208RS8400105",PayPal Bank 3,--,$18.93,"$965,572.73"
Donations directed by individuals,09/22/2023,Deposit,5W864208RS8400105,04 PAYPAL GENERAL UNRESTR,Support Ukraine - Support Ukraine,Contributed income:Donations directed by individuals,PayPal Bank 3,$20.00,"$965,592.73"
PayPal Fees,09/22/2023,Deposit,5W864208RS8400105,04 PAYPAL GENERAL UNRESTR,PayPal fees,OFFICE/GENERAL ADMINISTRATIVE EXPENSES:PayPal Fees,PayPal Bank 3,$1.07,"$965,593.80"
PayPal Bank 3,09/22/2023,Deposit,4NE28628HT7618908,04 PAYPAL GENERAL UNRESTR,"Subject: Support Ukraine
Transaction ID: 4NE28628HT7618908
https://www.paypal.com/activity/payment/4NE28628HT7618908",PayPal Bank 3,--,$29.53,"$965,623.33"
Donations directed by individuals,09/22/2023,Deposit,4NE28628HT7618908,04 PAYPAL GENERAL UNRESTR,Money in to PayPal,Contributed income:Donations directed by individuals,PayPal Bank 3,$31.40,"$965,654.73"
PayPal Fees,09/22/2023,Deposit,4NE28628HT7618908,04 PAYPAL GENERAL UNRESTR,PayPal fees,OFFICE/GENERAL ADMINISTRATIVE EXPENSES:PayPal Fees,PayPal Bank 3,$1.87,"$965,656.60"
PayPal Bank 3,09/22/2023,Deposit,9VS7331018499004H,08 VICTORY DRONES RESTR,"Subject: GeneralPage
Note: For Victory Drones! Слава Україні!
Transaction ID: 9VS7331018499004H
https://www.paypal.com/activity/payment/9VS7331018499004H",PayPal Bank 3,--,$246.13,"$965,902.73"
Donations directed by individuals,09/22/2023,Deposit,9VS7331018499004H,08 VICTORY DRONES RESTR,Support Ukraine - Support Ukraine,Contributed income:Donations directed by individuals,PayPal Bank 3,$257.94,"$966,160.67"
PayPal Fees,09/22/2023,Deposit,9VS7331018499004H,08 VICTORY DRONES RESTR,PayPal fees,OFFICE/GENERAL ADMINISTRATIVE EXPENSES:PayPal Fees,PayPal Bank 3,$11.81,"$966,172.48"
PayPal Bank 3,09/22/2023,Deposit,9S703561N7594014R,04 PAYPAL GENERAL UNRESTR,"Subject: GeneralPage
Transaction ID: 9S703561N7594014R
https://www.paypal.com/activity/payment/9S703561N7594014R",PayPal Bank 3,--,$147.68,"$966,320.16"
Donations directed by individuals,09/22/2023,Deposit,9S703561N7594014R,04 PAYPAL GENERAL UNRESTR,Support Ukraine - Support Ukraine,Contributed income:Donations directed by individuals,PayPal Bank 3,$154.97,"$966,475.13"
PayPal Fees,09/22/2023,Deposit,9S703561N7594014R,04 PAYPAL GENERAL UNRESTR,PayPal fees,OFFICE/GENERAL ADMINISTRATIVE EXPENSES:PayPal Fees,PayPal Bank 3,$7.29,"$966,482.42"
PayPal Bank 3,09/22/2023,Deposit,57E40748W0072523J,04 PAYPAL GENERAL UNRESTR,"Subject: GeneralPage
Note: Україна переможе! Дякую вам.
Transaction ID: 57E40748W0072523J
https://www.paypal.com/activity/payment/57E40748W0072523J",PayPal Bank 3,--,$98.45,"$966,580.87"
Donations directed by individuals,09/22/2023,Deposit,57E40748W0072523J,04 PAYPAL GENERAL UNRESTR,Support Ukraine - Support Ukraine,Contributed income:Donations directed by individuals,PayPal Bank 3,$103.48,"$966,684.35"
PayPal Fees,09/22/2023,Deposit,57E40748W0072523J,04 PAYPAL GENERAL UNRESTR,PayPal fees,OFFICE/GENERAL ADMINISTRATIVE EXPENSES:PayPal Fees,PayPal Bank 3,$5.03,"$966,689.38"
PayPal Bank 3,09/22/2023,Deposit,6DW31737BH104914M,08 VICTORY DRONES RESTR,"Subject: VictoryDrones
Note: Victory drones
Transaction ID: 6DW31737BH104914M
https://www.paypal.com/activity/payment/6DW31737BH104914M",PayPal Bank 3,--,$193.73,"$966,883.11"
Donations directed by individuals,09/22/2023,Deposit,6DW31737BH104914M,08 VICTORY DRONES RESTR,VICTORY DRONES - VICTORY DRONES,Contributed income:Donations directed by individuals,PayPal Bank 3,$200.00,"$967,083.11"
PayPal Fees,09/22/2023,Deposit,6DW31737BH104914M,08 VICTORY DRONES RESTR,PayPal fees,OFFICE/GENERAL ADMINISTRATIVE EXPENSES:PayPal Fees,PayPal Bank 3,$6.27,"$967,089.38"
PayPal Bank 3,09/22/2023,Deposit,4XJ339189N125715B,04 PAYPAL GENERAL UNRESTR,"Subject: GeneralPage
Transaction ID: 4XJ339189N125715B
https://www.paypal.com/activity/payment/4XJ339189N125715B",PayPal Bank 3,--,$49.22,"$967,138.60"
Donations directed by individuals,09/22/2023,Deposit,4XJ339189N125715B,04 PAYPAL GENERAL UNRESTR,Support Ukraine - Support Ukraine,Contributed income:Donations directed by individuals,PayPal Bank 3,$51.99,"$967,190.59"
PayPal Fees,09/22/2023,Deposit,4XJ339189N125715B,04 PAYPAL GENERAL UNRESTR,PayPal fees,OFFICE/GENERAL ADMINISTRATIVE EXPENSES:PayPal Fees,PayPal Bank 3,$2.77,"$967,193.36"
PayPal Bank 3,09/22/2023,Deposit,9FF150987J782572T,04 PAYPAL GENERAL UNRESTR,"Subject: GeneralPage
Transaction ID: 9FF150987J782572T
https://www.paypal.com/activity/payment/9FF150987J782572T",PayPal Bank 3,--,$66.44,"$967,259.80"
Donations directed by individuals,09/22/2023,Deposit,9FF150987J782572T,04 PAYPAL GENERAL UNRESTR,Support Ukraine - Support Ukraine,Contributed income:Donations directed by individuals,PayPal Bank 3,$70.00,"$967,329.80"
PayPal Fees,09/22/2023,Deposit,9FF150987J782572T,04 PAYPAL GENERAL UNRESTR,PayPal fees,OFFICE/GENERAL ADMINISTRATIVE EXPENSES:PayPal Fees,PayPal Bank 3,$3.56,"$967,333.36"
PayPal Bank 3,09/22/2023,Deposit,9E318041SD988684F,04 PAYPAL GENERAL UNRESTR,"Subject: GeneralPage
Transaction ID: 9E318041SD988684F
https://www.paypal.com/activity/payment/9E318041SD988684F",PayPal Bank 3,--,$98.45,"$967,431.81"
Donations directed by individuals,09/22/2023,Deposit,9E318041SD988684F,04 PAYPAL GENERAL UNRESTR,Support Ukraine - Support Ukraine,Contributed income:Donations directed by individuals,PayPal Bank 3,$103.48,"$967,535.29"
PayPal Fees,09/22/2023,Deposit,9E318041SD988684F,04 PAYPAL GENERAL UNRESTR,PayPal fees,OFFICE/GENERAL ADMINISTRATIVE EXPENSES:PayPal Fees,PayPal Bank 3,$5.03,"$967,540.32"
PayPal Bank 3,09/22/2023,Deposit,1N261110U16825830,04 PAYPAL GENERAL UNRESTR,"Subject: GeneralPage
Transaction ID: 1N261110U16825830
https://www.paypal.com/activity/payment/1N261110U16825830",PayPal Bank 3,--,$49.22,"$967,589.54"
Donations directed by individuals,09/22/2023,Deposit,1N261110U16825830,04 PAYPAL GENERAL UNRESTR,Support Ukraine - Support Ukraine,Contributed income:Donations directed by individuals,PayPal Bank 3,$51.99,"$967,641.53"
PayPal Fees,09/22/2023,Deposit,1N261110U16825830,04 PAYPAL GENERAL UNRESTR,PayPal fees,OFFICE/GENERAL ADMINISTRATIVE EXPENSES:PayPal Fees,PayPal Bank 3,$2.77,"$967,644.30"
PayPal Bank 3,09/22/2023,Deposit,5U597245KM0471218,04 PAYPAL GENERAL UNRESTR,"Subject: GeneralPage
Transaction ID: 5U597245KM0471218
https://www.paypal.com/activity/payment/5U597245KM0471218",PayPal Bank 3,--,$20.54,"$967,664.84"
Donations directed by individuals,09/22/2023,Deposit,5U597245KM0471218,04 PAYPAL GENERAL UNRESTR,Support Ukraine - Support Ukraine,Contributed income:Donations directed by individuals,PayPal Bank 3,$22.00,"$967,686.84"
PayPal Fees,09/22/2023,Deposit,5U597245KM0471218,04 PAYPAL GENERAL UNRESTR,PayPal fees,OFFICE/GENERAL ADMINISTRATIVE EXPENSES:PayPal Fees,PayPal Bank 3,$1.46,"$967,688.30"
PayPal Bank 3,09/22/2023,Deposit,6T226983A28775126,04 PAYPAL GENERAL UNRESTR,"Subject: GeneralPage
Transaction ID: 6T226983A28775126
https://www.paypal.com/activity/payment/6T226983A28775126",PayPal Bank 3,--,$300.00,"$967,988.30"
Donations directed by individuals,09/22/2023,Deposit,6T226983A28775126,04 PAYPAL GENERAL UNRESTR,Support Ukraine - Support Ukraine,Contributed income:Donations directed by individuals,PayPal Bank 3,$309.43,"$968,297.73"
PayPal Fees,09/22/2023,Deposit,6T226983A28775126,04 PAYPAL GENERAL UNRESTR,PayPal fees,OFFICE/GENERAL ADMINISTRATIVE EXPENSES:PayPal Fees,PayPal Bank 3,$9.43,"$968,307.16"
PayPal Bank 3,09/22/2023,Deposit,9XM70327342792451,07 1000 DRONES RESTR,"Subject: 1000DRONES
Transaction ID: 9XM70327342792451
https://www.paypal.com/activity/payment/9XM70327342792451",PayPal Bank 3,--,$49.22,"$968,356.38"
Donations directed by individuals,09/22/2023,Deposit,9XM70327342792451,07 1000 DRONES RESTR,1000 DRONES FOR UKRAINE - 1000 DRONES FOR UKRAINE,Contributed income:Donations directed by individuals,PayPal Bank 3,$51.99,"$968,408.37"
PayPal Fees,09/22/2023,Deposit,9XM70327342792451,07 1000 DRONES RESTR,PayPal fees,OFFICE/GENERAL ADMINISTRATIVE EXPENSES:PayPal Fees,PayPal Bank 3,$2.77,"$968,411.14"
PayPal Bank 3,09/22/2023,Deposit,1AW929158P195604W,04 PAYPAL GENERAL UNRESTR,"Subject: Support Ukraine
Transaction ID: 1AW929158P195604W
https://www.paypal.com/activity/payment/1AW929158P195604W",PayPal Bank 3,--,$4.29,"$968,415.43"
Donations directed by individuals,09/22/2023,Deposit,1AW929158P195604W,04 PAYPAL GENERAL UNRESTR,Money in to PayPal,Contributed income:Donations directed by individuals,PayPal Bank 3,$5.00,"$968,420.43"
PayPal Fees,09/22/2023,Deposit,1AW929158P195604W,04 PAYPAL GENERAL UNRESTR,PayPal fees,OFFICE/GENERAL ADMINISTRATIVE EXPENSES:PayPal Fees,PayPal Bank 3,$0.71,"$968,421.14"
PayPal Bank 3,09/22/2023,Deposit,83J82022CS994471R,04 PAYPAL GENERAL UNRESTR,"Subject: GeneralPage
Transaction ID: 83J82022CS994471R
https://www.paypal.com/activity/payment/83J82022CS994471R",PayPal Bank 3,--,$500.00,"$968,921.14"
Donations directed by individuals,09/22/2023,Deposit,83J82022CS994471R,04 PAYPAL GENERAL UNRESTR,Support Ukraine - Support Ukraine,Contributed income:Donations directed by individuals,PayPal Bank 3,$515.38,"$969,436.52"
PayPal Fees,09/22/2023,Deposit,83J82022CS994471R,04 PAYPAL GENERAL UNRESTR,PayPal fees,OFFICE/GENERAL ADMINISTRATIVE EXPENSES:PayPal Fees,PayPal Bank 3,$15.38,"$969,451.90"
PayPal Bank 3,09/22/2023,Deposit,65N01829HV1731325,04 PAYPAL GENERAL UNRESTR,"Subject: GeneralPage
Transaction ID: 65N01829HV1731325
https://www.paypal.com/activity/payment/65N01829HV1731325",PayPal Bank 3,--,$49.22,"$969,501.12"
Donations directed by individuals,09/22/2023,Deposit,65N01829HV1731325,04 PAYPAL GENERAL UNRESTR,Support Ukraine - Support Ukraine,Contributed income:Donations directed by individuals,PayPal Bank 3,$51.99,"$969,553.11"
PayPal Fees,09/22/2023,Deposit,65N01829HV1731325,04 PAYPAL GENERAL UNRESTR,PayPal fees,OFFICE/GENERAL ADMINISTRATIVE EXPENSES:PayPal Fees,PayPal Bank 3,$2.77,"$969,555.88"
PayPal Bank 3,09/22/2023,Deposit,76E80618MD4962041,07 1000 DRONES RESTR,"Subject: 1000DRONES
Transaction ID: 76E80618MD4962041
https://www.paypal.com/activity/payment/76E80618MD4962041",PayPal Bank 3,--,$49.22,"$969,605.10"
Donations directed by individuals,09/22/2023,Deposit,76E80618MD4962041,07 1000 DRONES RESTR,1000 DRONES FOR UKRAINE - 1000 DRONES FOR UKRAINE,Contributed income:Donations directed by individuals,PayPal Bank 3,$51.99,"$969,657.09"
PayPal Fees,09/22/2023,Deposit,76E80618MD4962041,07 1000 DRONES RESTR,PayPal fees,OFFICE/GENERAL ADMINISTRATIVE EXPENSES:PayPal Fees,PayPal Bank 3,$2.77,"$969,659.86"
PayPal Bank 3,09/22/2023,Deposit,41V1083753730805F,04 PAYPAL GENERAL UNRESTR,"Subject: GeneralPage
Transaction ID: 41V1083753730805F
https://www.paypal.com/activity/payment/41V1083753730805F",PayPal Bank 3,--,$18.93,"$969,678.79"
Donations directed by individuals,09/22/2023,Deposit,41V1083753730805F,04 PAYPAL GENERAL UNRESTR,Support Ukraine - Support Ukraine,Contributed income:Donations directed by individuals,PayPal Bank 3,$20.00,"$969,698.79"
PayPal Fees,09/22/2023,Deposit,41V1083753730805F,04 PAYPAL GENERAL UNRESTR,PayPal fees,OFFICE/GENERAL ADMINISTRATIVE EXPENSES:PayPal Fees,PayPal Bank 3,$1.07,"$969,699.86"
PayPal Bank 3,09/22/2023,Deposit,3SU43664C50138107,04 PAYPAL GENERAL UNRESTR,"Subject: GeneralPage
Transaction ID: 3SU43664C50138107
https://www.paypal.com/activity/payment/3SU43664C50138107",PayPal Bank 3,--,$20.00,"$969,719.86"
Donations directed by individuals,09/22/2023,Deposit,3SU43664C50138107,04 PAYPAL GENERAL UNRESTR,Support Ukraine - Support Ukraine,Contributed income:Donations directed by individuals,PayPal Bank 3,$21.10,"$969,740.96"
PayPal Fees,09/22/2023,Deposit,3SU43664C50138107,04 PAYPAL GENERAL UNRESTR,PayPal fees,OFFICE/GENERAL ADMINISTRATIVE EXPENSES:PayPal Fees,PayPal Bank 3,$1.10,"$969,742.06"
PayPal Bank 3,09/22/2023,Deposit,3Y9551256X1186001,07 1000 DRONES RESTR,"Subject: 1000DRONES
Transaction ID: 3Y9551256X1186001
https://www.paypal.com/activity/payment/3Y9551256X1186001",PayPal Bank 3,--,$196.91,"$969,938.97"
Donations directed by individuals,09/22/2023,Deposit,3Y9551256X1186001,07 1000 DRONES RESTR,1000 DRONES FOR UKRAINE - 1000 DRONES FOR UKRAINE,Contributed income:Donations directed by individuals,PayPal Bank 3,$206.46,"$970,145.43"
PayPal Fees,09/22/2023,Deposit,3Y9551256X1186001,07 1000 DRONES RESTR,PayPal fees,OFFICE/GENERAL ADMINISTRATIVE EXPENSES:PayPal Fees,PayPal Bank 3,$9.55,"$970,154.98"
PayPal Bank 3,09/22/2023,Deposit,49V12490S3183652S,04 PAYPAL GENERAL UNRESTR,"Subject: GeneralPage
Transaction ID: 49V12490S3183652S
https://www.paypal.com/activity/payment/49V12490S3183652S",PayPal Bank 3,--,$106.33,"$970,261.31"
Donations directed by individuals,09/22/2023,Deposit,49V12490S3183652S,04 PAYPAL GENERAL UNRESTR,Support Ukraine - Support Ukraine,Contributed income:Donations directed by individuals,PayPal Bank 3,$110.00,"$970,371.31"
PayPal Fees,09/22/2023,Deposit,49V12490S3183652S,04 PAYPAL GENERAL UNRESTR,PayPal fees,OFFICE/GENERAL ADMINISTRATIVE EXPENSES:PayPal Fees,PayPal Bank 3,$3.67,"$970,374.98"
PayPal Bank 3,09/22/2023,Deposit,8Y840893KY298122U,07 1000 DRONES RESTR,"Subject: 1000DRONES
Transaction ID: 8Y840893KY298122U
https://www.paypal.com/activity/payment/8Y840893KY298122U",PayPal Bank 3,--,$100.00,"$970,474.98"
Donations directed by individuals,09/22/2023,Deposit,8Y840893KY298122U,07 1000 DRONES RESTR,1000 DRONES FOR UKRAINE - 1000 DRONES FOR UKRAINE,Contributed income:Donations directed by individuals,PayPal Bank 3,$103.48,"$970,578.46"
PayPal Fees,09/22/2023,Deposit,8Y840893KY298122U,07 1000 DRONES RESTR,PayPal fees,OFFICE/GENERAL ADMINISTRATIVE EXPENSES:PayPal Fees,PayPal Bank 3,$3.48,"$970,581.94"
PayPal Bank 3,09/22/2023,Deposit,0PT420167H4669905,04 PAYPAL GENERAL UNRESTR,"Subject: GeneralPage
Transaction ID: 0PT420167H4669905
https://www.paypal.com/activity/payment/0PT420167H4669905",PayPal Bank 3,--,$13.85,"$970,595.79"
Donations directed by individuals,09/22/2023,Deposit,0PT420167H4669905,04 PAYPAL GENERAL UNRESTR,Support Ukraine - Support Ukraine,Contributed income:Donations directed by individuals,PayPal Bank 3,$15.00,"$970,610.79"
PayPal Fees,09/22/2023,Deposit,0PT420167H4669905,04 PAYPAL GENERAL UNRESTR,PayPal fees,OFFICE/GENERAL ADMINISTRATIVE EXPENSES:PayPal Fees,PayPal Bank 3,$1.15,"$970,611.94"
PayPal Bank 3,09/22/2023,Deposit,61489646BL707764A,04 PAYPAL GENERAL UNRESTR,"Subject: GeneralPage
Transaction ID: 61489646BL707764A
https://www.paypal.com/activity/payment/61489646BL707764A",PayPal Bank 3,--,$47.31,"$970,659.25"
Donations directed by individuals,09/22/2023,Deposit,61489646BL707764A,04 PAYPAL GENERAL UNRESTR,Support Ukraine - Support Ukraine,Contributed income:Donations directed by individuals,PayPal Bank 3,$50.00,"$970,709.25"
PayPal Fees,09/22/2023,Deposit,61489646BL707764A,04 PAYPAL GENERAL UNRESTR,PayPal fees,OFFICE/GENERAL ADMINISTRATIVE EXPENSES:PayPal Fees,PayPal Bank 3,$2.69,"$970,711.94"
PayPal Bank 3,09/22/2023,Deposit,2DY704725L279391V,04 PAYPAL GENERAL UNRESTR,"Subject: Support Ukraine
Transaction ID: 2DY704725L279391V
https://www.paypal.com/activity/payment/2DY704725L279391V",PayPal Bank 3,--,$50.00,"$970,761.94"
Donations directed by individuals,09/22/2023,Deposit,2DY704725L279391V,04 PAYPAL GENERAL UNRESTR,Money in to PayPal,Contributed income:Donations directed by individuals,PayPal Bank 3,$51.99,"$970,813.93"
PayPal Fees,09/22/2023,Deposit,2DY704725L279391V,04 PAYPAL GENERAL UNRESTR,PayPal fees,OFFICE/GENERAL ADMINISTRATIVE EXPENSES:PayPal Fees,PayPal Bank 3,$1.99,"$970,815.92"
PayPal Bank 3,09/22/2023,Deposit,058676124Y1689045,04 PAYPAL GENERAL UNRESTR,"Subject: GeneralPage
Note: Нищити русню!
Transaction ID: 058676124Y1689045
https://www.paypal.com/activity/payment/058676124Y1689045",PayPal Bank 3,--,$196.91,"$971,012.83"
Donations directed by individuals,09/22/2023,Deposit,058676124Y1689045,04 PAYPAL GENERAL UNRESTR,Support Ukraine - Support Ukraine,Contributed income:Donations directed by individuals,PayPal Bank 3,$206.46,"$971,219.29"
PayPal Fees,09/22/2023,Deposit,058676124Y1689045,04 PAYPAL GENERAL UNRESTR,PayPal fees,OFFICE/GENERAL ADMINISTRATIVE EXPENSES:PayPal Fees,PayPal Bank 3,$9.55,"$971,228.84"
PayPal Bank 3,09/22/2023,Deposit,32T35881WU2525456,07 1000 DRONES RESTR,"Subject: 1000DRONES
Note: З Днем Народження, Любо Шипович!
Transaction ID: 32T35881WU2525456
https://www.paypal.com/activity/payment/32T35881WU2525456",PayPal Bank 3,--,$100.00,"$971,328.84"
Donations directed by individuals,09/22/2023,Deposit,32T35881WU2525456,07 1000 DRONES RESTR,1000 DRONES FOR UKRAINE - 1000 DRONES FOR UKRAINE,Contributed income:Donations directed by individuals,PayPal Bank 3,$103.48,"$971,432.32"
PayPal Fees,09/22/2023,Deposit,32T35881WU2525456,07 1000 DRONES RESTR,PayPal fees,OFFICE/GENERAL ADMINISTRATIVE EXPENSES:PayPal Fees,PayPal Bank 3,$3.48,"$971,435.80"
PayPal Bank 3,09/22/2023,Deposit,83407418C0310890F,07 1000 DRONES RESTR,"Subject: 1000DRONES
Transaction ID: 83407418C0310890F
https://www.paypal.com/activity/payment/83407418C0310890F",PayPal Bank 3,--,$98.45,"$971,534.25"
Donations directed by individuals,09/22/2023,Deposit,83407418C0310890F,07 1000 DRONES RESTR,1000 DRONES FOR UKRAINE - 1000 DRONES FOR UKRAINE,Contributed income:Donations directed by individuals,PayPal Bank 3,$103.48,"$971,637.73"
PayPal Fees,09/22/2023,Deposit,83407418C0310890F,07 1000 DRONES RESTR,PayPal fees,OFFICE/GENERAL ADMINISTRATIVE EXPENSES:PayPal Fees,PayPal Bank 3,$5.03,"$971,642.76"
PayPal Bank 3,09/22/2023,Deposit,4X4680358N101271N,04 PAYPAL GENERAL UNRESTR,"Subject: GeneralPage
Note: test (but drones)
Transaction ID: 4X4680358N101271N
https://www.paypal.com/activity/payment/4X4680358N101271N",PayPal Bank 3,--,$9.22,"$971,651.98"
Donations directed by individuals,09/22/2023,Deposit,4X4680358N101271N,04 PAYPAL GENERAL UNRESTR,Support Ukraine - Support Ukraine,Contributed income:Donations directed by individuals,PayPal Bank 3,$10.00,"$971,661.98"
PayPal Fees,09/22/2023,Deposit,4X4680358N101271N,04 PAYPAL GENERAL UNRESTR,PayPal fees,OFFICE/GENERAL ADMINISTRATIVE EXPENSES:PayPal Fees,PayPal Bank 3,$0.78,"$971,662.76"
PayPal Bank 3,09/22/2023,Deposit,64C982311K8830128,04 PAYPAL GENERAL UNRESTR,"Subject: GeneralPage
Transaction ID: 64C982311K8830128
https://www.paypal.com/activity/payment/64C982311K8830128",PayPal Bank 3,--,$48.06,"$971,710.82"
Donations directed by individuals,09/22/2023,Deposit,64C982311K8830128,04 PAYPAL GENERAL UNRESTR,Support Ukraine - Support Ukraine,Contributed income:Donations directed by individuals,PayPal Bank 3,$50.00,"$971,760.82"
PayPal Fees,09/22/2023,Deposit,64C982311K8830128,04 PAYPAL GENERAL UNRESTR,PayPal fees,OFFICE/GENERAL ADMINISTRATIVE EXPENSES:PayPal Fees,PayPal Bank 3,$1.94,"$971,762.76"
PayPal Bank 3,09/22/2023,Deposit,2636058282394482F,04 PAYPAL GENERAL UNRESTR,"Subject: Support Ukraine
Transaction ID: 2636058282394482F
https://www.paypal.com/activity/payment/2636058282394482F",PayPal Bank 3,--,$190.73,"$971,953.49"
Donations directed by individuals,09/22/2023,Deposit,2636058282394482F,04 PAYPAL GENERAL UNRESTR,Money in to PayPal,Contributed income:Donations directed by individuals,PayPal Bank 3,$200.00,"$972,153.49"
PayPal Fees,09/22/2023,Deposit,2636058282394482F,04 PAYPAL GENERAL UNRESTR,PayPal fees,OFFICE/GENERAL ADMINISTRATIVE EXPENSES:PayPal Fees,PayPal Bank 3,$9.27,"$972,162.76"
PayPal Bank 3,09/22/2023,Deposit,3EV33143HF0267404,04 PAYPAL GENERAL UNRESTR,"Subject: Support Ukraine
Transaction ID: 3EV33143HF0267404
https://www.paypal.com/activity/payment/3EV33143HF0267404",PayPal Bank 3,--,$29.53,"$972,192.29"
Donations directed by individuals,09/22/2023,Deposit,3EV33143HF0267404,04 PAYPAL GENERAL UNRESTR,Money in to PayPal,Contributed income:Donations directed by individuals,PayPal Bank 3,$31.40,"$972,223.69"
PayPal Fees,09/22/2023,Deposit,3EV33143HF0267404,04 PAYPAL GENERAL UNRESTR,PayPal fees,OFFICE/GENERAL ADMINISTRATIVE EXPENSES:PayPal Fees,PayPal Bank 3,$1.87,"$972,225.56"
PayPal Bank 3,09/22/2023,Deposit,0NC46849FC796934H,04 PAYPAL GENERAL UNRESTR,"Subject: GeneralPage
Transaction ID: 0NC46849FC796934H
https://www.paypal.com/activity/payment/0NC46849FC796934H",PayPal Bank 3,--,$19.68,"$972,245.24"
Donations directed by individuals,09/22/2023,Deposit,0NC46849FC796934H,04 PAYPAL GENERAL UNRESTR,Support Ukraine - Support Ukraine,Contributed income:Donations directed by individuals,PayPal Bank 3,$21.10,"$972,266.34"
PayPal Fees,09/22/2023,Deposit,0NC46849FC796934H,04 PAYPAL GENERAL UNRESTR,PayPal fees,OFFICE/GENERAL ADMINISTRATIVE EXPENSES:PayPal Fees,PayPal Bank 3,$1.42,"$972,267.76"
PayPal Bank 3,09/22/2023,Deposit,00J142725F697602C,04 PAYPAL GENERAL UNRESTR,"Subject: GeneralPage
Transaction ID: 00J142725F697602C
https://www.paypal.com/activity/payment/00J142725F697602C",PayPal Bank 3,--,$98.45,"$972,366.21"
Donations directed by individuals,09/22/2023,Deposit,00J142725F697602C,04 PAYPAL GENERAL UNRESTR,Support Ukraine - Support Ukraine,Contributed income:Donations directed by individuals,PayPal Bank 3,$103.48,"$972,469.69"
PayPal Fees,09/22/2023,Deposit,00J142725F697602C,04 PAYPAL GENERAL UNRESTR,PayPal fees,OFFICE/GENERAL ADMINISTRATIVE EXPENSES:PayPal Fees,PayPal Bank 3,$5.03,"$972,474.72"
PayPal Bank 3,09/22/2023,Deposit,67Y37778X6923745X,04 PAYPAL GENERAL UNRESTR,"Subject: Support Ukraine
Transaction ID: 67Y37778X6923745X
https://www.paypal.com/activity/payment/67Y37778X6923745X",PayPal Bank 3,--,$47.31,"$972,522.03"
Donations directed by individuals,09/22/2023,Deposit,67Y37778X6923745X,04 PAYPAL GENERAL UNRESTR,Money in to PayPal,Contributed income:Donations directed by individuals,PayPal Bank 3,$50.00,"$972,572.03"
PayPal Fees,09/22/2023,Deposit,67Y37778X6923745X,04 PAYPAL GENERAL UNRESTR,PayPal fees,OFFICE/GENERAL ADMINISTRATIVE EXPENSES:PayPal Fees,PayPal Bank 3,$2.69,"$972,574.72"
PayPal Bank 3,09/22/2023,Deposit,9NX78933WR082700M,04 PAYPAL GENERAL UNRESTR,"Subject: Support Ukraine
Transaction ID: 9NX78933WR082700M
https://www.paypal.com/activity/payment/9NX78933WR082700M",PayPal Bank 3,--,$23.41,"$972,598.13"
Donations directed by individuals,09/22/2023,Deposit,9NX78933WR082700M,04 PAYPAL GENERAL UNRESTR,Money in to PayPal,Contributed income:Donations directed by individuals,PayPal Bank 3,$25.00,"$972,623.13"
PayPal Fees,09/22/2023,Deposit,9NX78933WR082700M,04 PAYPAL GENERAL UNRESTR,PayPal fees,OFFICE/GENERAL ADMINISTRATIVE EXPENSES:PayPal Fees,PayPal Bank 3,$1.59,"$972,624.72"
PayPal Bank 3,09/22/2023,Deposit,2CY56271VD704912V,04 PAYPAL GENERAL UNRESTR,"Subject: Support Ukraine
Transaction ID: 2CY56271VD704912V
https://www.paypal.com/activity/payment/2CY56271VD704912V",PayPal Bank 3,--,$18.63,"$972,643.35"
Donations directed by individuals,09/22/2023,Deposit,2CY56271VD704912V,04 PAYPAL GENERAL UNRESTR,Money in to PayPal,Contributed income:Donations directed by individuals,PayPal Bank 3,$20.00,"$972,663.35"
PayPal Fees,09/22/2023,Deposit,2CY56271VD704912V,04 PAYPAL GENERAL UNRESTR,PayPal fees,OFFICE/GENERAL ADMINISTRATIVE EXPENSES:PayPal Fees,PayPal Bank 3,$1.37,"$972,664.72"
PayPal Bank 3,09/22/2023,Deposit,1B395927SN6996818,04 PAYPAL GENERAL UNRESTR,"Subject: Support Ukraine
Transaction ID: 1B395927SN6996818
https://www.paypal.com/activity/payment/1B395927SN6996818",PayPal Bank 3,--,$4.91,"$972,669.63"
Donations directed by individuals,09/22/2023,Deposit,1B395927SN6996818,04 PAYPAL GENERAL UNRESTR,Money in to PayPal,Contributed income:Donations directed by individuals,PayPal Bank 3,$5.65,"$972,675.28"
PayPal Fees,09/22/2023,Deposit,1B395927SN6996818,04 PAYPAL GENERAL UNRESTR,PayPal fees,OFFICE/GENERAL ADMINISTRATIVE EXPENSES:PayPal Fees,PayPal Bank 3,$0.74,"$972,676.02"
PayPal Bank 3,09/22/2023,Deposit,27258365JS642482E,04 PAYPAL GENERAL UNRESTR,"Subject: GeneralPage
Transaction ID: 27258365JS642482E
https://www.paypal.com/activity/payment/27258365JS642482E",PayPal Bank 3,--,$284.71,"$972,960.73"
Donations directed by individuals,09/22/2023,Deposit,27258365JS642482E,04 PAYPAL GENERAL UNRESTR,Support Ukraine - Support Ukraine,Contributed income:Donations directed by individuals,PayPal Bank 3,$298.30,"$973,259.03"
PayPal Fees,09/22/2023,Deposit,27258365JS642482E,04 PAYPAL GENERAL UNRESTR,PayPal fees,OFFICE/GENERAL ADMINISTRATIVE EXPENSES:PayPal Fees,PayPal Bank 3,$13.59,"$973,272.62"
PayPal Bank 3,09/22/2023,Deposit,61841628J4912041A,09 MSU RESTR,"Subject: MobileShowers
Transaction ID: 61841628J4912041A
https://www.paypal.com/activity/payment/61841628J4912041A",PayPal Bank 3,--,$96.62,"$973,369.24"
Donations directed by individuals,09/22/2023,Deposit,61841628J4912041A,09 MSU RESTR,Mobile Shower/Laundry Units - Mobile Shower/Laundry Units,Contributed income:Donations directed by individuals,PayPal Bank 3,$100.00,"$973,469.24"
PayPal Fees,09/22/2023,Deposit,61841628J4912041A,09 MSU RESTR,PayPal fees,OFFICE/GENERAL ADMINISTRATIVE EXPENSES:PayPal Fees,PayPal Bank 3,$3.38,"$973,472.62"
PayPal Bank 3,09/22/2023,Deposit,0C59898945601080G,04 PAYPAL GENERAL UNRESTR,"Subject: GeneralPage
Transaction ID: 0C59898945601080G
https://www.paypal.com/activity/payment/0C59898945601080G",PayPal Bank 3,--,$0.47,"$973,473.09"
Donations directed by individuals,09/22/2023,Deposit,0C59898945601080G,04 PAYPAL GENERAL UNRESTR,Support Ukraine - Support Ukraine,Contributed income:Donations directed by individuals,PayPal Bank 3,$1.00,"$973,474.09"
PayPal Fees,09/22/2023,Deposit,0C59898945601080G,04 PAYPAL GENERAL UNRESTR,PayPal fees,OFFICE/GENERAL ADMINISTRATIVE EXPENSES:PayPal Fees,PayPal Bank 3,$0.53,"$973,474.62"
PayPal Bank 3,09/22/2023,Deposit,0PC837507H261180U,04 PAYPAL GENERAL UNRESTR,"Subject: GeneralPage
Transaction ID: 0PC837507H261180U
https://www.paypal.com/activity/payment/0PC837507H261180U",PayPal Bank 3,--,$100.00,"$973,574.62"
Donations directed by individuals,09/22/2023,Deposit,0PC837507H261180U,04 PAYPAL GENERAL UNRESTR,Support Ukraine - Support Ukraine,Contributed income:Donations directed by individuals,PayPal Bank 3,$103.48,"$973,678.10"
PayPal Fees,09/22/2023,Deposit,0PC837507H261180U,04 PAYPAL GENERAL UNRESTR,PayPal fees,OFFICE/GENERAL ADMINISTRATIVE EXPENSES:PayPal Fees,PayPal Bank 3,$3.48,"$973,681.58"
PayPal Bank 3,09/22/2023,Deposit,6BS578075R959133K,04 PAYPAL GENERAL UNRESTR,"Subject: Support Ukraine
Transaction ID: 6BS578075R959133K
https://www.paypal.com/activity/payment/6BS578075R959133K",PayPal Bank 3,--,$68.35,"$973,749.93"
Donations directed by individuals,09/22/2023,Deposit,6BS578075R959133K,04 PAYPAL GENERAL UNRESTR,Money in to PayPal,Contributed income:Donations directed by individuals,PayPal Bank 3,$72.00,"$973,821.93"
PayPal Fees,09/22/2023,Deposit,6BS578075R959133K,04 PAYPAL GENERAL UNRESTR,PayPal fees,OFFICE/GENERAL ADMINISTRATIVE EXPENSES:PayPal Fees,PayPal Bank 3,$3.65,"$973,825.58"
PayPal Bank 3,09/22/2023,Deposit,20237340KV493331P,07 1000 DRONES RESTR,"Subject: 1000DRONES
Transaction ID: 20237340KV493331P
https://www.paypal.com/activity/payment/20237340KV493331P",PayPal Bank 3,--,$96.62,"$973,922.20"
Donations directed by individuals,09/22/2023,Deposit,20237340KV493331P,07 1000 DRONES RESTR,1000 DRONES FOR UKRAINE - 1000 DRONES FOR UKRAINE,Contributed income:Donations directed by individuals,PayPal Bank 3,$100.00,"$974,022.20"
PayPal Fees,09/22/2023,Deposit,20237340KV493331P,07 1000 DRONES RESTR,PayPal fees,OFFICE/GENERAL ADMINISTRATIVE EXPENSES:PayPal Fees,PayPal Bank 3,$3.38,"$974,025.58"
PayPal Bank 3,09/22/2023,Deposit,2K246371S2833063W,04 PAYPAL GENERAL UNRESTR,"Subject: GeneralPage
Transaction ID: 2K246371S2833063W
https://www.paypal.com/activity/payment/2K246371S2833063W",PayPal Bank 3,--,$14.76,"$974,040.34"
Donations directed by individuals,09/22/2023,Deposit,2K246371S2833063W,04 PAYPAL GENERAL UNRESTR,Support Ukraine - Support Ukraine,Contributed income:Donations directed by individuals,PayPal Bank 3,$15.95,"$974,056.29"
PayPal Fees,09/22/2023,Deposit,2K246371S2833063W,04 PAYPAL GENERAL UNRESTR,PayPal fees,OFFICE/GENERAL ADMINISTRATIVE EXPENSES:PayPal Fees,PayPal Bank 3,$1.19,"$974,057.48"
PayPal Bank 3,09/22/2023,Deposit,2PT56001K0682042R,04 PAYPAL GENERAL UNRESTR,"Subject: GeneralPage
Transaction ID: 2PT56001K0682042R
https://www.paypal.com/activity/payment/2PT56001K0682042R",PayPal Bank 3,--,$19.68,"$974,077.16"
Donations directed by individuals,09/22/2023,Deposit,2PT56001K0682042R,04 PAYPAL GENERAL UNRESTR,Support Ukraine - Support Ukraine,Contributed income:Donations directed by individuals,PayPal Bank 3,$21.10,"$974,098.26"
PayPal Fees,09/22/2023,Deposit,2PT56001K0682042R,04 PAYPAL GENERAL UNRESTR,PayPal fees,OFFICE/GENERAL ADMINISTRATIVE EXPENSES:PayPal Fees,PayPal Bank 3,$1.42,"$974,099.68"
PayPal Bank 3,09/22/2023,Deposit,57Y34941DT708264U,04 PAYPAL GENERAL UNRESTR,"Subject: GeneralPage
Note: З Днем народження)))�
Transaction ID: 57Y34941DT708264U
https://www.paypal.com/activity/payment/57Y34941DT708264U",PayPal Bank 3,--,$200.00,"$974,299.68"
Donations directed by individuals,09/22/2023,Deposit,57Y34941DT708264U,04 PAYPAL GENERAL UNRESTR,Support Ukraine - Support Ukraine,Contributed income:Donations directed by individuals,PayPal Bank 3,$206.46,"$974,506.14"
PayPal Fees,09/22/2023,Deposit,57Y34941DT708264U,04 PAYPAL GENERAL UNRESTR,PayPal fees,OFFICE/GENERAL ADMINISTRATIVE EXPENSES:PayPal Fees,PayPal Bank 3,$6.46,"$974,512.60"
PayPal Bank 3,09/22/2023,Deposit,0XS31101EJ8169012,04 PAYPAL GENERAL UNRESTR,"Subject: GeneralPage
Transaction ID: 0XS31101EJ8169012
https://www.paypal.com/activity/payment/0XS31101EJ8169012",PayPal Bank 3,--,$23.41,"$974,536.01"
Donations directed by individuals,09/22/2023,Deposit,0XS31101EJ8169012,04 PAYPAL GENERAL UNRESTR,Support Ukraine - Support Ukraine,Contributed income:Donations directed by individuals,PayPal Bank 3,$25.00,"$974,561.01"
PayPal Fees,09/22/2023,Deposit,0XS31101EJ8169012,04 PAYPAL GENERAL UNRESTR,PayPal fees,OFFICE/GENERAL ADMINISTRATIVE EXPENSES:PayPal Fees,PayPal Bank 3,$1.59,"$974,562.60"
PayPal Bank 3,09/22/2023,Deposit,51B546867K0736349,04 PAYPAL GENERAL UNRESTR,"Subject: Support Ukraine
Transaction ID: 51B546867K0736349
https://www.paypal.com/activity/payment/51B546867K0736349",PayPal Bank 3,--,$50.00,"$974,612.60"
Donations directed by individuals,09/22/2023,Deposit,51B546867K0736349,04 PAYPAL GENERAL UNRESTR,Money in to PayPal,Contributed income:Donations directed by individuals,PayPal Bank 3,$51.99,"$974,664.59"
PayPal Fees,09/22/2023,Deposit,51B546867K0736349,04 PAYPAL GENERAL UNRESTR,PayPal fees,OFFICE/GENERAL ADMINISTRATIVE EXPENSES:PayPal Fees,PayPal Bank 3,$1.99,"$974,666.58"
PayPal Bank 3,09/22/2023,Deposit,3JU54555E6068053N,04 PAYPAL GENERAL UNRESTR,"Subject: GeneralPage
Transaction ID: 3JU54555E6068053N
https://www.paypal.com/activity/payment/3JU54555E6068053N",PayPal Bank 3,--,$98.45,"$974,765.03"
Donations directed by individuals,09/22/2023,Deposit,3JU54555E6068053N,04 PAYPAL GENERAL UNRESTR,Support Ukraine - Support Ukraine,Contributed income:Donations directed by individuals,PayPal Bank 3,$103.48,"$974,868.51"
PayPal Fees,09/22/2023,Deposit,3JU54555E6068053N,04 PAYPAL GENERAL UNRESTR,PayPal fees,OFFICE/GENERAL ADMINISTRATIVE EXPENSES:PayPal Fees,PayPal Bank 3,$5.03,"$974,873.54"
PayPal Bank 3,09/22/2023,Deposit,5EH0736972589691N,07 1000 DRONES RESTR,"Subject: GeneralPage
Note: на дрони для рот ударних БПЛА.   З Днем Народження!
Transaction ID: 5EH0736972589691N
https://www.paypal.com/activity/payment/5EH0736972589691N",PayPal Bank 3,--,$40.00,"$974,913.54"
Donations directed by individuals,09/22/2023,Deposit,5EH0736972589691N,07 1000 DRONES RESTR,Support Ukraine - Support Ukraine,Contributed income:Donations directed by individuals,PayPal Bank 3,$41.69,"$974,955.23"
PayPal Fees,09/22/2023,Deposit,5EH0736972589691N,07 1000 DRONES RESTR,PayPal fees,OFFICE/GENERAL ADMINISTRATIVE EXPENSES:PayPal Fees,PayPal Bank 3,$1.69,"$974,956.92"
PayPal Bank 3,09/22/2023,Deposit,01303884X7914430B,04 PAYPAL GENERAL UNRESTR,"Subject: GeneralPage
Note: ЗА ПЕРЕМОГУ!!!!
Transaction ID: 01303884X7914430B
https://www.paypal.com/activity/payment/01303884X7914430B",PayPal Bank 3,--,$96.62,"$975,053.54"
Donations directed by individuals,09/22/2023,Deposit,01303884X7914430B,04 PAYPAL GENERAL UNRESTR,Support Ukraine - Support Ukraine,Contributed income:Donations directed by individuals,PayPal Bank 3,$100.00,"$975,153.54"
PayPal Fees,09/22/2023,Deposit,01303884X7914430B,04 PAYPAL GENERAL UNRESTR,PayPal fees,OFFICE/GENERAL ADMINISTRATIVE EXPENSES:PayPal Fees,PayPal Bank 3,$3.38,"$975,156.92"
PayPal Bank 3,09/22/2023,Deposit,0DM94883L7387281S,04 PAYPAL GENERAL UNRESTR,"Subject: GeneralPage
Note: Тримайся, Люба! Може пом’ятаеш мене…
Transaction ID: 0DM94883L7387281S
https://www.paypal.com/activity/payment/0DM94883L7387281S",PayPal Bank 3,--,$96.62,"$975,253.54"
Donations directed by individuals,09/22/2023,Deposit,0DM94883L7387281S,04 PAYPAL GENERAL UNRESTR,Support Ukraine - Support Ukraine,Contributed income:Donations directed by individuals,PayPal Bank 3,$100.00,"$975,353.54"
PayPal Fees,09/22/2023,Deposit,0DM94883L7387281S,04 PAYPAL GENERAL UNRESTR,PayPal fees,OFFICE/GENERAL ADMINISTRATIVE EXPENSES:PayPal Fees,PayPal Bank 3,$3.38,"$975,356.92"
PayPal Bank 3,09/22/2023,Deposit,3SC17136LW391014S,04 PAYPAL GENERAL UNRESTR,"Subject: GeneralPage
Transaction ID: 3SC17136LW391014S
https://www.paypal.com/activity/payment/3SC17136LW391014S",PayPal Bank 3,--,$4.29,"$975,361.21"
Donations directed by individuals,09/22/2023,Deposit,3SC17136LW391014S,04 PAYPAL GENERAL UNRESTR,Support Ukraine - Support Ukraine,Contributed income:Donations directed by individuals,PayPal Bank 3,$5.00,"$975,366.21"
PayPal Fees,09/22/2023,Deposit,3SC17136LW391014S,04 PAYPAL GENERAL UNRESTR,PayPal fees,OFFICE/GENERAL ADMINISTRATIVE EXPENSES:PayPal Fees,PayPal Bank 3,$0.71,"$975,366.92"
PayPal Bank 3,09/22/2023,Deposit,7MB7968597946332P,04 PAYPAL GENERAL UNRESTR,"Subject: GeneralPage
Transaction ID: 7MB7968597946332P
https://www.paypal.com/activity/payment/7MB7968597946332P",PayPal Bank 3,--,$190.73,"$975,557.65"
Donations directed by individuals,09/22/2023,Deposit,7MB7968597946332P,04 PAYPAL GENERAL UNRESTR,Support Ukraine - Support Ukraine,Contributed income:Donations directed by individuals,PayPal Bank 3,$200.00,"$975,757.65"
PayPal Fees,09/22/2023,Deposit,7MB7968597946332P,04 PAYPAL GENERAL UNRESTR,PayPal fees,OFFICE/GENERAL ADMINISTRATIVE EXPENSES:PayPal Fees,PayPal Bank 3,$9.27,"$975,766.92"
PayPal Bank 3,09/22/2023,Deposit,9M1166777M785673U,04 PAYPAL GENERAL UNRESTR,"Subject: Support Ukraine
Transaction ID: 9M1166777M785673U
https://www.paypal.com/activity/payment/9M1166777M785673U",PayPal Bank 3,--,$47.31,"$975,814.23"
Donations directed by individuals,09/22/2023,Deposit,9M1166777M785673U,04 PAYPAL GENERAL UNRESTR,Money in to PayPal,Contributed income:Donations directed by individuals,PayPal Bank 3,$50.00,"$975,864.23"
PayPal Fees,09/22/2023,Deposit,9M1166777M785673U,04 PAYPAL GENERAL UNRESTR,PayPal fees,OFFICE/GENERAL ADMINISTRATIVE EXPENSES:PayPal Fees,PayPal Bank 3,$2.69,"$975,866.92"
PayPal Bank 3,09/22/2023,Deposit,7LL9406133599474N,04 PAYPAL GENERAL UNRESTR,"Subject: GeneralPage
Note: Lyuba's birthday
Transaction ID: 7LL9406133599474N
https://www.paypal.com/activity/payment/7LL9406133599474N",PayPal Bank 3,--,$36.00,"$975,902.92"
Donations directed by individuals,09/22/2023,Deposit,7LL9406133599474N,04 PAYPAL GENERAL UNRESTR,Support Ukraine - Support Ukraine,Contributed income:Donations directed by individuals,PayPal Bank 3,$37.58,"$975,940.50"
PayPal Fees,09/22/2023,Deposit,7LL9406133599474N,04 PAYPAL GENERAL UNRESTR,PayPal fees,OFFICE/GENERAL ADMINISTRATIVE EXPENSES:PayPal Fees,PayPal Bank 3,$1.58,"$975,942.08"
PayPal Bank 3,09/22/2023,Deposit,6YF83188VT3411648,04 PAYPAL GENERAL UNRESTR,"Subject: GeneralPage
Transaction ID: 6YF83188VT3411648
https://www.paypal.com/activity/payment/6YF83188VT3411648",PayPal Bank 3,--,$13.85,"$975,955.93"
Donations directed by individuals,09/22/2023,Deposit,6YF83188VT3411648,04 PAYPAL GENERAL UNRESTR,Support Ukraine - Support Ukraine,Contributed income:Donations directed by individuals,PayPal Bank 3,$15.00,"$975,970.93"
PayPal Fees,09/22/2023,Deposit,6YF83188VT3411648,04 PAYPAL GENERAL UNRESTR,PayPal fees,OFFICE/GENERAL ADMINISTRATIVE EXPENSES:PayPal Fees,PayPal Bank 3,$1.15,"$975,972.08"
PayPal Bank 3,09/22/2023,Deposit,5MN29950GY4716218,07 1000 DRONES RESTR,"Subject: 1000DRONES
Transaction ID: 5MN29950GY4716218
https://www.paypal.com/activity/payment/5MN29950GY4716218",PayPal Bank 3,--,$19.68,"$975,991.76"
Donations directed by individuals,09/22/2023,Deposit,5MN29950GY4716218,07 1000 DRONES RESTR,1000 DRONES FOR UKRAINE - 1000 DRONES FOR UKRAINE,Contributed income:Donations directed by individuals,PayPal Bank 3,$21.10,"$976,012.86"
PayPal Fees,09/22/2023,Deposit,5MN29950GY4716218,07 1000 DRONES RESTR,PayPal fees,OFFICE/GENERAL ADMINISTRATIVE EXPENSES:PayPal Fees,PayPal Bank 3,$1.42,"$976,014.28"
PayPal Bank 3,09/22/2023,Deposit,8F445094XW806482B,04 PAYPAL GENERAL UNRESTR,"Subject: GeneralPage
Transaction ID: 8F445094XW806482B
https://www.paypal.com/activity/payment/8F445094XW806482B",PayPal Bank 3,--,$50.00,"$976,064.28"
Donations directed by individuals,09/22/2023,Deposit,8F445094XW806482B,04 PAYPAL GENERAL UNRESTR,Support Ukraine - Support Ukraine,Contributed income:Donations directed by individuals,PayPal Bank 3,$51.99,"$976,116.27"
PayPal Fees,09/22/2023,Deposit,8F445094XW806482B,04 PAYPAL GENERAL UNRESTR,PayPal fees,OFFICE/GENERAL ADMINISTRATIVE EXPENSES:PayPal Fees,PayPal Bank 3,$1.99,"$976,118.26"
PayPal Bank 3,09/22/2023,Deposit,5YG57798EC0730455,04 PAYPAL GENERAL UNRESTR,"Subject: GeneralPage
Transaction ID: 5YG57798EC0730455
https://www.paypal.com/activity/payment/5YG57798EC0730455",PayPal Bank 3,--,$9.84,"$976,128.10"
Donations directed by individuals,09/22/2023,Deposit,5YG57798EC0730455,04 PAYPAL GENERAL UNRESTR,Support Ukraine - Support Ukraine,Contributed income:Donations directed by individuals,PayPal Bank 3,$10.80,"$976,138.90"
PayPal Fees,09/22/2023,Deposit,5YG57798EC0730455,04 PAYPAL GENERAL UNRESTR,PayPal fees,OFFICE/GENERAL ADMINISTRATIVE EXPENSES:PayPal Fees,PayPal Bank 3,$0.96,"$976,139.86"
PayPal Bank 3,09/22/2023,Deposit,5CF836038T654152T,04 PAYPAL GENERAL UNRESTR,"Subject: GeneralPage
Transaction ID: 5CF836038T654152T
https://www.paypal.com/activity/payment/5CF836038T654152T",PayPal Bank 3,--,$300.00,"$976,439.86"
Donations directed by individuals,09/22/2023,Deposit,5CF836038T654152T,04 PAYPAL GENERAL UNRESTR,Support Ukraine - Support Ukraine,Contributed income:Donations directed by individuals,PayPal Bank 3,$309.43,"$976,749.29"
PayPal Fees,09/22/2023,Deposit,5CF836038T654152T,04 PAYPAL GENERAL UNRESTR,PayPal fees,OFFICE/GENERAL ADMINISTRATIVE EXPENSES:PayPal Fees,PayPal Bank 3,$9.43,"$976,758.72"
PayPal Bank 3,09/22/2023,Deposit,5MX38849AE713991E,04 PAYPAL GENERAL UNRESTR,"Subject: GeneralPage
Transaction ID: 5MX38849AE713991E
https://www.paypal.com/activity/payment/5MX38849AE713991E",PayPal Bank 3,--,$96.62,"$976,855.34"
Donations directed by individuals,09/22/2023,Deposit,5MX38849AE713991E,04 PAYPAL GENERAL UNRESTR,Support Ukraine - Support Ukraine,Contributed income:Donations directed by individuals,PayPal Bank 3,$100.00,"$976,955.34"
PayPal Fees,09/22/2023,Deposit,5MX38849AE713991E,04 PAYPAL GENERAL UNRESTR,PayPal fees,OFFICE/GENERAL ADMINISTRATIVE EXPENSES:PayPal Fees,PayPal Bank 3,$3.38,"$976,958.72"
PayPal Bank 3,09/22/2023,Deposit,5GE00546M49214419,04 PAYPAL GENERAL UNRESTR,"Subject: GeneralPage
Transaction ID: 5GE00546M49214419
https://www.paypal.com/activity/payment/5GE00546M49214419",PayPal Bank 3,--,$96.62,"$977,055.34"
Donations directed by individuals,09/22/2023,Deposit,5GE00546M49214419,04 PAYPAL GENERAL UNRESTR,Support Ukraine - Support Ukraine,Contributed income:Donations directed by individuals,PayPal Bank 3,$100.00,"$977,155.34"
PayPal Fees,09/22/2023,Deposit,5GE00546M49214419,04 PAYPAL GENERAL UNRESTR,PayPal fees,OFFICE/GENERAL ADMINISTRATIVE EXPENSES:PayPal Fees,PayPal Bank 3,$3.38,"$977,158.72"
PayPal Bank 3,09/22/2023,Deposit,6UN85806ED284713M,04 PAYPAL GENERAL UNRESTR,"Subject: GeneralPage
Transaction ID: 6UN85806ED284713M
https://www.paypal.com/activity/payment/6UN85806ED284713M",PayPal Bank 3,--,$30.00,"$977,188.72"
Donations directed by individuals,09/22/2023,Deposit,6UN85806ED284713M,04 PAYPAL GENERAL UNRESTR,Support Ukraine - Support Ukraine,Contributed income:Donations directed by individuals,PayPal Bank 3,$31.40,"$977,220.12"
PayPal Fees,09/22/2023,Deposit,6UN85806ED284713M,04 PAYPAL GENERAL UNRESTR,PayPal fees,OFFICE/GENERAL ADMINISTRATIVE EXPENSES:PayPal Fees,PayPal Bank 3,$1.40,"$977,221.52"
PayPal Bank 3,09/22/2023,Deposit,6MP6452204563261K,04 PAYPAL GENERAL UNRESTR,"Subject: GeneralPage
Note: Mnohii Lita, Lyuba
Transaction ID: 6MP6452204563261K
https://www.paypal.com/activity/payment/6MP6452204563261K",PayPal Bank 3,--,$98.45,"$977,319.97"
Donations directed by individuals,09/22/2023,Deposit,6MP6452204563261K,04 PAYPAL GENERAL UNRESTR,Support Ukraine - Support Ukraine,Contributed income:Donations directed by individuals,PayPal Bank 3,$103.48,"$977,423.45"
PayPal Fees,09/22/2023,Deposit,6MP6452204563261K,04 PAYPAL GENERAL UNRESTR,PayPal fees,OFFICE/GENERAL ADMINISTRATIVE EXPENSES:PayPal Fees,PayPal Bank 3,$5.03,"$977,428.48"
PayPal Bank 3,09/22/2023,Deposit,9HD345775D588911W,04 PAYPAL GENERAL UNRESTR,"Subject: Support Ukraine
Transaction ID: 9HD345775D588911W
https://www.paypal.com/activity/payment/9HD345775D588911W",PayPal Bank 3,--,$25.00,"$977,453.48"
Donations directed by individuals,09/22/2023,Deposit,9HD345775D588911W,04 PAYPAL GENERAL UNRESTR,Money in to PayPal,Contributed income:Donations directed by individuals,PayPal Bank 3,$26.25,"$977,479.73"
PayPal Fees,09/22/2023,Deposit,9HD345775D588911W,04 PAYPAL GENERAL UNRESTR,PayPal fees,OFFICE/GENERAL ADMINISTRATIVE EXPENSES:PayPal Fees,PayPal Bank 3,$1.25,"$977,480.98"
PayPal Bank 3,09/22/2023,Deposit,3W37598027733534A,04 PAYPAL GENERAL UNRESTR,"Subject: GeneralPage
Transaction ID: 3W37598027733534A
https://www.paypal.com/activity/payment/3W37598027733534A",PayPal Bank 3,--,$30.00,"$977,510.98"
Donations directed by individuals,09/22/2023,Deposit,3W37598027733534A,04 PAYPAL GENERAL UNRESTR,Support Ukraine - Support Ukraine,Contributed income:Donations directed by individuals,PayPal Bank 3,$31.40,"$977,542.38"
PayPal Fees,09/22/2023,Deposit,3W37598027733534A,04 PAYPAL GENERAL UNRESTR,PayPal fees,OFFICE/GENERAL ADMINISTRATIVE EXPENSES:PayPal Fees,PayPal Bank 3,$1.40,"$977,543.78"
PayPal Bank 3,09/22/2023,Deposit,7L593890MC561110M,04 PAYPAL GENERAL UNRESTR,"Subject: GeneralPage
Transaction ID: 7L593890MC561110M
https://www.paypal.com/activity/payment/7L593890MC561110M",PayPal Bank 3,--,$49.22,"$977,593.00"
Donations directed by individuals,09/22/2023,Deposit,7L593890MC561110M,04 PAYPAL GENERAL UNRESTR,Support Ukraine - Support Ukraine,Contributed income:Donations directed by individuals,PayPal Bank 3,$51.99,"$977,644.99"
PayPal Fees,09/22/2023,Deposit,7L593890MC561110M,04 PAYPAL GENERAL UNRESTR,PayPal fees,OFFICE/GENERAL ADMINISTRATIVE EXPENSES:PayPal Fees,PayPal Bank 3,$2.77,"$977,647.76"
PayPal Bank 3,09/22/2023,Deposit,9TM50698FE886611N,04 PAYPAL GENERAL UNRESTR,"Subject: GeneralPage
Note: Happy Birthday Lyuba Shipovich!
Transaction ID: 9TM50698FE886611N
https://www.paypal.com/activity/payment/9TM50698FE886611N",PayPal Bank 3,--,$100.00,"$977,747.76"
Donations directed by individuals,09/22/2023,Deposit,9TM50698FE886611N,04 PAYPAL GENERAL UNRESTR,Support Ukraine - Support Ukraine,Contributed income:Donations directed by individuals,PayPal Bank 3,$103.48,"$977,851.24"
PayPal Fees,09/22/2023,Deposit,9TM50698FE886611N,04 PAYPAL GENERAL UNRESTR,PayPal fees,OFFICE/GENERAL ADMINISTRATIVE EXPENSES:PayPal Fees,PayPal Bank 3,$3.48,"$977,854.72"
PayPal Bank 3,09/22/2023,Deposit,31A121404C1997703,04 PAYPAL GENERAL UNRESTR,"Subject: GeneralPage
Transaction ID: 31A121404C1997703
https://www.paypal.com/activity/payment/31A121404C1997703",PayPal Bank 3,--,$290.84,"$978,145.56"
Donations directed by individuals,09/22/2023,Deposit,31A121404C1997703,04 PAYPAL GENERAL UNRESTR,Support Ukraine - Support Ukraine,Contributed income:Donations directed by individuals,PayPal Bank 3,$300.00,"$978,445.56"
PayPal Fees,09/22/2023,Deposit,31A121404C1997703,04 PAYPAL GENERAL UNRESTR,PayPal fees,OFFICE/GENERAL ADMINISTRATIVE EXPENSES:PayPal Fees,PayPal Bank 3,$9.16,"$978,454.72"
PayPal Bank 3,09/22/2023,Deposit,39X62260U80060447,04 PAYPAL GENERAL UNRESTR,"Subject: GeneralPage
Note: Happy Birthday Lyuba!
Transaction ID: 39X62260U80060447
https://www.paypal.com/activity/payment/39X62260U80060447",PayPal Bank 3,--,$193.73,"$978,648.45"
Donations directed by individuals,09/22/2023,Deposit,39X62260U80060447,04 PAYPAL GENERAL UNRESTR,Support Ukraine - Support Ukraine,Contributed income:Donations directed by individuals,PayPal Bank 3,$200.00,"$978,848.45"
PayPal Fees,09/22/2023,Deposit,39X62260U80060447,04 PAYPAL GENERAL UNRESTR,PayPal fees,OFFICE/GENERAL ADMINISTRATIVE EXPENSES:PayPal Fees,PayPal Bank 3,$6.27,"$978,854.72"
PayPal Bank 3,09/22/2023,Deposit,71A50641X46963142,04 PAYPAL GENERAL UNRESTR,"Subject: GeneralPage
Transaction ID: 71A50641X46963142
https://www.paypal.com/activity/payment/71A50641X46963142",PayPal Bank 3,--,$820.00,"$979,674.72"
Donations directed by individuals,09/22/2023,Deposit,71A50641X46963142,04 PAYPAL GENERAL UNRESTR,Support Ukraine - Support Ukraine,Contributed income:Donations directed by individuals,PayPal Bank 3,$844.91,"$980,519.63"
PayPal Fees,09/22/2023,Deposit,71A50641X46963142,04 PAYPAL GENERAL UNRESTR,PayPal fees,OFFICE/GENERAL ADMINISTRATIVE EXPENSES:PayPal Fees,PayPal Bank 3,$24.91,"$980,544.54"
PayPal Bank 3,09/22/2023,Deposit,49Y29843UW779240L,04 PAYPAL GENERAL UNRESTR,"Subject: GeneralPage
Transaction ID: 49Y29843UW779240L
https://www.paypal.com/activity/payment/49Y29843UW779240L",PayPal Bank 3,--,$49.22,"$980,593.76"
Donations directed by individuals,09/22/2023,Deposit,49Y29843UW779240L,04 PAYPAL GENERAL UNRESTR,Support Ukraine - Support Ukraine,Contributed income:Donations directed by individuals,PayPal Bank 3,$51.99,"$980,645.75"
PayPal Fees,09/22/2023,Deposit,49Y29843UW779240L,04 PAYPAL GENERAL UNRESTR,PayPal fees,OFFICE/GENERAL ADMINISTRATIVE EXPENSES:PayPal Fees,PayPal Bank 3,$2.77,"$980,648.52"
PayPal Bank 3,09/22/2023,Deposit,64387333V3369200X,04 PAYPAL GENERAL UNRESTR,"Subject: GeneralPage
Transaction ID: 64387333V3369200X
https://www.paypal.com/activity/payment/64387333V3369200X",PayPal Bank 3,--,$50.00,"$980,698.52"
Donations directed by individuals,09/22/2023,Deposit,64387333V3369200X,04 PAYPAL GENERAL UNRESTR,Support Ukraine - Support Ukraine,Contributed income:Donations directed by individuals,PayPal Bank 3,$51.99,"$980,750.51"
PayPal Fees,09/22/2023,Deposit,64387333V3369200X,04 PAYPAL GENERAL UNRESTR,PayPal fees,OFFICE/GENERAL ADMINISTRATIVE EXPENSES:PayPal Fees,PayPal Bank 3,$1.99,"$980,752.50"
PayPal Bank 3,09/22/2023,Deposit,7UW41748MF324114U,04 PAYPAL GENERAL UNRESTR,"Subject: GeneralPage
Transaction ID: 7UW41748MF324114U
https://www.paypal.com/activity/payment/7UW41748MF324114U",PayPal Bank 3,--,$50.00,"$980,802.50"
Donations directed by individuals,09/22/2023,Deposit,7UW41748MF324114U,04 PAYPAL GENERAL UNRESTR,Support Ukraine - Support Ukraine,Contributed income:Donations directed by individuals,PayPal Bank 3,$51.99,"$980,854.49"
PayPal Fees,09/22/2023,Deposit,7UW41748MF324114U,04 PAYPAL GENERAL UNRESTR,PayPal fees,OFFICE/GENERAL ADMINISTRATIVE EXPENSES:PayPal Fees,PayPal Bank 3,$1.99,"$980,856.48"
PayPal Bank 3,09/22/2023,Deposit,4RY212138X079980M,04 PAYPAL GENERAL UNRESTR,"Subject: GeneralPage
Transaction ID: 4RY212138X079980M
https://www.paypal.com/activity/payment/4RY212138X079980M",PayPal Bank 3,--,$48.06,"$980,904.54"
Donations directed by individuals,09/22/2023,Deposit,4RY212138X079980M,04 PAYPAL GENERAL UNRESTR,Support Ukraine - Support Ukraine,Contributed income:Donations directed by individuals,PayPal Bank 3,$50.00,"$980,954.54"
PayPal Fees,09/22/2023,Deposit,4RY212138X079980M,04 PAYPAL GENERAL UNRESTR,PayPal fees,OFFICE/GENERAL ADMINISTRATIVE EXPENSES:PayPal Fees,PayPal Bank 3,$1.94,"$980,956.48"
PayPal Bank 3,09/22/2023,Deposit,72C5448182009291B,04 PAYPAL GENERAL UNRESTR,"Subject: GeneralPage
Transaction ID: 72C5448182009291B
https://www.paypal.com/activity/payment/72C5448182009291B",PayPal Bank 3,--,$4.37,"$980,960.85"
Donations directed by individuals,09/22/2023,Deposit,72C5448182009291B,04 PAYPAL GENERAL UNRESTR,Support Ukraine - Support Ukraine,Contributed income:Donations directed by individuals,PayPal Bank 3,$5.00,"$980,965.85"
PayPal Fees,09/22/2023,Deposit,72C5448182009291B,04 PAYPAL GENERAL UNRESTR,PayPal fees,OFFICE/GENERAL ADMINISTRATIVE EXPENSES:PayPal Fees,PayPal Bank 3,$0.63,"$980,966.48"
PayPal Bank 3,09/22/2023,Deposit,2RJ87902UJ811740F,04 PAYPAL GENERAL UNRESTR,"Transaction ID: 2RJ87902UJ811740F
https://www.paypal.com/activity/payment/2RJ87902UJ811740F",PayPal Bank 3,--,$33.95,"$981,000.43"
Donations directed by individuals,09/22/2023,Deposit,2RJ87902UJ811740F,04 PAYPAL GENERAL UNRESTR,Money in to PayPal,Contributed income:Donations directed by individuals,PayPal Bank 3,$35.00,"$981,035.43"
PayPal Fees,09/22/2023,Deposit,2RJ87902UJ811740F,04 PAYPAL GENERAL UNRESTR,PayPal fees,OFFICE/GENERAL ADMINISTRATIVE EXPENSES:PayPal Fees,PayPal Bank 3,$1.05,"$981,036.48"
PayPal Bank 3,09/22/2023,Deposit,9A081869S52439819,04 PAYPAL GENERAL UNRESTR,"Subject: GeneralPage
Transaction ID: 9A081869S52439819
https://www.paypal.com/activity/payment/9A081869S52439819",PayPal Bank 3,--,$38.35,"$981,074.83"
Donations directed by individuals,09/22/2023,Deposit,9A081869S52439819,04 PAYPAL GENERAL UNRESTR,Support Ukraine - Support Ukraine,Contributed income:Donations directed by individuals,PayPal Bank 3,$40.00,"$981,114.83"
PayPal Fees,09/22/2023,Deposit,9A081869S52439819,04 PAYPAL GENERAL UNRESTR,PayPal fees,OFFICE/GENERAL ADMINISTRATIVE EXPENSES:PayPal Fees,PayPal Bank 3,$1.65,"$981,116.48"
PayPal Bank 3,09/22/2023,Deposit,76H76369F45085905,04 PAYPAL GENERAL UNRESTR,"Subject: GeneralPage
Transaction ID: 76H76369F45085905
https://www.paypal.com/activity/payment/76H76369F45085905",PayPal Bank 3,--,$96.62,"$981,213.10"
Donations directed by individuals,09/22/2023,Deposit,76H76369F45085905,04 PAYPAL GENERAL UNRESTR,Support Ukraine - Support Ukraine,Contributed income:Donations directed by individuals,PayPal Bank 3,$100.00,"$981,313.10"
PayPal Fees,09/22/2023,Deposit,76H76369F45085905,04 PAYPAL GENERAL UNRESTR,PayPal fees,OFFICE/GENERAL ADMINISTRATIVE EXPENSES:PayPal Fees,PayPal Bank 3,$3.38,"$981,316.48"
PayPal Bank 3,09/22/2023,Deposit,3XG02471JY446130J,04 PAYPAL GENERAL UNRESTR,"Subject: Support Ukraine
Transaction ID: 3XG02471JY446130J
https://www.paypal.com/activity/payment/3XG02471JY446130J",PayPal Bank 3,--,$20.75,"$981,337.23"
Donations directed by individuals,09/22/2023,Deposit,3XG02471JY446130J,04 PAYPAL GENERAL UNRESTR,Money in to PayPal,Contributed income:Donations directed by individuals,PayPal Bank 3,$22.22,"$981,359.45"
PayPal Fees,09/22/2023,Deposit,3XG02471JY446130J,04 PAYPAL GENERAL UNRESTR,PayPal fees,OFFICE/GENERAL ADMINISTRATIVE EXPENSES:PayPal Fees,PayPal Bank 3,$1.47,"$981,360.92"
PayPal Bank 3,09/22/2023,Deposit,51M60073MG3717313,04 PAYPAL GENERAL UNRESTR,"Subject: GeneralPage
Transaction ID: 51M60073MG3717313
https://www.paypal.com/activity/payment/51M60073MG3717313",PayPal Bank 3,--,$290.84,"$981,651.76"
Donations directed by individuals,09/22/2023,Deposit,51M60073MG3717313,04 PAYPAL GENERAL UNRESTR,Support Ukraine - Support Ukraine,Contributed income:Donations directed by individuals,PayPal Bank 3,$300.00,"$981,951.76"
PayPal Fees,09/22/2023,Deposit,51M60073MG3717313,04 PAYPAL GENERAL UNRESTR,PayPal fees,OFFICE/GENERAL ADMINISTRATIVE EXPENSES:PayPal Fees,PayPal Bank 3,$9.16,"$981,960.92"
PayPal Bank 3,09/22/2023,Deposit,1Y388623659877031,07 1000 DRONES RESTR,"Subject: 1000DRONES
Transaction ID: 1Y388623659877031
https://www.paypal.com/activity/payment/1Y388623659877031",PayPal Bank 3,--,$29.53,"$981,990.45"
Donations directed by individuals,09/22/2023,Deposit,1Y388623659877031,07 1000 DRONES RESTR,1000 DRONES FOR UKRAINE - 1000 DRONES FOR UKRAINE,Contributed income:Donations directed by individuals,PayPal Bank 3,$31.40,"$982,021.85"
PayPal Fees,09/22/2023,Deposit,1Y388623659877031,07 1000 DRONES RESTR,PayPal fees,OFFICE/GENERAL ADMINISTRATIVE EXPENSES:PayPal Fees,PayPal Bank 3,$1.87,"$982,023.72"
PayPal Bank 3,09/22/2023,Deposit,7W774328XL7301211,04 PAYPAL GENERAL UNRESTR,"Subject: GeneralPage
Note: Berlinska you are the best ��
Transaction ID: 7W774328XL7301211
https://www.paypal.com/activity/payment/7W774328XL7301211",PayPal Bank 3,--,$95.12,"$982,118.84"
Donations directed by individuals,09/22/2023,Deposit,7W774328XL7301211,04 PAYPAL GENERAL UNRESTR,Support Ukraine - Support Ukraine,Contributed income:Donations directed by individuals,PayPal Bank 3,$100.00,"$982,218.84"
PayPal Fees,09/22/2023,Deposit,7W774328XL7301211,04 PAYPAL GENERAL UNRESTR,PayPal fees,OFFICE/GENERAL ADMINISTRATIVE EXPENSES:PayPal Fees,PayPal Bank 3,$4.88,"$982,223.72"
PayPal Bank 3,09/22/2023,Deposit,2MJ53335SS7405935,04 PAYPAL GENERAL UNRESTR,"Subject: Support Ukraine
Transaction ID: 2MJ53335SS7405935
https://www.paypal.com/activity/payment/2MJ53335SS7405935",PayPal Bank 3,--,$98.45,"$982,322.17"
Donations directed by individuals,09/22/2023,Deposit,2MJ53335SS7405935,04 PAYPAL GENERAL UNRESTR,Money in to PayPal,Contributed income:Donations directed by individuals,PayPal Bank 3,$103.48,"$982,425.65"
PayPal Fees,09/22/2023,Deposit,2MJ53335SS7405935,04 PAYPAL GENERAL UNRESTR,PayPal fees,OFFICE/GENERAL ADMINISTRATIVE EXPENSES:PayPal Fees,PayPal Bank 3,$5.03,"$982,430.68"
PayPal Bank 3,09/22/2023,Deposit,4Y295847E9693872H,04 PAYPAL GENERAL UNRESTR,"Subject: GeneralPage
Transaction ID: 4Y295847E9693872H
https://www.paypal.com/activity/payment/4Y295847E9693872H",PayPal Bank 3,--,$18.93,"$982,449.61"
Donations directed by individuals,09/22/2023,Deposit,4Y295847E9693872H,04 PAYPAL GENERAL UNRESTR,Support Ukraine - Support Ukraine,Contributed income:Donations directed by individuals,PayPal Bank 3,$20.00,"$982,469.61"
PayPal Fees,09/22/2023,Deposit,4Y295847E9693872H,04 PAYPAL GENERAL UNRESTR,PayPal fees,OFFICE/GENERAL ADMINISTRATIVE EXPENSES:PayPal Fees,PayPal Bank 3,$1.07,"$982,470.68"
PayPal Bank 3,09/22/2023,Deposit,4WF86501W7438222D,04 PAYPAL GENERAL UNRESTR,"Subject: GeneralPage
Transaction ID: 4WF86501W7438222D
https://www.paypal.com/activity/payment/4WF86501W7438222D",PayPal Bank 3,--,$98.45,"$982,569.13"
Donations directed by individuals,09/22/2023,Deposit,4WF86501W7438222D,04 PAYPAL GENERAL UNRESTR,Support Ukraine - Support Ukraine,Contributed income:Donations directed by individuals,PayPal Bank 3,$103.48,"$982,672.61"
PayPal Fees,09/22/2023,Deposit,4WF86501W7438222D,04 PAYPAL GENERAL UNRESTR,PayPal fees,OFFICE/GENERAL ADMINISTRATIVE EXPENSES:PayPal Fees,PayPal Bank 3,$5.03,"$982,677.64"
PayPal Bank 3,09/22/2023,Deposit,7CA338358D569582P,08 VICTORY DRONES RESTR,"Subject: VICTORY DRONES
Transaction ID: 7CA338358D569582P
https://www.paypal.com/activity/payment/7CA338358D569582P",PayPal Bank 3,--,$2.94,"$982,680.58"
Donations directed by individuals,09/22/2023,Deposit,7CA338358D569582P,08 VICTORY DRONES RESTR,Money in to PayPal,Contributed income:Donations directed by individuals,PayPal Bank 3,$3.59,"$982,684.17"
PayPal Fees,09/22/2023,Deposit,7CA338358D569582P,08 VICTORY DRONES RESTR,PayPal fees,OFFICE/GENERAL ADMINISTRATIVE EXPENSES:PayPal Fees,PayPal Bank 3,$0.65,"$982,684.82"
PayPal Bank 3,09/22/2023,Deposit,5EB99905YK1619709,04 PAYPAL GENERAL UNRESTR,"Subject: GeneralPage
Transaction ID: 5EB99905YK1619709
https://www.paypal.com/activity/payment/5EB99905YK1619709",PayPal Bank 3,--,$573.17,"$983,257.99"
Donations directed by individuals,09/22/2023,Deposit,5EB99905YK1619709,04 PAYPAL GENERAL UNRESTR,Support Ukraine - Support Ukraine,Contributed income:Donations directed by individuals,PayPal Bank 3,$600.00,"$983,857.99"
PayPal Fees,09/22/2023,Deposit,5EB99905YK1619709,04 PAYPAL GENERAL UNRESTR,PayPal fees,OFFICE/GENERAL ADMINISTRATIVE EXPENSES:PayPal Fees,PayPal Bank 3,$26.83,"$983,884.82"
PayPal Bank 3,09/22/2023,Deposit,1NK258195G7166433,07 1000 DRONES RESTR,"Subject: 1000DRONES
Note: 1000 Drones for Ukraine
Transaction ID: 1NK258195G7166433
https://www.paypal.com/activity/payment/1NK258195G7166433",PayPal Bank 3,--,$290.84,"$984,175.66"
Donations directed by individuals,09/22/2023,Deposit,1NK258195G7166433,07 1000 DRONES RESTR,1000 DRONES FOR UKRAINE - 1000 DRONES FOR UKRAINE,Contributed income:Donations directed by individuals,PayPal Bank 3,$300.00,"$984,475.66"
PayPal Fees,09/22/2023,Deposit,1NK258195G7166433,07 1000 DRONES RESTR,PayPal fees,OFFICE/GENERAL ADMINISTRATIVE EXPENSES:PayPal Fees,PayPal Bank 3,$9.16,"$984,484.82"
PayPal Bank 3,09/22/2023,Deposit,8S8098256V0659126,04 PAYPAL GENERAL UNRESTR,"Subject: GeneralPage
Transaction ID: 8S8098256V0659126
https://www.paypal.com/activity/payment/8S8098256V0659126",PayPal Bank 3,--,$196.91,"$984,681.73"
Donations directed by individuals,09/22/2023,Deposit,8S8098256V0659126,04 PAYPAL GENERAL UNRESTR,Support Ukraine - Support Ukraine,Contributed income:Donations directed by individuals,PayPal Bank 3,$206.46,"$984,888.19"
PayPal Fees,09/22/2023,Deposit,8S8098256V0659126,04 PAYPAL GENERAL UNRESTR,PayPal fees,OFFICE/GENERAL ADMINISTRATIVE EXPENSES:PayPal Fees,PayPal Bank 3,$9.55,"$984,897.74"
PayPal Bank 3,09/22/2023,Deposit,3XR22187XW8843046,04 PAYPAL GENERAL UNRESTR,"Subject: GeneralPage
Transaction ID: 3XR22187XW8843046
https://www.paypal.com/activity/payment/3XR22187XW8843046",PayPal Bank 3,--,$9.84,"$984,907.58"
Donations directed by individuals,09/22/2023,Deposit,3XR22187XW8843046,04 PAYPAL GENERAL UNRESTR,Support Ukraine - Support Ukraine,Contributed income:Donations directed by individuals,PayPal Bank 3,$10.80,"$984,918.38"
PayPal Fees,09/22/2023,Deposit,3XR22187XW8843046,04 PAYPAL GENERAL UNRESTR,PayPal fees,OFFICE/GENERAL ADMINISTRATIVE EXPENSES:PayPal Fees,PayPal Bank 3,$0.96,"$984,919.34"
PayPal Bank 3,09/22/2023,Deposit,92A166717S631983S,04 PAYPAL GENERAL UNRESTR,"Subject: GeneralPage
Transaction ID: 92A166717S631983S
https://www.paypal.com/activity/payment/92A166717S631983S",PayPal Bank 3,--,$18.63,"$984,937.97"
Donations directed by individuals,09/22/2023,Deposit,92A166717S631983S,04 PAYPAL GENERAL UNRESTR,Support Ukraine - Support Ukraine,Contributed income:Donations directed by individuals,PayPal Bank 3,$20.00,"$984,957.97"
PayPal Fees,09/22/2023,Deposit,92A166717S631983S,04 PAYPAL GENERAL UNRESTR,PayPal fees,OFFICE/GENERAL ADMINISTRATIVE EXPENSES:PayPal Fees,PayPal Bank 3,$1.37,"$984,959.34"
PayPal Bank 3,09/22/2023,Deposit,2JK07157RS451103B,04 PAYPAL GENERAL UNRESTR,"Subject: GeneralPage
Transaction ID: 2JK07157RS451103B
https://www.paypal.com/activity/payment/2JK07157RS451103B",PayPal Bank 3,--,$23.41,"$984,982.75"
Donations directed by individuals,09/22/2023,Deposit,2JK07157RS451103B,04 PAYPAL GENERAL UNRESTR,Support Ukraine - Support Ukraine,Contributed income:Donations directed by individuals,PayPal Bank 3,$25.00,"$985,007.75"
PayPal Fees,09/22/2023,Deposit,2JK07157RS451103B,04 PAYPAL GENERAL UNRESTR,PayPal fees,OFFICE/GENERAL ADMINISTRATIVE EXPENSES:PayPal Fees,PayPal Bank 3,$1.59,"$985,009.34"
PayPal Bank 3,09/22/2023,Deposit,48J341091C089703F,07 1000 DRONES RESTR,"Subject: 1000DRONES
Transaction ID: 48J341091C089703F
https://www.paypal.com/activity/payment/48J341091C089703F",PayPal Bank 3,--,$19.68,"$985,029.02"
Donations directed by individuals,09/22/2023,Deposit,48J341091C089703F,07 1000 DRONES RESTR,1000 DRONES FOR UKRAINE - 1000 DRONES FOR UKRAINE,Contributed income:Donations directed by individuals,PayPal Bank 3,$21.10,"$985,050.12"
PayPal Fees,09/22/2023,Deposit,48J341091C089703F,07 1000 DRONES RESTR,PayPal fees,OFFICE/GENERAL ADMINISTRATIVE EXPENSES:PayPal Fees,PayPal Bank 3,$1.42,"$985,051.54"
PayPal Bank 3,09/22/2023,Deposit,16S87911137311040,04 PAYPAL GENERAL UNRESTR,"Subject: Support Ukraine
Transaction ID: 16S87911137311040
https://www.paypal.com/activity/payment/16S87911137311040",PayPal Bank 3,--,$47.25,"$985,098.79"
Donations directed by individuals,09/22/2023,Deposit,16S87911137311040,04 PAYPAL GENERAL UNRESTR,Money in to PayPal,Contributed income:Donations directed by individuals,PayPal Bank 3,$49.93,"$985,148.72"
PayPal Fees,09/22/2023,Deposit,16S87911137311040,04 PAYPAL GENERAL UNRESTR,PayPal fees,OFFICE/GENERAL ADMINISTRATIVE EXPENSES:PayPal Fees,PayPal Bank 3,$2.68,"$985,151.40"
PayPal Bank 3,09/22/2023,Deposit,9VW99510006981318,04 PAYPAL GENERAL UNRESTR,"Subject: GeneralPage
Transaction ID: 9VW99510006981318
https://www.paypal.com/activity/payment/9VW99510006981318",PayPal Bank 3,--,$29.53,"$985,180.93"
Donations directed by individuals,09/22/2023,Deposit,9VW99510006981318,04 PAYPAL GENERAL UNRESTR,Support Ukraine - Support Ukraine,Contributed income:Donations directed by individuals,PayPal Bank 3,$31.40,"$985,212.33"
PayPal Fees,09/22/2023,Deposit,9VW99510006981318,04 PAYPAL GENERAL UNRESTR,PayPal fees,OFFICE/GENERAL ADMINISTRATIVE EXPENSES:PayPal Fees,PayPal Bank 3,$1.87,"$985,214.20"
PayPal Bank 3,09/22/2023,Deposit,6WK833943P229073V,04 PAYPAL GENERAL UNRESTR,"Subject: GeneralPage
Transaction ID: 6WK833943P229073V
https://www.paypal.com/activity/payment/6WK833943P229073V",PayPal Bank 3,--,$13.85,"$985,228.05"
Donations directed by individuals,09/22/2023,Deposit,6WK833943P229073V,04 PAYPAL GENERAL UNRESTR,Support Ukraine - Support Ukraine,Contributed income:Donations directed by individuals,PayPal Bank 3,$15.00,"$985,243.05"
PayPal Fees,09/22/2023,Deposit,6WK833943P229073V,04 PAYPAL GENERAL UNRESTR,PayPal fees,OFFICE/GENERAL ADMINISTRATIVE EXPENSES:PayPal Fees,PayPal Bank 3,$1.15,"$985,244.20"
PayPal Bank 3,09/22/2023,Deposit,3KE110899T596373N,07 1000 DRONES RESTR,"Subject: GeneralPage
Note: Люті пташки ��
Transaction ID: 3KE110899T596373N
https://www.paypal.com/activity/payment/3KE110899T596373N",PayPal Bank 3,--,$98.45,"$985,342.65"
Donations directed by individuals,09/22/2023,Deposit,3KE110899T596373N,07 1000 DRONES RESTR,Support Ukraine - Support Ukraine,Contributed income:Donations directed by individuals,PayPal Bank 3,$103.48,"$985,446.13"
PayPal Fees,09/22/2023,Deposit,3KE110899T596373N,07 1000 DRONES RESTR,PayPal fees,OFFICE/GENERAL ADMINISTRATIVE EXPENSES:PayPal Fees,PayPal Bank 3,$5.03,"$985,451.16"
PayPal Bank 3,09/22/2023,Deposit,25M34503NX359714G,07 1000 DRONES RESTR,"Subject: GeneralPage
Note: До 1000 дронів для України неньки
Transaction ID: 25M34503NX359714G
https://www.paypal.com/activity/payment/25M34503NX359714G",PayPal Bank 3,--,$295.36,"$985,746.52"
Donations directed by individuals,09/22/2023,Deposit,25M34503NX359714G,07 1000 DRONES RESTR,Support Ukraine - Support Ukraine,Contributed income:Donations directed by individuals,PayPal Bank 3,$309.43,"$986,055.95"
PayPal Fees,09/22/2023,Deposit,25M34503NX359714G,07 1000 DRONES RESTR,PayPal fees,OFFICE/GENERAL ADMINISTRATIVE EXPENSES:PayPal Fees,PayPal Bank 3,$14.07,"$986,070.02"
PayPal Bank 3,09/22/2023,Deposit,9XE72826T6403323F,04 PAYPAL GENERAL UNRESTR,"Subject: GeneralPage
Transaction ID: 9XE72826T6403323F
https://www.paypal.com/activity/payment/9XE72826T6403323F",PayPal Bank 3,--,$50.00,"$986,120.02"
Donations directed by individuals,09/22/2023,Deposit,9XE72826T6403323F,04 PAYPAL GENERAL UNRESTR,Support Ukraine - Support Ukraine,Contributed income:Donations directed by individuals,PayPal Bank 3,$51.99,"$986,172.01"
PayPal Fees,09/22/2023,Deposit,9XE72826T6403323F,04 PAYPAL GENERAL UNRESTR,PayPal fees,OFFICE/GENERAL ADMINISTRATIVE EXPENSES:PayPal Fees,PayPal Bank 3,$1.99,"$986,174.00"
PayPal Bank 3,09/22/2023,Deposit,8F387199M5915234R,04 PAYPAL GENERAL UNRESTR,"Subject: GeneralPage
Transaction ID: 8F387199M5915234R
https://www.paypal.com/activity/payment/8F387199M5915234R",PayPal Bank 3,--,$32.97,"$986,206.97"
Donations directed by individuals,09/22/2023,Deposit,8F387199M5915234R,04 PAYPAL GENERAL UNRESTR,Support Ukraine - Support Ukraine,Contributed income:Donations directed by individuals,PayPal Bank 3,$35.00,"$986,241.97"
PayPal Fees,09/22/2023,Deposit,8F387199M5915234R,04 PAYPAL GENERAL UNRESTR,PayPal fees,OFFICE/GENERAL ADMINISTRATIVE EXPENSES:PayPal Fees,PayPal Bank 3,$2.03,"$986,244.00"
PayPal Bank 3,09/22/2023,Deposit,42B07612NT542883V,04 PAYPAL GENERAL UNRESTR,"Subject: Support Ukraine
Transaction ID: 42B07612NT542883V
https://www.paypal.com/activity/payment/42B07612NT542883V",PayPal Bank 3,--,$9.84,"$986,253.84"
Donations directed by individuals,09/22/2023,Deposit,42B07612NT542883V,04 PAYPAL GENERAL UNRESTR,Money in to PayPal,Contributed income:Donations directed by individuals,PayPal Bank 3,$10.80,"$986,264.64"
PayPal Fees,09/22/2023,Deposit,42B07612NT542883V,04 PAYPAL GENERAL UNRESTR,PayPal fees,OFFICE/GENERAL ADMINISTRATIVE EXPENSES:PayPal Fees,PayPal Bank 3,$0.96,"$986,265.60"
PayPal Bank 3,09/22/2023,Deposit,42K81052BV6225712,04 PAYPAL GENERAL UNRESTR,"Subject: GeneralPage
Transaction ID: 42K81052BV6225712
https://www.paypal.com/activity/payment/42K81052BV6225712",PayPal Bank 3,--,$49.22,"$986,314.82"
Donations directed by individuals,09/22/2023,Deposit,42K81052BV6225712,04 PAYPAL GENERAL UNRESTR,Support Ukraine - Support Ukraine,Contributed income:Donations directed by individuals,PayPal Bank 3,$51.99,"$986,366.81"
PayPal Fees,09/22/2023,Deposit,42K81052BV6225712,04 PAYPAL GENERAL UNRESTR,PayPal fees,OFFICE/GENERAL ADMINISTRATIVE EXPENSES:PayPal Fees,PayPal Bank 3,$2.77,"$986,369.58"
PayPal Bank 3,09/22/2023,Deposit,6W103413XG919330W,04 PAYPAL GENERAL UNRESTR,"Subject: GeneralPage
Transaction ID: 6W103413XG919330W
https://www.paypal.com/activity/payment/6W103413XG919330W",PayPal Bank 3,--,$96.62,"$986,466.20"
Donations directed by individuals,09/22/2023,Deposit,6W103413XG919330W,04 PAYPAL GENERAL UNRESTR,Support Ukraine - Support Ukraine,Contributed income:Donations directed by individuals,PayPal Bank 3,$100.00,"$986,566.20"
PayPal Fees,09/22/2023,Deposit,6W103413XG919330W,04 PAYPAL GENERAL UNRESTR,PayPal fees,OFFICE/GENERAL ADMINISTRATIVE EXPENSES:PayPal Fees,PayPal Bank 3,$3.38,"$986,569.58"
PayPal Bank 3,09/22/2023,Deposit,9GR73003PP668005S,04 PAYPAL GENERAL UNRESTR,"Subject: GeneralPage
Transaction ID: 9GR73003PP668005S
https://www.paypal.com/activity/payment/9GR73003PP668005S",PayPal Bank 3,--,$98.45,"$986,668.03"
Donations directed by individuals,09/22/2023,Deposit,9GR73003PP668005S,04 PAYPAL GENERAL UNRESTR,Support Ukraine - Support Ukraine,Contributed income:Donations directed by individuals,PayPal Bank 3,$103.48,"$986,771.51"
PayPal Fees,09/22/2023,Deposit,9GR73003PP668005S,04 PAYPAL GENERAL UNRESTR,PayPal fees,OFFICE/GENERAL ADMINISTRATIVE EXPENSES:PayPal Fees,PayPal Bank 3,$5.03,"$986,776.54"
PayPal Bank 3,09/22/2023,Deposit,8KS66926H3530631A,04 PAYPAL GENERAL UNRESTR,"Subject: GeneralPage
Transaction ID: 8KS66926H3530631A
https://www.paypal.com/activity/payment/8KS66926H3530631A",PayPal Bank 3,--,$500.00,"$987,276.54"
Donations directed by individuals,09/22/2023,Deposit,8KS66926H3530631A,04 PAYPAL GENERAL UNRESTR,Support Ukraine - Support Ukraine,Contributed income:Donations directed by individuals,PayPal Bank 3,$515.38,"$987,791.92"
PayPal Fees,09/22/2023,Deposit,8KS66926H3530631A,04 PAYPAL GENERAL UNRESTR,PayPal fees,OFFICE/GENERAL ADMINISTRATIVE EXPENSES:PayPal Fees,PayPal Bank 3,$15.38,"$987,807.30"
PayPal Bank 3,09/22/2023,Deposit,03K69425HF604842P,04 PAYPAL GENERAL UNRESTR,"Subject: GeneralPage
Transaction ID: 03K69425HF604842P
https://www.paypal.com/activity/payment/03K69425HF604842P",PayPal Bank 3,--,$100.00,"$987,907.30"
Donations directed by individuals,09/22/2023,Deposit,03K69425HF604842P,04 PAYPAL GENERAL UNRESTR,Support Ukraine - Support Ukraine,Contributed income:Donations directed by individuals,PayPal Bank 3,$103.48,"$988,010.78"
PayPal Fees,09/22/2023,Deposit,03K69425HF604842P,04 PAYPAL GENERAL UNRESTR,PayPal fees,OFFICE/GENERAL ADMINISTRATIVE EXPENSES:PayPal Fees,PayPal Bank 3,$3.48,"$988,014.26"
PayPal Bank 3,09/22/2023,Deposit,5XA3732165849152L,04 PAYPAL GENERAL UNRESTR,"Subject: GeneralPage
Transaction ID: 5XA3732165849152L
https://www.paypal.com/activity/payment/5XA3732165849152L",PayPal Bank 3,--,$100.00,"$988,114.26"
Donations directed by individuals,09/22/2023,Deposit,5XA3732165849152L,04 PAYPAL GENERAL UNRESTR,Support Ukraine - Support Ukraine,Contributed income:Donations directed by individuals,PayPal Bank 3,$103.48,"$988,217.74"
PayPal Fees,09/22/2023,Deposit,5XA3732165849152L,04 PAYPAL GENERAL UNRESTR,PayPal fees,OFFICE/GENERAL ADMINISTRATIVE EXPENSES:PayPal Fees,PayPal Bank 3,$3.48,"$988,221.22"
PayPal Bank 3,09/22/2023,Deposit,95538973EW2526137,07 1000 DRONES RESTR,"Subject: GeneralPage
Note: Na ptashky
Transaction ID: 95538973EW2526137
https://www.paypal.com/activity/payment/95538973EW2526137",PayPal Bank 3,--,$9.22,"$988,230.44"
Donations directed by individuals,09/22/2023,Deposit,95538973EW2526137,07 1000 DRONES RESTR,Support Ukraine - Support Ukraine,Contributed income:Donations directed by individuals,PayPal Bank 3,$10.00,"$988,240.44"
PayPal Fees,09/22/2023,Deposit,95538973EW2526137,07 1000 DRONES RESTR,PayPal fees,OFFICE/GENERAL ADMINISTRATIVE EXPENSES:PayPal Fees,PayPal Bank 3,$0.78,"$988,241.22"
PayPal Bank 3,09/22/2023,Deposit,5JV12215MS3743010,04 PAYPAL GENERAL UNRESTR,"Subject: Support Ukraine
Transaction ID: 5JV12215MS3743010
https://www.paypal.com/activity/payment/5JV12215MS3743010",PayPal Bank 3,--,$9.07,"$988,250.29"
Donations directed by individuals,09/22/2023,Deposit,5JV12215MS3743010,04 PAYPAL GENERAL UNRESTR,Money in to PayPal,Contributed income:Donations directed by individuals,PayPal Bank 3,$10.00,"$988,260.29"
PayPal Fees,09/22/2023,Deposit,5JV12215MS3743010,04 PAYPAL GENERAL UNRESTR,PayPal fees,OFFICE/GENERAL ADMINISTRATIVE EXPENSES:PayPal Fees,PayPal Bank 3,$0.93,"$988,261.22"
PayPal Bank 3,09/22/2023,Deposit,6WK07755YW466793L,04 PAYPAL GENERAL UNRESTR,"Subject: GeneralPage
Transaction ID: 6WK07755YW466793L
https://www.paypal.com/activity/payment/6WK07755YW466793L",PayPal Bank 3,--,$47.31,"$988,308.53"
Donations directed by individuals,09/22/2023,Deposit,6WK07755YW466793L,04 PAYPAL GENERAL UNRESTR,Support Ukraine - Support Ukraine,Contributed income:Donations directed by individuals,PayPal Bank 3,$50.00,"$988,358.53"
PayPal Fees,09/22/2023,Deposit,6WK07755YW466793L,04 PAYPAL GENERAL UNRESTR,PayPal fees,OFFICE/GENERAL ADMINISTRATIVE EXPENSES:PayPal Fees,PayPal Bank 3,$2.69,"$988,361.22"
PayPal Bank 3,09/22/2023,Deposit,9FC1834436717901S,04 PAYPAL GENERAL UNRESTR,"Subject: GeneralPage
Note: Support for Ukraine
Transaction ID: 9FC1834436717901S
https://www.paypal.com/activity/payment/9FC1834436717901S",PayPal Bank 3,--,$200.00,"$988,561.22"
Donations directed by individuals,09/22/2023,Deposit,9FC1834436717901S,04 PAYPAL GENERAL UNRESTR,Support Ukraine - Support Ukraine,Contributed income:Donations directed by individuals,PayPal Bank 3,$206.46,"$988,767.68"
PayPal Fees,09/22/2023,Deposit,9FC1834436717901S,04 PAYPAL GENERAL UNRESTR,PayPal fees,OFFICE/GENERAL ADMINISTRATIVE EXPENSES:PayPal Fees,PayPal Bank 3,$6.46,"$988,774.14"
PayPal Bank 3,09/22/2023,Deposit,5RA79431HA847290Y,04 PAYPAL GENERAL UNRESTR,"Subject: GeneralPage
Transaction ID: 5RA79431HA847290Y
https://www.paypal.com/activity/payment/5RA79431HA847290Y",PayPal Bank 3,--,$98.45,"$988,872.59"
Donations directed by individuals,09/22/2023,Deposit,5RA79431HA847290Y,04 PAYPAL GENERAL UNRESTR,Support Ukraine - Support Ukraine,Contributed income:Donations directed by individuals,PayPal Bank 3,$103.48,"$988,976.07"
PayPal Fees,09/22/2023,Deposit,5RA79431HA847290Y,04 PAYPAL GENERAL UNRESTR,PayPal fees,OFFICE/GENERAL ADMINISTRATIVE EXPENSES:PayPal Fees,PayPal Bank 3,$5.03,"$988,981.10"
PayPal Bank 3,09/22/2023,Deposit,25F31626EE663584U,04 PAYPAL GENERAL UNRESTR,"Subject: GeneralPage
Transaction ID: 25F31626EE663584U
https://www.paypal.com/activity/payment/25F31626EE663584U",PayPal Bank 3,--,$9.07,"$988,990.17"
Donations directed by individuals,09/22/2023,Deposit,25F31626EE663584U,04 PAYPAL GENERAL UNRESTR,Support Ukraine - Support Ukraine,Contributed income:Donations directed by individuals,PayPal Bank 3,$10.00,"$989,000.17"
PayPal Fees,09/22/2023,Deposit,25F31626EE663584U,04 PAYPAL GENERAL UNRESTR,PayPal fees,OFFICE/GENERAL ADMINISTRATIVE EXPENSES:PayPal Fees,PayPal Bank 3,$0.93,"$989,001.10"
PayPal Bank 3,09/22/2023,Deposit,77H280990U621721G,04 PAYPAL GENERAL UNRESTR,"Subject: GeneralPage
Transaction ID: 77H280990U621721G
https://www.paypal.com/activity/payment/77H280990U621721G",PayPal Bank 3,--,$49.22,"$989,050.32"
Donations directed by individuals,09/22/2023,Deposit,77H280990U621721G,04 PAYPAL GENERAL UNRESTR,Support Ukraine - Support Ukraine,Contributed income:Donations directed by individuals,PayPal Bank 3,$51.99,"$989,102.31"
PayPal Fees,09/22/2023,Deposit,77H280990U621721G,04 PAYPAL GENERAL UNRESTR,PayPal fees,OFFICE/GENERAL ADMINISTRATIVE EXPENSES:PayPal Fees,PayPal Bank 3,$2.77,"$989,105.08"
PayPal Bank 3,09/22/2023,Deposit,58U2170704821354R,04 PAYPAL GENERAL UNRESTR,"Subject: GeneralPage
Transaction ID: 58U2170704821354R
https://www.paypal.com/activity/payment/58U2170704821354R",PayPal Bank 3,--,$19.68,"$989,124.76"
Donations directed by individuals,09/22/2023,Deposit,58U2170704821354R,04 PAYPAL GENERAL UNRESTR,Support Ukraine - Support Ukraine,Contributed income:Donations directed by individuals,PayPal Bank 3,$21.10,"$989,145.86"
PayPal Fees,09/22/2023,Deposit,58U2170704821354R,04 PAYPAL GENERAL UNRESTR,PayPal fees,OFFICE/GENERAL ADMINISTRATIVE EXPENSES:PayPal Fees,PayPal Bank 3,$1.42,"$989,147.28"
PayPal Bank 3,09/22/2023,Deposit,359359249B0114451,04 PAYPAL GENERAL UNRESTR,"Subject: GeneralPage
Transaction ID: 359359249B0114451
https://www.paypal.com/activity/payment/359359249B0114451",PayPal Bank 3,--,$19.68,"$989,166.96"
Donations directed by individuals,09/22/2023,Deposit,359359249B0114451,04 PAYPAL GENERAL UNRESTR,Support Ukraine - Support Ukraine,Contributed income:Donations directed by individuals,PayPal Bank 3,$21.10,"$989,188.06"
PayPal Fees,09/22/2023,Deposit,359359249B0114451,04 PAYPAL GENERAL UNRESTR,PayPal fees,OFFICE/GENERAL ADMINISTRATIVE EXPENSES:PayPal Fees,PayPal Bank 3,$1.42,"$989,189.48"
PayPal Bank 3,09/22/2023,Deposit,5RW14553BU7106123,04 PAYPAL GENERAL UNRESTR,"Subject: Support Ukraine
Transaction ID: 5RW14553BU7106123
https://www.paypal.com/activity/payment/5RW14553BU7106123",PayPal Bank 3,--,$24.61,"$989,214.09"
Donations directed by individuals,09/22/2023,Deposit,5RW14553BU7106123,04 PAYPAL GENERAL UNRESTR,Money in to PayPal,Contributed income:Donations directed by individuals,PayPal Bank 3,$26.25,"$989,240.34"
PayPal Fees,09/22/2023,Deposit,5RW14553BU7106123,04 PAYPAL GENERAL UNRESTR,PayPal fees,OFFICE/GENERAL ADMINISTRATIVE EXPENSES:PayPal Fees,PayPal Bank 3,$1.64,"$989,241.98"
PayPal Bank 3,09/22/2023,Deposit,1N559813K2223021G,04 PAYPAL GENERAL UNRESTR,"Subject: Support Ukraine
Transaction ID: 1N559813K2223021G
https://www.paypal.com/activity/payment/1N559813K2223021G",PayPal Bank 3,--,$50.00,"$989,291.98"
Donations directed by individuals,09/22/2023,Deposit,1N559813K2223021G,04 PAYPAL GENERAL UNRESTR,Money in to PayPal,Contributed income:Donations directed by individuals,PayPal Bank 3,$51.99,"$989,343.97"
PayPal Fees,09/22/2023,Deposit,1N559813K2223021G,04 PAYPAL GENERAL UNRESTR,PayPal fees,OFFICE/GENERAL ADMINISTRATIVE EXPENSES:PayPal Fees,PayPal Bank 3,$1.99,"$989,345.96"
PayPal Bank 3,09/22/2023,Deposit,3F632953T3606281T,07 1000 DRONES RESTR,"Subject: 1000DRONES
Transaction ID: 3F632953T3606281T
https://www.paypal.com/activity/payment/3F632953T3606281T",PayPal Bank 3,--,$193.73,"$989,539.69"
Donations directed by individuals,09/22/2023,Deposit,3F632953T3606281T,07 1000 DRONES RESTR,1000 DRONES FOR UKRAINE - 1000 DRONES FOR UKRAINE,Contributed income:Donations directed by individuals,PayPal Bank 3,$200.00,"$989,739.69"
PayPal Fees,09/22/2023,Deposit,3F632953T3606281T,07 1000 DRONES RESTR,PayPal fees,OFFICE/GENERAL ADMINISTRATIVE EXPENSES:PayPal Fees,PayPal Bank 3,$6.27,"$989,745.96"
PayPal Bank 3,09/22/2023,Deposit,4JM21726SS849751D,04 PAYPAL GENERAL UNRESTR,"Subject: GeneralPage
Transaction ID: 4JM21726SS849751D
https://www.paypal.com/activity/payment/4JM21726SS849751D",PayPal Bank 3,--,$95.12,"$989,841.08"
Donations directed by individuals,09/22/2023,Deposit,4JM21726SS849751D,04 PAYPAL GENERAL UNRESTR,Support Ukraine - Support Ukraine,Contributed income:Donations directed by individuals,PayPal Bank 3,$100.00,"$989,941.08"
PayPal Fees,09/22/2023,Deposit,4JM21726SS849751D,04 PAYPAL GENERAL UNRESTR,PayPal fees,OFFICE/GENERAL ADMINISTRATIVE EXPENSES:PayPal Fees,PayPal Bank 3,$4.88,"$989,945.96"
PayPal Bank 3,09/22/2023,Deposit,5H0010721Y763150T,04 PAYPAL GENERAL UNRESTR,"Subject: GeneralPage
Transaction ID: 5H0010721Y763150T
https://www.paypal.com/activity/payment/5H0010721Y763150T",PayPal Bank 3,--,$95.12,"$990,041.08"
Donations directed by individuals,09/22/2023,Deposit,5H0010721Y763150T,04 PAYPAL GENERAL UNRESTR,Support Ukraine - Support Ukraine,Contributed income:Donations directed by individuals,PayPal Bank 3,$100.00,"$990,141.08"
PayPal Fees,09/22/2023,Deposit,5H0010721Y763150T,04 PAYPAL GENERAL UNRESTR,PayPal fees,OFFICE/GENERAL ADMINISTRATIVE EXPENSES:PayPal Fees,PayPal Bank 3,$4.88,"$990,145.96"
PayPal Bank 3,09/22/2023,Deposit,1LT21801GY7912345,07 1000 DRONES RESTR,"Subject: 1000DRONES
Transaction ID: 1LT21801GY7912345
https://www.paypal.com/activity/payment/1LT21801GY7912345",PayPal Bank 3,--,$492.26,"$990,638.22"
Donations directed by individuals,09/22/2023,Deposit,1LT21801GY7912345,07 1000 DRONES RESTR,1000 DRONES FOR UKRAINE - 1000 DRONES FOR UKRAINE,Contributed income:Donations directed by individuals,PayPal Bank 3,$515.38,"$991,153.60"
PayPal Fees,09/22/2023,Deposit,1LT21801GY7912345,07 1000 DRONES RESTR,PayPal fees,OFFICE/GENERAL ADMINISTRATIVE EXPENSES:PayPal Fees,PayPal Bank 3,$23.12,"$991,176.72"
PayPal Bank 3,09/22/2023,Deposit,4KE83002GX485871C,04 PAYPAL GENERAL UNRESTR,"Subject: GeneralPage
Note: Slava Ukraini!
Transaction ID: 4KE83002GX485871C
https://www.paypal.com/activity/payment/4KE83002GX485871C",PayPal Bank 3,--,$300.00,"$991,476.72"
Donations directed by individuals,09/22/2023,Deposit,4KE83002GX485871C,04 PAYPAL GENERAL UNRESTR,Support Ukraine - Support Ukraine,Contributed income:Donations directed by individuals,PayPal Bank 3,$309.43,"$991,786.15"
PayPal Fees,09/22/2023,Deposit,4KE83002GX485871C,04 PAYPAL GENERAL UNRESTR,PayPal fees,OFFICE/GENERAL ADMINISTRATIVE EXPENSES:PayPal Fees,PayPal Bank 3,$9.43,"$991,795.58"
PayPal Bank 3,09/22/2023,Deposit,2DA32544345137526,04 PAYPAL GENERAL UNRESTR,"Subject: GeneralPage
Note: Слава Україні ��
Transaction ID: 2DA32544345137526
https://www.paypal.com/activity/payment/2DA32544345137526",PayPal Bank 3,--,$19.68,"$991,815.26"
Donations directed by individuals,09/22/2023,Deposit,2DA32544345137526,04 PAYPAL GENERAL UNRESTR,Support Ukraine - Support Ukraine,Contributed income:Donations directed by individuals,PayPal Bank 3,$21.10,"$991,836.36"
PayPal Fees,09/22/2023,Deposit,2DA32544345137526,04 PAYPAL GENERAL UNRESTR,PayPal fees,OFFICE/GENERAL ADMINISTRATIVE EXPENSES:PayPal Fees,PayPal Bank 3,$1.42,"$991,837.78"
PayPal Bank 3,09/22/2023,Deposit,3S921031J73009534,04 PAYPAL GENERAL UNRESTR,"Subject: GeneralPage
Transaction ID: 3S921031J73009534
https://www.paypal.com/activity/payment/3S921031J73009534",PayPal Bank 3,--,$49.22,"$991,887.00"
Donations directed by individuals,09/22/2023,Deposit,3S921031J73009534,04 PAYPAL GENERAL UNRESTR,Support Ukraine - Support Ukraine,Contributed income:Donations directed by individuals,PayPal Bank 3,$51.99,"$991,938.99"
PayPal Fees,09/22/2023,Deposit,3S921031J73009534,04 PAYPAL GENERAL UNRESTR,PayPal fees,OFFICE/GENERAL ADMINISTRATIVE EXPENSES:PayPal Fees,PayPal Bank 3,$2.77,"$991,941.76"
PayPal Bank 3,09/22/2023,Deposit,2VM04440AS328494H,04 PAYPAL GENERAL UNRESTR,"Subject: GeneralPage
Transaction ID: 2VM04440AS328494H
https://www.paypal.com/activity/payment/2VM04440AS328494H",PayPal Bank 3,--,$95.12,"$992,036.88"
Donations directed by individuals,09/22/2023,Deposit,2VM04440AS328494H,04 PAYPAL GENERAL UNRESTR,Support Ukraine - Support Ukraine,Contributed income:Donations directed by individuals,PayPal Bank 3,$100.00,"$992,136.88"
PayPal Fees,09/22/2023,Deposit,2VM04440AS328494H,04 PAYPAL GENERAL UNRESTR,PayPal fees,OFFICE/GENERAL ADMINISTRATIVE EXPENSES:PayPal Fees,PayPal Bank 3,$4.88,"$992,141.76"
PayPal Bank 3,09/22/2023,Deposit,00K56961BF045794P,07 1000 DRONES RESTR,"Subject: 1000DRONES
Note: На дрони їбошити русню от родини одеситів.   Дякуємо за тещо ви робите!
Transaction ID: 00K56961BF045794P
https://www.paypal.com/activity/payment/00K56961BF045794P",PayPal Bank 3,--,$47.31,"$992,189.07"
Donations directed by individuals,09/22/2023,Deposit,00K56961BF045794P,07 1000 DRONES RESTR,1000 DRONES FOR UKRAINE - 1000 DRONES FOR UKRAINE,Contributed income:Donations directed by individuals,PayPal Bank 3,$50.00,"$992,239.07"
PayPal Fees,09/22/2023,Deposit,00K56961BF045794P,07 1000 DRONES RESTR,PayPal fees,OFFICE/GENERAL ADMINISTRATIVE EXPENSES:PayPal Fees,PayPal Bank 3,$2.69,"$992,241.76"
PayPal Bank 3,09/22/2023,Deposit,98S39545HS489392P,04 PAYPAL GENERAL UNRESTR,"Subject: GeneralPage
Transaction ID: 98S39545HS489392P
https://www.paypal.com/activity/payment/98S39545HS489392P",PayPal Bank 3,--,$39.37,"$992,281.13"
Donations directed by individuals,09/22/2023,Deposit,98S39545HS489392P,04 PAYPAL GENERAL UNRESTR,Support Ukraine - Support Ukraine,Contributed income:Donations directed by individuals,PayPal Bank 3,$41.69,"$992,322.82"
PayPal Fees,09/22/2023,Deposit,98S39545HS489392P,04 PAYPAL GENERAL UNRESTR,PayPal fees,OFFICE/GENERAL ADMINISTRATIVE EXPENSES:PayPal Fees,PayPal Bank 3,$2.32,"$992,325.14"
PayPal Bank 3,09/22/2023,Deposit,5RS06339Y0587420W,04 PAYPAL GENERAL UNRESTR,"Subject: GeneralPage
Transaction ID: 5RS06339Y0587420W
https://www.paypal.com/activity/payment/5RS06339Y0587420W",PayPal Bank 3,--,$246.13,"$992,571.27"
Donations directed by individuals,09/22/2023,Deposit,5RS06339Y0587420W,04 PAYPAL GENERAL UNRESTR,Support Ukraine - Support Ukraine,Contributed income:Donations directed by individuals,PayPal Bank 3,$257.94,"$992,829.21"
PayPal Fees,09/22/2023,Deposit,5RS06339Y0587420W,04 PAYPAL GENERAL UNRESTR,PayPal fees,OFFICE/GENERAL ADMINISTRATIVE EXPENSES:PayPal Fees,PayPal Bank 3,$11.81,"$992,841.02"
PayPal Bank 3,09/22/2023,Deposit,3WG41587NM439472Y,04 PAYPAL GENERAL UNRESTR,"Subject: GeneralPage
Transaction ID: 3WG41587NM439472Y
https://www.paypal.com/activity/payment/3WG41587NM439472Y",PayPal Bank 3,--,$47.31,"$992,888.33"
Donations directed by individuals,09/22/2023,Deposit,3WG41587NM439472Y,04 PAYPAL GENERAL UNRESTR,Support Ukraine - Support Ukraine,Contributed income:Donations directed by individuals,PayPal Bank 3,$50.00,"$992,938.33"
PayPal Fees,09/22/2023,Deposit,3WG41587NM439472Y,04 PAYPAL GENERAL UNRESTR,PayPal fees,OFFICE/GENERAL ADMINISTRATIVE EXPENSES:PayPal Fees,PayPal Bank 3,$2.69,"$992,941.02"
PayPal Bank 3,09/22/2023,Deposit,33T93556B1385403L,04 PAYPAL GENERAL UNRESTR,"Subject: GeneralPage
Transaction ID: 33T93556B1385403L
https://www.paypal.com/activity/payment/33T93556B1385403L",PayPal Bank 3,--,$19.68,"$992,960.70"
Donations directed by individuals,09/22/2023,Deposit,33T93556B1385403L,04 PAYPAL GENERAL UNRESTR,Support Ukraine - Support Ukraine,Contributed income:Donations directed by individuals,PayPal Bank 3,$21.10,"$992,981.80"
PayPal Fees,09/22/2023,Deposit,33T93556B1385403L,04 PAYPAL GENERAL UNRESTR,PayPal fees,OFFICE/GENERAL ADMINISTRATIVE EXPENSES:PayPal Fees,PayPal Bank 3,$1.42,"$992,983.22"
PayPal Bank 3,09/22/2023,Deposit,6TY60856ET897635N,04 PAYPAL GENERAL UNRESTR,"Subject: GeneralPage
Transaction ID: 6TY60856ET897635N
https://www.paypal.com/activity/payment/6TY60856ET897635N",PayPal Bank 3,--,$9.84,"$992,993.06"
Donations directed by individuals,09/22/2023,Deposit,6TY60856ET897635N,04 PAYPAL GENERAL UNRESTR,Support Ukraine - Support Ukraine,Contributed income:Donations directed by individuals,PayPal Bank 3,$10.80,"$993,003.86"
PayPal Fees,09/22/2023,Deposit,6TY60856ET897635N,04 PAYPAL GENERAL UNRESTR,PayPal fees,OFFICE/GENERAL ADMINISTRATIVE EXPENSES:PayPal Fees,PayPal Bank 3,$0.96,"$993,004.82"
PayPal Bank 3,09/22/2023,Deposit,2AG40679G54369508,07 1000 DRONES RESTR,"Subject: 1000DRONES
Transaction ID: 2AG40679G54369508
https://www.paypal.com/activity/payment/2AG40679G54369508",PayPal Bank 3,--,$9.07,"$993,013.89"
Donations directed by individuals,09/22/2023,Deposit,2AG40679G54369508,07 1000 DRONES RESTR,1000 DRONES FOR UKRAINE - 1000 DRONES FOR UKRAINE,Contributed income:Donations directed by individuals,PayPal Bank 3,$10.00,"$993,023.89"
PayPal Fees,09/22/2023,Deposit,2AG40679G54369508,07 1000 DRONES RESTR,PayPal fees,OFFICE/GENERAL ADMINISTRATIVE EXPENSES:PayPal Fees,PayPal Bank 3,$0.93,"$993,024.82"
PayPal Bank 3,09/22/2023,Deposit,27365438GR4770420,04 PAYPAL GENERAL UNRESTR,"Subject: GeneralPage
Transaction ID: 27365438GR4770420
https://www.paypal.com/activity/payment/27365438GR4770420",PayPal Bank 3,--,$500.00,"$993,524.82"
Donations directed by individuals,09/22/2023,Deposit,27365438GR4770420,04 PAYPAL GENERAL UNRESTR,Support Ukraine - Support Ukraine,Contributed income:Donations directed by individuals,PayPal Bank 3,$515.38,"$994,040.20"
PayPal Fees,09/22/2023,Deposit,27365438GR4770420,04 PAYPAL GENERAL UNRESTR,PayPal fees,OFFICE/GENERAL ADMINISTRATIVE EXPENSES:PayPal Fees,PayPal Bank 3,$15.38,"$994,055.58"
PayPal Bank 3,09/22/2023,Deposit,58G17779VT869534N,04 PAYPAL GENERAL UNRESTR,"Subject: GeneralPage
Transaction ID: 58G17779VT869534N
https://www.paypal.com/activity/payment/58G17779VT869534N",PayPal Bank 3,--,$147.68,"$994,203.26"
Donations directed by individuals,09/22/2023,Deposit,58G17779VT869534N,04 PAYPAL GENERAL UNRESTR,Support Ukraine - Support Ukraine,Contributed income:Donations directed by individuals,PayPal Bank 3,$154.97,"$994,358.23"
PayPal Fees,09/22/2023,Deposit,58G17779VT869534N,04 PAYPAL GENERAL UNRESTR,PayPal fees,OFFICE/GENERAL ADMINISTRATIVE EXPENSES:PayPal Fees,PayPal Bank 3,$7.29,"$994,365.52"
PayPal Bank 3,09/22/2023,Deposit,4FP558038W846493C,04 PAYPAL GENERAL UNRESTR,"Subject: GeneralPage
Transaction ID: 4FP558038W846493C
https://www.paypal.com/activity/payment/4FP558038W846493C",PayPal Bank 3,--,$9.84,"$994,375.36"
Donations directed by individuals,09/22/2023,Deposit,4FP558038W846493C,04 PAYPAL GENERAL UNRESTR,Support Ukraine - Support Ukraine,Contributed income:Donations directed by individuals,PayPal Bank 3,$10.80,"$994,386.16"
PayPal Fees,09/22/2023,Deposit,4FP558038W846493C,04 PAYPAL GENERAL UNRESTR,PayPal fees,OFFICE/GENERAL ADMINISTRATIVE EXPENSES:PayPal Fees,PayPal Bank 3,$0.96,"$994,387.12"
PayPal Bank 3,09/22/2023,Deposit,94613622SY192712G,04 PAYPAL GENERAL UNRESTR,"Subject: GeneralPage
Transaction ID: 94613622SY192712G
https://www.paypal.com/activity/payment/94613622SY192712G",PayPal Bank 3,--,$49.22,"$994,436.34"
Donations directed by individuals,09/22/2023,Deposit,94613622SY192712G,04 PAYPAL GENERAL UNRESTR,Support Ukraine - Support Ukraine,Contributed income:Donations directed by individuals,PayPal Bank 3,$51.99,"$994,488.33"
PayPal Fees,09/22/2023,Deposit,94613622SY192712G,04 PAYPAL GENERAL UNRESTR,PayPal fees,OFFICE/GENERAL ADMINISTRATIVE EXPENSES:PayPal Fees,PayPal Bank 3,$2.77,"$994,491.10"
PayPal Bank 3,09/22/2023,Deposit,4R202272UT023183C,04 PAYPAL GENERAL UNRESTR,"Subject: GeneralPage
Transaction ID: 4R202272UT023183C
https://www.paypal.com/activity/payment/4R202272UT023183C",PayPal Bank 3,--,$96.62,"$994,587.72"
Donations directed by individuals,09/22/2023,Deposit,4R202272UT023183C,04 PAYPAL GENERAL UNRESTR,Support Ukraine - Support Ukraine,Contributed income:Donations directed by individuals,PayPal Bank 3,$100.00,"$994,687.72"
PayPal Fees,09/22/2023,Deposit,4R202272UT023183C,04 PAYPAL GENERAL UNRESTR,PayPal fees,OFFICE/GENERAL ADMINISTRATIVE EXPENSES:PayPal Fees,PayPal Bank 3,$3.38,"$994,691.10"
PayPal Bank 3,09/22/2023,Deposit,7TY77350AB906844H,04 PAYPAL GENERAL UNRESTR,"Subject: GeneralPage
Transaction ID: 7TY77350AB906844H
https://www.paypal.com/activity/payment/7TY77350AB906844H",PayPal Bank 3,--,$29.53,"$994,720.63"
Donations directed by individuals,09/22/2023,Deposit,7TY77350AB906844H,04 PAYPAL GENERAL UNRESTR,Support Ukraine - Support Ukraine,Contributed income:Donations directed by individuals,PayPal Bank 3,$31.40,"$994,752.03"
PayPal Fees,09/22/2023,Deposit,7TY77350AB906844H,04 PAYPAL GENERAL UNRESTR,PayPal fees,OFFICE/GENERAL ADMINISTRATIVE EXPENSES:PayPal Fees,PayPal Bank 3,$1.87,"$994,753.90"
PayPal Bank 3,09/22/2023,Deposit,53E41718GV723764U,07 1000 DRONES RESTR,"Subject: GeneralPage
Note: Spende für FPV-Drone
Transaction ID: 53E41718GV723764U
https://www.paypal.com/activity/payment/53E41718GV723764U",PayPal Bank 3,--,$49.22,"$994,803.12"
Donations directed by individuals,09/22/2023,Deposit,53E41718GV723764U,07 1000 DRONES RESTR,Support Ukraine - Support Ukraine,Contributed income:Donations directed by individuals,PayPal Bank 3,$51.99,"$994,855.11"
PayPal Fees,09/22/2023,Deposit,53E41718GV723764U,07 1000 DRONES RESTR,PayPal fees,OFFICE/GENERAL ADMINISTRATIVE EXPENSES:PayPal Fees,PayPal Bank 3,$2.77,"$994,857.88"
PayPal Bank 3,09/22/2023,Deposit,66N44466GY225503S,04 PAYPAL GENERAL UNRESTR,"Subject: GeneralPage
Transaction ID: 66N44466GY225503S
https://www.paypal.com/activity/payment/66N44466GY225503S",PayPal Bank 3,--,$95.12,"$994,953.00"
Donations directed by individuals,09/22/2023,Deposit,66N44466GY225503S,04 PAYPAL GENERAL UNRESTR,Support Ukraine - Support Ukraine,Contributed income:Donations directed by individuals,PayPal Bank 3,$100.00,"$995,053.00"
PayPal Fees,09/22/2023,Deposit,66N44466GY225503S,04 PAYPAL GENERAL UNRESTR,PayPal fees,OFFICE/GENERAL ADMINISTRATIVE EXPENSES:PayPal Fees,PayPal Bank 3,$4.88,"$995,057.88"
PayPal Bank 3,09/22/2023,Deposit,80876349UY840945G,04 PAYPAL GENERAL UNRESTR,"Subject: GeneralPage
Transaction ID: 80876349UY840945G
https://www.paypal.com/activity/payment/80876349UY840945G",PayPal Bank 3,--,$20.67,"$995,078.55"
Donations directed by individuals,09/22/2023,Deposit,80876349UY840945G,04 PAYPAL GENERAL UNRESTR,Support Ukraine - Support Ukraine,Contributed income:Donations directed by individuals,PayPal Bank 3,$22.13,"$995,100.68"
PayPal Fees,09/22/2023,Deposit,80876349UY840945G,04 PAYPAL GENERAL UNRESTR,PayPal fees,OFFICE/GENERAL ADMINISTRATIVE EXPENSES:PayPal Fees,PayPal Bank 3,$1.46,"$995,102.14"
PayPal Bank 3,09/22/2023,Deposit,7UG234104N448590P,04 PAYPAL GENERAL UNRESTR,"Subject: Support Ukraine
Transaction ID: 7UG234104N448590P
https://www.paypal.com/activity/payment/7UG234104N448590P",PayPal Bank 3,--,$10.82,"$995,112.96"
Donations directed by individuals,09/22/2023,Deposit,7UG234104N448590P,04 PAYPAL GENERAL UNRESTR,Money in to PayPal,Contributed income:Donations directed by individuals,PayPal Bank 3,$11.83,"$995,124.79"
PayPal Fees,09/22/2023,Deposit,7UG234104N448590P,04 PAYPAL GENERAL UNRESTR,PayPal fees,OFFICE/GENERAL ADMINISTRATIVE EXPENSES:PayPal Fees,PayPal Bank 3,$1.01,"$995,125.80"
PayPal Bank 3,09/22/2023,Deposit,4WD93372323467427,04 PAYPAL GENERAL UNRESTR,"Subject: GeneralPage
Transaction ID: 4WD93372323467427
https://www.paypal.com/activity/payment/4WD93372323467427",PayPal Bank 3,--,$9.84,"$995,135.64"
Donations directed by individuals,09/22/2023,Deposit,4WD93372323467427,04 PAYPAL GENERAL UNRESTR,Support Ukraine - Support Ukraine,Contributed income:Donations directed by individuals,PayPal Bank 3,$10.80,"$995,146.44"
PayPal Fees,09/22/2023,Deposit,4WD93372323467427,04 PAYPAL GENERAL UNRESTR,PayPal fees,OFFICE/GENERAL ADMINISTRATIVE EXPENSES:PayPal Fees,PayPal Bank 3,$0.96,"$995,147.40"
PayPal Bank 3,09/22/2023,Deposit,23670184G2819700Y,04 PAYPAL GENERAL UNRESTR,"Subject: GeneralPage
Transaction ID: 23670184G2819700Y
https://www.paypal.com/activity/payment/23670184G2819700Y",PayPal Bank 3,--,$50.00,"$995,197.40"
Donations directed by individuals,09/22/2023,Deposit,23670184G2819700Y,04 PAYPAL GENERAL UNRESTR,Support Ukraine - Support Ukraine,Contributed income:Donations directed by individuals,PayPal Bank 3,$51.99,"$995,249.39"
PayPal Fees,09/22/2023,Deposit,23670184G2819700Y,04 PAYPAL GENERAL UNRESTR,PayPal fees,OFFICE/GENERAL ADMINISTRATIVE EXPENSES:PayPal Fees,PayPal Bank 3,$1.99,"$995,251.38"
PayPal Bank 3,09/22/2023,Deposit,61X72037XP3307507,08 VICTORY DRONES RESTR,"Subject: VICTORY DRONES
Transaction ID: 61X72037XP3307507
https://www.paypal.com/activity/payment/61X72037XP3307507",PayPal Bank 3,--,$2.94,"$995,254.32"
Donations directed by individuals,09/22/2023,Deposit,61X72037XP3307507,08 VICTORY DRONES RESTR,Money in to PayPal,Contributed income:Donations directed by individuals,PayPal Bank 3,$3.59,"$995,257.91"
PayPal Fees,09/22/2023,Deposit,61X72037XP3307507,08 VICTORY DRONES RESTR,PayPal fees,OFFICE/GENERAL ADMINISTRATIVE EXPENSES:PayPal Fees,PayPal Bank 3,$0.65,"$995,258.56"
PayPal Bank 3,09/22/2023,Deposit,496874789A098354V,04 PAYPAL GENERAL UNRESTR,"Subject: GeneralPage
Transaction ID: 496874789A098354V
https://www.paypal.com/activity/payment/496874789A098354V",PayPal Bank 3,--,$49.22,"$995,307.78"
Donations directed by individuals,09/22/2023,Deposit,496874789A098354V,04 PAYPAL GENERAL UNRESTR,Support Ukraine - Support Ukraine,Contributed income:Donations directed by individuals,PayPal Bank 3,$51.99,"$995,359.77"
PayPal Fees,09/22/2023,Deposit,496874789A098354V,04 PAYPAL GENERAL UNRESTR,PayPal fees,OFFICE/GENERAL ADMINISTRATIVE EXPENSES:PayPal Fees,PayPal Bank 3,$2.77,"$995,362.54"
PayPal Bank 3,09/22/2023,Deposit,5JN97613TA549501S,04 PAYPAL GENERAL UNRESTR,"Subject: GeneralPage
Transaction ID: 5JN97613TA549501S
https://www.paypal.com/activity/payment/5JN97613TA549501S",PayPal Bank 3,--,$9.22,"$995,371.76"
Donations directed by individuals,09/22/2023,Deposit,5JN97613TA549501S,04 PAYPAL GENERAL UNRESTR,Support Ukraine - Support Ukraine,Contributed income:Donations directed by individuals,PayPal Bank 3,$10.00,"$995,381.76"
PayPal Fees,09/22/2023,Deposit,5JN97613TA549501S,04 PAYPAL GENERAL UNRESTR,PayPal fees,OFFICE/GENERAL ADMINISTRATIVE EXPENSES:PayPal Fees,PayPal Bank 3,$0.78,"$995,382.54"
PayPal Bank 3,09/22/2023,Deposit,9N53505568674084L,07 1000 DRONES RESTR,"Subject: GeneralPage
Note: На люті пташки
Transaction ID: 9N53505568674084L
https://www.paypal.com/activity/payment/9N53505568674084L",PayPal Bank 3,--,$48.06,"$995,430.60"
Donations directed by individuals,09/22/2023,Deposit,9N53505568674084L,07 1000 DRONES RESTR,Support Ukraine - Support Ukraine,Contributed income:Donations directed by individuals,PayPal Bank 3,$50.00,"$995,480.60"
PayPal Fees,09/22/2023,Deposit,9N53505568674084L,07 1000 DRONES RESTR,PayPal fees,OFFICE/GENERAL ADMINISTRATIVE EXPENSES:PayPal Fees,PayPal Bank 3,$1.94,"$995,482.54"
PayPal Bank 3,09/22/2023,Deposit,67H76598CF579340P,04 PAYPAL GENERAL UNRESTR,"Subject: GeneralPage
Transaction ID: 67H76598CF579340P
https://www.paypal.com/activity/payment/67H76598CF579340P",PayPal Bank 3,--,$48.06,"$995,530.60"
Donations directed by individuals,09/22/2023,Deposit,67H76598CF579340P,04 PAYPAL GENERAL UNRESTR,Support Ukraine - Support Ukraine,Contributed income:Donations directed by individuals,PayPal Bank 3,$50.00,"$995,580.60"
PayPal Fees,09/22/2023,Deposit,67H76598CF579340P,04 PAYPAL GENERAL UNRESTR,PayPal fees,OFFICE/GENERAL ADMINISTRATIVE EXPENSES:PayPal Fees,PayPal Bank 3,$1.94,"$995,582.54"
PayPal Bank 3,09/22/2023,Deposit,4JA304881D342170Y,07 1000 DRONES RESTR,"Subject: 1000DRONES
Transaction ID: 4JA304881D342170Y
https://www.paypal.com/activity/payment/4JA304881D342170Y",PayPal Bank 3,--,$98.45,"$995,680.99"
Donations directed by individuals,09/22/2023,Deposit,4JA304881D342170Y,07 1000 DRONES RESTR,1000 DRONES FOR UKRAINE - 1000 DRONES FOR UKRAINE,Contributed income:Donations directed by individuals,PayPal Bank 3,$103.48,"$995,784.47"
PayPal Fees,09/22/2023,Deposit,4JA304881D342170Y,07 1000 DRONES RESTR,PayPal fees,OFFICE/GENERAL ADMINISTRATIVE EXPENSES:PayPal Fees,PayPal Bank 3,$5.03,"$995,789.50"
PayPal Bank 3,09/22/2023,Deposit,5DJ85528JP825880T,04 PAYPAL GENERAL UNRESTR,"Subject: GeneralPage
Transaction ID: 5DJ85528JP825880T
https://www.paypal.com/activity/payment/5DJ85528JP825880T",PayPal Bank 3,--,$98.45,"$995,887.95"
Donations directed by individuals,09/22/2023,Deposit,5DJ85528JP825880T,04 PAYPAL GENERAL UNRESTR,Support Ukraine - Support Ukraine,Contributed income:Donations directed by individuals,PayPal Bank 3,$103.48,"$995,991.43"
PayPal Fees,09/22/2023,Deposit,5DJ85528JP825880T,04 PAYPAL GENERAL UNRESTR,PayPal fees,OFFICE/GENERAL ADMINISTRATIVE EXPENSES:PayPal Fees,PayPal Bank 3,$5.03,"$995,996.46"
PayPal Bank 3,09/22/2023,Deposit,8HL11662SR0867322,04 PAYPAL GENERAL UNRESTR,"Subject: Support Ukraine
Transaction ID: 8HL11662SR0867322
https://www.paypal.com/activity/payment/8HL11662SR0867322",PayPal Bank 3,--,$47.31,"$996,043.77"
Donations directed by individuals,09/22/2023,Deposit,8HL11662SR0867322,04 PAYPAL GENERAL UNRESTR,Money in to PayPal,Contributed income:Donations directed by individuals,PayPal Bank 3,$50.00,"$996,093.77"
PayPal Fees,09/22/2023,Deposit,8HL11662SR0867322,04 PAYPAL GENERAL UNRESTR,PayPal fees,OFFICE/GENERAL ADMINISTRATIVE EXPENSES:PayPal Fees,PayPal Bank 3,$2.69,"$996,096.46"
PayPal Bank 3,09/22/2023,Deposit,3UH11990LU863560R,04 PAYPAL GENERAL UNRESTR,"Subject: Support Ukraine
Transaction ID: 3UH11990LU863560R
https://www.paypal.com/activity/payment/3UH11990LU863560R",PayPal Bank 3,--,$47.31,"$996,143.77"
Donations directed by individuals,09/22/2023,Deposit,3UH11990LU863560R,04 PAYPAL GENERAL UNRESTR,Money in to PayPal,Contributed income:Donations directed by individuals,PayPal Bank 3,$50.00,"$996,193.77"
PayPal Fees,09/22/2023,Deposit,3UH11990LU863560R,04 PAYPAL GENERAL UNRESTR,PayPal fees,OFFICE/GENERAL ADMINISTRATIVE EXPENSES:PayPal Fees,PayPal Bank 3,$2.69,"$996,196.46"
PayPal Bank 3,09/22/2023,Deposit,10P63206A8040883B,04 PAYPAL GENERAL UNRESTR,"Subject: GeneralPage
Transaction ID: 10P63206A8040883B
https://www.paypal.com/activity/payment/10P63206A8040883B",PayPal Bank 3,--,$14.76,"$996,211.22"
Donations directed by individuals,09/22/2023,Deposit,10P63206A8040883B,04 PAYPAL GENERAL UNRESTR,Support Ukraine - Support Ukraine,Contributed income:Donations directed by individuals,PayPal Bank 3,$15.95,"$996,227.17"
PayPal Fees,09/22/2023,Deposit,10P63206A8040883B,04 PAYPAL GENERAL UNRESTR,PayPal fees,OFFICE/GENERAL ADMINISTRATIVE EXPENSES:PayPal Fees,PayPal Bank 3,$1.19,"$996,228.36"
PayPal Bank 3,09/22/2023,Deposit,2JB49266W5158790U,04 PAYPAL GENERAL UNRESTR,"Subject: GeneralPage
Transaction ID: 2JB49266W5158790U
https://www.paypal.com/activity/payment/2JB49266W5158790U",PayPal Bank 3,--,$96.62,"$996,324.98"
Donations directed by individuals,09/22/2023,Deposit,2JB49266W5158790U,04 PAYPAL GENERAL UNRESTR,Support Ukraine - Support Ukraine,Contributed income:Donations directed by individuals,PayPal Bank 3,$100.00,"$996,424.98"
PayPal Fees,09/22/2023,Deposit,2JB49266W5158790U,04 PAYPAL GENERAL UNRESTR,PayPal fees,OFFICE/GENERAL ADMINISTRATIVE EXPENSES:PayPal Fees,PayPal Bank 3,$3.38,"$996,428.36"
PayPal Bank 3,09/22/2023,Deposit,4JS579261V5573904,07 1000 DRONES RESTR,"Subject: 1000DRONES
Transaction ID: 4JS579261V5573904
https://www.paypal.com/activity/payment/4JS579261V5573904",PayPal Bank 3,--,$29.53,"$996,457.89"
Donations directed by individuals,09/22/2023,Deposit,4JS579261V5573904,07 1000 DRONES RESTR,1000 DRONES FOR UKRAINE - 1000 DRONES FOR UKRAINE,Contributed income:Donations directed by individuals,PayPal Bank 3,$31.40,"$996,489.29"
PayPal Fees,09/22/2023,Deposit,4JS579261V5573904,07 1000 DRONES RESTR,PayPal fees,OFFICE/GENERAL ADMINISTRATIVE EXPENSES:PayPal Fees,PayPal Bank 3,$1.87,"$996,491.16"
PayPal Bank 3,09/22/2023,Deposit,8SM41909B8153125G,04 PAYPAL GENERAL UNRESTR,"Subject: GeneralPage
Transaction ID: 8SM41909B8153125G
https://www.paypal.com/activity/payment/8SM41909B8153125G",PayPal Bank 3,--,$19.68,"$996,510.84"
Donations directed by individuals,09/22/2023,Deposit,8SM41909B8153125G,04 PAYPAL GENERAL UNRESTR,Support Ukraine - Support Ukraine,Contributed income:Donations directed by individuals,PayPal Bank 3,$21.10,"$996,531.94"
PayPal Fees,09/22/2023,Deposit,8SM41909B8153125G,04 PAYPAL GENERAL UNRESTR,PayPal fees,OFFICE/GENERAL ADMINISTRATIVE EXPENSES:PayPal Fees,PayPal Bank 3,$1.42,"$996,533.36"
PayPal Bank 3,09/22/2023,Deposit,78S8914314077252C,04 PAYPAL GENERAL UNRESTR,"Subject: GeneralPage
Transaction ID: 78S8914314077252C
https://www.paypal.com/activity/payment/78S8914314077252C",PayPal Bank 3,--,$49.22,"$996,582.58"
Donations directed by individuals,09/22/2023,Deposit,78S8914314077252C,04 PAYPAL GENERAL UNRESTR,Support Ukraine - Support Ukraine,Contributed income:Donations directed by individuals,PayPal Bank 3,$51.99,"$996,634.57"
PayPal Fees,09/22/2023,Deposit,78S8914314077252C,04 PAYPAL GENERAL UNRESTR,PayPal fees,OFFICE/GENERAL ADMINISTRATIVE EXPENSES:PayPal Fees,PayPal Bank 3,$2.77,"$996,637.34"
PayPal Bank 3,09/22/2023,Deposit,82B04636ND647513M,04 PAYPAL GENERAL UNRESTR,"Subject: GeneralPage
Transaction ID: 82B04636ND647513M
https://www.paypal.com/activity/payment/82B04636ND647513M",PayPal Bank 3,--,$276.61,"$996,913.95"
Donations directed by individuals,09/22/2023,Deposit,82B04636ND647513M,04 PAYPAL GENERAL UNRESTR,Support Ukraine - Support Ukraine,Contributed income:Donations directed by individuals,PayPal Bank 3,$289.82,"$997,203.77"
PayPal Fees,09/22/2023,Deposit,82B04636ND647513M,04 PAYPAL GENERAL UNRESTR,PayPal fees,OFFICE/GENERAL ADMINISTRATIVE EXPENSES:PayPal Fees,PayPal Bank 3,$13.21,"$997,216.98"
PayPal Bank 3,09/22/2023,Deposit,9R089859FU788214C,04 PAYPAL GENERAL UNRESTR,"Subject: GeneralPage
Transaction ID: 9R089859FU788214C
https://www.paypal.com/activity/payment/9R089859FU788214C",PayPal Bank 3,--,$9.84,"$997,226.82"
Donations directed by individuals,09/22/2023,Deposit,9R089859FU788214C,04 PAYPAL GENERAL UNRESTR,Support Ukraine - Support Ukraine,Contributed income:Donations directed by individuals,PayPal Bank 3,$10.80,"$997,237.62"
PayPal Fees,09/22/2023,Deposit,9R089859FU788214C,04 PAYPAL GENERAL UNRESTR,PayPal fees,OFFICE/GENERAL ADMINISTRATIVE EXPENSES:PayPal Fees,PayPal Bank 3,$0.96,"$997,238.58"
PayPal Bank 3,09/22/2023,Deposit,2B971202F4835130S,07 1000 DRONES RESTR,"Subject: 1000DRONES
Transaction ID: 2B971202F4835130S
https://www.paypal.com/activity/payment/2B971202F4835130S",PayPal Bank 3,--,$200.00,"$997,438.58"
Donations directed by individuals,09/22/2023,Deposit,2B971202F4835130S,07 1000 DRONES RESTR,1000 DRONES FOR UKRAINE - 1000 DRONES FOR UKRAINE,Contributed income:Donations directed by individuals,PayPal Bank 3,$206.46,"$997,645.04"
PayPal Fees,09/22/2023,Deposit,2B971202F4835130S,07 1000 DRONES RESTR,PayPal fees,OFFICE/GENERAL ADMINISTRATIVE EXPENSES:PayPal Fees,PayPal Bank 3,$6.46,"$997,651.50"
PayPal Bank 3,09/22/2023,Deposit,8D816449WB8347731,04 PAYPAL GENERAL UNRESTR,"Subject: GeneralPage
Transaction ID: 8D816449WB8347731
https://www.paypal.com/activity/payment/8D816449WB8347731",PayPal Bank 3,--,$13.85,"$997,665.35"
Donations directed by individuals,09/22/2023,Deposit,8D816449WB8347731,04 PAYPAL GENERAL UNRESTR,Support Ukraine - Support Ukraine,Contributed income:Donations directed by individuals,PayPal Bank 3,$15.00,"$997,680.35"
PayPal Fees,09/22/2023,Deposit,8D816449WB8347731,04 PAYPAL GENERAL UNRESTR,PayPal fees,OFFICE/GENERAL ADMINISTRATIVE EXPENSES:PayPal Fees,PayPal Bank 3,$1.15,"$997,681.50"
PayPal Bank 3,09/22/2023,Deposit,0XJ17311J57320303,07 1000 DRONES RESTR,"Subject: 1000DRONES
Transaction ID: 0XJ17311J57320303
https://www.paypal.com/activity/payment/0XJ17311J57320303",PayPal Bank 3,--,$100.00,"$997,781.50"
Donations directed by individuals,09/22/2023,Deposit,0XJ17311J57320303,07 1000 DRONES RESTR,1000 DRONES FOR UKRAINE - 1000 DRONES FOR UKRAINE,Contributed income:Donations directed by individuals,PayPal Bank 3,$103.48,"$997,884.98"
PayPal Fees,09/22/2023,Deposit,0XJ17311J57320303,07 1000 DRONES RESTR,PayPal fees,OFFICE/GENERAL ADMINISTRATIVE EXPENSES:PayPal Fees,PayPal Bank 3,$3.48,"$997,888.46"
PayPal Bank 3,09/22/2023,Deposit,53V20915JA1803934,04 PAYPAL GENERAL UNRESTR,"Subject: GeneralPage
Transaction ID: 53V20915JA1803934
https://www.paypal.com/activity/payment/53V20915JA1803934",PayPal Bank 3,--,$9.84,"$997,898.30"
Donations directed by individuals,09/22/2023,Deposit,53V20915JA1803934,04 PAYPAL GENERAL UNRESTR,Support Ukraine - Support Ukraine,Contributed income:Donations directed by individuals,PayPal Bank 3,$10.80,"$997,909.10"
PayPal Fees,09/22/2023,Deposit,53V20915JA1803934,04 PAYPAL GENERAL UNRESTR,PayPal fees,OFFICE/GENERAL ADMINISTRATIVE EXPENSES:PayPal Fees,PayPal Bank 3,$0.96,"$997,910.06"
PayPal Bank 3,09/22/2023,Deposit,77U01518B5083202L,04 PAYPAL GENERAL UNRESTR,"Subject: GeneralPage
Transaction ID: 77U01518B5083202L
https://www.paypal.com/activity/payment/77U01518B5083202L",PayPal Bank 3,--,$50.00,"$997,960.06"
Donations directed by individuals,09/22/2023,Deposit,77U01518B5083202L,04 PAYPAL GENERAL UNRESTR,Support Ukraine - Support Ukraine,Contributed income:Donations directed by individuals,PayPal Bank 3,$51.99,"$998,012.05"
PayPal Fees,09/22/2023,Deposit,77U01518B5083202L,04 PAYPAL GENERAL UNRESTR,PayPal fees,OFFICE/GENERAL ADMINISTRATIVE EXPENSES:PayPal Fees,PayPal Bank 3,$1.99,"$998,014.04"
PayPal Bank 3,09/22/2023,Deposit,8DW22426UN678923Y,04 PAYPAL GENERAL UNRESTR,"Subject: GeneralPage
Transaction ID: 8DW22426UN678923Y
https://www.paypal.com/activity/payment/8DW22426UN678923Y",PayPal Bank 3,--,$295.36,"$998,309.40"
Donations directed by individuals,09/22/2023,Deposit,8DW22426UN678923Y,04 PAYPAL GENERAL UNRESTR,Support Ukraine - Support Ukraine,Contributed income:Donations directed by individuals,PayPal Bank 3,$309.43,"$998,618.83"
PayPal Fees,09/22/2023,Deposit,8DW22426UN678923Y,04 PAYPAL GENERAL UNRESTR,PayPal fees,OFFICE/GENERAL ADMINISTRATIVE EXPENSES:PayPal Fees,PayPal Bank 3,$14.07,"$998,632.90"
PayPal Bank 3,09/22/2023,Deposit,58H02392HU906463P,07 1000 DRONES RESTR,"Subject: GeneralPage
Note: Drons����
Transaction ID: 58H02392HU906463P
https://www.paypal.com/activity/payment/58H02392HU906463P",PayPal Bank 3,--,$48.06,"$998,680.96"
Donations directed by individuals,09/22/2023,Deposit,58H02392HU906463P,07 1000 DRONES RESTR,Support Ukraine - Support Ukraine,Contributed income:Donations directed by individuals,PayPal Bank 3,$50.00,"$998,730.96"
PayPal Fees,09/22/2023,Deposit,58H02392HU906463P,07 1000 DRONES RESTR,PayPal fees,OFFICE/GENERAL ADMINISTRATIVE EXPENSES:PayPal Fees,PayPal Bank 3,$1.94,"$998,732.90"
PayPal Bank 3,09/22/2023,Deposit,2AK77463G6229984D,04 PAYPAL GENERAL UNRESTR,"Subject: GeneralPage
Transaction ID: 2AK77463G6229984D
https://www.paypal.com/activity/payment/2AK77463G6229984D",PayPal Bank 3,--,$30.00,"$998,762.90"
Donations directed by individuals,09/22/2023,Deposit,2AK77463G6229984D,04 PAYPAL GENERAL UNRESTR,Support Ukraine - Support Ukraine,Contributed income:Donations directed by individuals,PayPal Bank 3,$31.40,"$998,794.30"
PayPal Fees,09/22/2023,Deposit,2AK77463G6229984D,04 PAYPAL GENERAL UNRESTR,PayPal fees,OFFICE/GENERAL ADMINISTRATIVE EXPENSES:PayPal Fees,PayPal Bank 3,$1.40,"$998,795.70"
PayPal Bank 3,09/22/2023,Deposit,78K308185U947333J,04 PAYPAL GENERAL UNRESTR,"Subject: GeneralPage
Transaction ID: 78K308185U947333J
https://www.paypal.com/activity/payment/78K308185U947333J",PayPal Bank 3,--,$20.00,"$998,815.70"
Donations directed by individuals,09/22/2023,Deposit,78K308185U947333J,04 PAYPAL GENERAL UNRESTR,Support Ukraine - Support Ukraine,Contributed income:Donations directed by individuals,PayPal Bank 3,$21.10,"$998,836.80"
PayPal Fees,09/22/2023,Deposit,78K308185U947333J,04 PAYPAL GENERAL UNRESTR,PayPal fees,OFFICE/GENERAL ADMINISTRATIVE EXPENSES:PayPal Fees,PayPal Bank 3,$1.10,"$998,837.90"
PayPal Bank 3,09/22/2023,Deposit,2SW46133K98458928,04 PAYPAL GENERAL UNRESTR,"Subject: GeneralPage
Transaction ID: 2SW46133K98458928
https://www.paypal.com/activity/payment/2SW46133K98458928",PayPal Bank 3,--,$4.91,"$998,842.81"
Donations directed by individuals,09/22/2023,Deposit,2SW46133K98458928,04 PAYPAL GENERAL UNRESTR,Support Ukraine - Support Ukraine,Contributed income:Donations directed by individuals,PayPal Bank 3,$5.65,"$998,848.46"
PayPal Fees,09/22/2023,Deposit,2SW46133K98458928,04 PAYPAL GENERAL UNRESTR,PayPal fees,OFFICE/GENERAL ADMINISTRATIVE EXPENSES:PayPal Fees,PayPal Bank 3,$0.74,"$998,849.20"
PayPal Bank 3,09/22/2023,Deposit,4AX40225XH000561L,04 PAYPAL GENERAL UNRESTR,"Subject: GeneralPage
Transaction ID: 4AX40225XH000561L
https://www.paypal.com/activity/payment/4AX40225XH000561L",PayPal Bank 3,--,$9.07,"$998,858.27"
Donations directed by individuals,09/22/2023,Deposit,4AX40225XH000561L,04 PAYPAL GENERAL UNRESTR,Support Ukraine - Support Ukraine,Contributed income:Donations directed by individuals,PayPal Bank 3,$10.00,"$998,868.27"
PayPal Fees,09/22/2023,Deposit,4AX40225XH000561L,04 PAYPAL GENERAL UNRESTR,PayPal fees,OFFICE/GENERAL ADMINISTRATIVE EXPENSES:PayPal Fees,PayPal Bank 3,$0.93,"$998,869.20"
PayPal Bank 3,09/22/2023,Deposit,6FD90403RL741741U,04 PAYPAL GENERAL UNRESTR,"Subject: GeneralPage
Transaction ID: 6FD90403RL741741U
https://www.paypal.com/activity/payment/6FD90403RL741741U",PayPal Bank 3,--,$100.00,"$998,969.20"
Donations directed by individuals,09/22/2023,Deposit,6FD90403RL741741U,04 PAYPAL GENERAL UNRESTR,Support Ukraine - Support Ukraine,Contributed income:Donations directed by individuals,PayPal Bank 3,$103.48,"$999,072.68"
PayPal Fees,09/22/2023,Deposit,6FD90403RL741741U,04 PAYPAL GENERAL UNRESTR,PayPal fees,OFFICE/GENERAL ADMINISTRATIVE EXPENSES:PayPal Fees,PayPal Bank 3,$3.48,"$999,076.16"
PayPal Bank 3,09/22/2023,Deposit,7AK5878893329071K,04 PAYPAL GENERAL UNRESTR,"Subject: GeneralPage
Transaction ID: 7AK5878893329071K
https://www.paypal.com/activity/payment/7AK5878893329071K",PayPal Bank 3,--,$9.84,"$999,086.00"
Donations directed by individuals,09/22/2023,Deposit,7AK5878893329071K,04 PAYPAL GENERAL UNRESTR,Support Ukraine - Support Ukraine,Contributed income:Donations directed by individuals,PayPal Bank 3,$10.80,"$999,096.80"
PayPal Fees,09/22/2023,Deposit,7AK5878893329071K,04 PAYPAL GENERAL UNRESTR,PayPal fees,OFFICE/GENERAL ADMINISTRATIVE EXPENSES:PayPal Fees,PayPal Bank 3,$0.96,"$999,097.76"
PayPal Bank 3,09/22/2023,Deposit,69E305135D2119318,04 PAYPAL GENERAL UNRESTR,"Subject: GeneralPage
Transaction ID: 69E305135D2119318
https://www.paypal.com/activity/payment/69E305135D2119318",PayPal Bank 3,--,$50.00,"$999,147.76"
Donations directed by individuals,09/22/2023,Deposit,69E305135D2119318,04 PAYPAL GENERAL UNRESTR,Support Ukraine - Support Ukraine,Contributed income:Donations directed by individuals,PayPal Bank 3,$51.99,"$999,199.75"
PayPal Fees,09/22/2023,Deposit,69E305135D2119318,04 PAYPAL GENERAL UNRESTR,PayPal fees,OFFICE/GENERAL ADMINISTRATIVE EXPENSES:PayPal Fees,PayPal Bank 3,$1.99,"$999,201.74"
PayPal Bank 3,09/22/2023,Deposit,9SX29258FK023532G,04 PAYPAL GENERAL UNRESTR,"Subject: GeneralPage
Transaction ID: 9SX29258FK023532G
https://www.paypal.com/activity/payment/9SX29258FK023532G",PayPal Bank 3,--,$47.31,"$999,249.05"
Donations directed by individuals,09/22/2023,Deposit,9SX29258FK023532G,04 PAYPAL GENERAL UNRESTR,Support Ukraine - Support Ukraine,Contributed income:Donations directed by individuals,PayPal Bank 3,$50.00,"$999,299.05"
PayPal Fees,09/22/2023,Deposit,9SX29258FK023532G,04 PAYPAL GENERAL UNRESTR,PayPal fees,OFFICE/GENERAL ADMINISTRATIVE EXPENSES:PayPal Fees,PayPal Bank 3,$2.69,"$999,301.74"
PayPal Bank 3,09/22/2023,Deposit,40W00283DK709843P,04 PAYPAL GENERAL UNRESTR,"Subject: GeneralPage
Transaction ID: 40W00283DK709843P
https://www.paypal.com/activity/payment/40W00283DK709843P",PayPal Bank 3,--,$9.84,"$999,311.58"
Donations directed by individuals,09/22/2023,Deposit,40W00283DK709843P,04 PAYPAL GENERAL UNRESTR,Support Ukraine - Support Ukraine,Contributed income:Donations directed by individuals,PayPal Bank 3,$10.80,"$999,322.38"
PayPal Fees,09/22/2023,Deposit,40W00283DK709843P,04 PAYPAL GENERAL UNRESTR,PayPal fees,OFFICE/GENERAL ADMINISTRATIVE EXPENSES:PayPal Fees,PayPal Bank 3,$0.96,"$999,323.34"
PayPal Bank 3,09/22/2023,Deposit,1H2489953B243751L,04 PAYPAL GENERAL UNRESTR,"Subject: GeneralPage
Transaction ID: 1H2489953B243751L
https://www.paypal.com/activity/payment/1H2489953B243751L",PayPal Bank 3,--,$47.31,"$999,370.65"
Donations directed by individuals,09/22/2023,Deposit,1H2489953B243751L,04 PAYPAL GENERAL UNRESTR,Support Ukraine - Support Ukraine,Contributed income:Donations directed by individuals,PayPal Bank 3,$50.00,"$999,420.65"
PayPal Fees,09/22/2023,Deposit,1H2489953B243751L,04 PAYPAL GENERAL UNRESTR,PayPal fees,OFFICE/GENERAL ADMINISTRATIVE EXPENSES:PayPal Fees,PayPal Bank 3,$2.69,"$999,423.34"
PayPal Bank 3,09/22/2023,Deposit,7H23632278885211C,04 PAYPAL GENERAL UNRESTR,"Subject: Support Ukraine
Transaction ID: 7H23632278885211C
https://www.paypal.com/activity/payment/7H23632278885211C",PayPal Bank 3,--,$98.45,"$999,521.79"
Donations directed by individuals,09/22/2023,Deposit,7H23632278885211C,04 PAYPAL GENERAL UNRESTR,Money in to PayPal,Contributed income:Donations directed by individuals,PayPal Bank 3,$103.48,"$999,625.27"
PayPal Fees,09/22/2023,Deposit,7H23632278885211C,04 PAYPAL GENERAL UNRESTR,PayPal fees,OFFICE/GENERAL ADMINISTRATIVE EXPENSES:PayPal Fees,PayPal Bank 3,$5.03,"$999,630.30"
PayPal Bank 3,09/22/2023,Deposit,3PH558264D524425J,04 PAYPAL GENERAL UNRESTR,"Subject: GeneralPage
Transaction ID: 3PH558264D524425J
https://www.paypal.com/activity/payment/3PH558264D524425J",PayPal Bank 3,--,"$3,000.00","$1,002,630.30"
Donations directed by individuals,09/22/2023,Deposit,3PH558264D524425J,04 PAYPAL GENERAL UNRESTR,Support Ukraine - Support Ukraine,Contributed income:Donations directed by individuals,PayPal Bank 3,"$3,089.78","$1,005,720.08"
PayPal Fees,09/22/2023,Deposit,3PH558264D524425J,04 PAYPAL GENERAL UNRESTR,PayPal fees,OFFICE/GENERAL ADMINISTRATIVE EXPENSES:PayPal Fees,PayPal Bank 3,$89.78,"$1,005,809.86"
PayPal Bank 3,09/22/2023,Deposit,5PU22237EU940383M,07 1000 DRONES RESTR,"Subject: GeneralPage
Note: I would love it if you used this money to get some FPV drones to blow up some invader scum.   Слава Україні!
Transaction ID: 5PU22237EU940383M
https://www.paypal.com/activity/payment/5PU22237EU940383M",PayPal Bank 3,--,$96.62,"$1,005,906.48"
Donations directed by individuals,09/22/2023,Deposit,5PU22237EU940383M,07 1000 DRONES RESTR,Support Ukraine - Support Ukraine,Contributed income:Donations directed by individuals,PayPal Bank 3,$100.00,"$1,006,006.48"
PayPal Fees,09/22/2023,Deposit,5PU22237EU940383M,07 1000 DRONES RESTR,PayPal fees,OFFICE/GENERAL ADMINISTRATIVE EXPENSES:PayPal Fees,PayPal Bank 3,$3.38,"$1,006,009.86"
PayPal Bank 3,09/22/2023,Deposit,1LU169853B0954527,04 PAYPAL GENERAL UNRESTR,"Subject: GeneralPage
Transaction ID: 1LU169853B0954527
https://www.paypal.com/activity/payment/1LU169853B0954527",PayPal Bank 3,--,$100.00,"$1,006,109.86"
Donations directed by individuals,09/22/2023,Deposit,1LU169853B0954527,04 PAYPAL GENERAL UNRESTR,Support Ukraine - Support Ukraine,Contributed income:Donations directed by individuals,PayPal Bank 3,$103.48,"$1,006,213.34"
PayPal Fees,09/22/2023,Deposit,1LU169853B0954527,04 PAYPAL GENERAL UNRESTR,PayPal fees,OFFICE/GENERAL ADMINISTRATIVE EXPENSES:PayPal Fees,PayPal Bank 3,$3.48,"$1,006,216.82"
PayPal Bank 3,09/22/2023,Deposit,8G955465MY182713W,08 VICTORY DRONES RESTR,"Subject: VICTORY DRONES
Transaction ID: 8G955465MY182713W
https://www.paypal.com/activity/payment/8G955465MY182713W",PayPal Bank 3,--,$100.00,"$1,006,316.82"
Donations directed by individuals,09/22/2023,Deposit,8G955465MY182713W,08 VICTORY DRONES RESTR,Money in to PayPal,Contributed income:Donations directed by individuals,PayPal Bank 3,$103.48,"$1,006,420.30"
PayPal Fees,09/22/2023,Deposit,8G955465MY182713W,08 VICTORY DRONES RESTR,PayPal fees,OFFICE/GENERAL ADMINISTRATIVE EXPENSES:PayPal Fees,PayPal Bank 3,$3.48,"$1,006,423.78"
PayPal Bank 3,09/22/2023,Deposit,878176043N743231T,04 PAYPAL GENERAL UNRESTR,"Subject: GeneralPage
Note: From Irish-Ukrainian community.   We wish you a strong wings� and no wind.
Transaction ID: 878176043N743231T
https://www.paypal.com/activity/payment/878176043N743231T",PayPal Bank 3,--,$47.31,"$1,006,471.09"
Donations directed by individuals,09/22/2023,Deposit,878176043N743231T,04 PAYPAL GENERAL UNRESTR,Support Ukraine - Support Ukraine,Contributed income:Donations directed by individuals,PayPal Bank 3,$50.00,"$1,006,521.09"
PayPal Fees,09/22/2023,Deposit,878176043N743231T,04 PAYPAL GENERAL UNRESTR,PayPal fees,OFFICE/GENERAL ADMINISTRATIVE EXPENSES:PayPal Fees,PayPal Bank 3,$2.69,"$1,006,523.78"
PayPal Bank 3,09/22/2023,Deposit,4LJ48094CX539084E,04 PAYPAL GENERAL UNRESTR,"Subject: GeneralPage
Transaction ID: 4LJ48094CX539084E
https://www.paypal.com/activity/payment/4LJ48094CX539084E",PayPal Bank 3,--,$23.41,"$1,006,547.19"
Donations directed by individuals,09/22/2023,Deposit,4LJ48094CX539084E,04 PAYPAL GENERAL UNRESTR,Support Ukraine - Support Ukraine,Contributed income:Donations directed by individuals,PayPal Bank 3,$25.00,"$1,006,572.19"
PayPal Fees,09/22/2023,Deposit,4LJ48094CX539084E,04 PAYPAL GENERAL UNRESTR,PayPal fees,OFFICE/GENERAL ADMINISTRATIVE EXPENSES:PayPal Fees,PayPal Bank 3,$1.59,"$1,006,573.78"
PayPal Bank 3,09/22/2023,Deposit,3R591967RC218180B,04 PAYPAL GENERAL UNRESTR,"Subject: GeneralPage
Transaction ID: 3R591967RC218180B
https://www.paypal.com/activity/payment/3R591967RC218180B",PayPal Bank 3,--,$29.53,"$1,006,603.31"
Donations directed by individuals,09/22/2023,Deposit,3R591967RC218180B,04 PAYPAL GENERAL UNRESTR,Support Ukraine - Support Ukraine,Contributed income:Donations directed by individuals,PayPal Bank 3,$31.40,"$1,006,634.71"
PayPal Fees,09/22/2023,Deposit,3R591967RC218180B,04 PAYPAL GENERAL UNRESTR,PayPal fees,OFFICE/GENERAL ADMINISTRATIVE EXPENSES:PayPal Fees,PayPal Bank 3,$1.87,"$1,006,636.58"
PayPal Bank 3,09/22/2023,Deposit,37397940NS1206827,04 PAYPAL GENERAL UNRESTR,"Subject: GeneralPage
Transaction ID: 37397940NS1206827
https://www.paypal.com/activity/payment/37397940NS1206827",PayPal Bank 3,--,$24.61,"$1,006,661.19"
Donations directed by individuals,09/22/2023,Deposit,37397940NS1206827,04 PAYPAL GENERAL UNRESTR,Support Ukraine - Support Ukraine,Contributed income:Donations directed by individuals,PayPal Bank 3,$26.25,"$1,006,687.44"
PayPal Fees,09/22/2023,Deposit,37397940NS1206827,04 PAYPAL GENERAL UNRESTR,PayPal fees,OFFICE/GENERAL ADMINISTRATIVE EXPENSES:PayPal Fees,PayPal Bank 3,$1.64,"$1,006,689.08"
PayPal Bank 3,09/22/2023,Deposit,28Y96140YU216931V,04 PAYPAL GENERAL UNRESTR,"Subject: GeneralPage
Transaction ID: 28Y96140YU216931V
https://www.paypal.com/activity/payment/28Y96140YU216931V",PayPal Bank 3,--,$96.62,"$1,006,785.70"
Donations directed by individuals,09/22/2023,Deposit,28Y96140YU216931V,04 PAYPAL GENERAL UNRESTR,Support Ukraine - Support Ukraine,Contributed income:Donations directed by individuals,PayPal Bank 3,$100.00,"$1,006,885.70"
PayPal Fees,09/22/2023,Deposit,28Y96140YU216931V,04 PAYPAL GENERAL UNRESTR,PayPal fees,OFFICE/GENERAL ADMINISTRATIVE EXPENSES:PayPal Fees,PayPal Bank 3,$3.38,"$1,006,889.08"
PayPal Bank 3,09/22/2023,Deposit,21277431SL5587828,04 PAYPAL GENERAL UNRESTR,"Subject: GeneralPage
Transaction ID: 21277431SL5587828
https://www.paypal.com/activity/payment/21277431SL5587828",PayPal Bank 3,--,$95.12,"$1,006,984.20"
Donations directed by individuals,09/22/2023,Deposit,21277431SL5587828,04 PAYPAL GENERAL UNRESTR,Support Ukraine - Support Ukraine,Contributed income:Donations directed by individuals,PayPal Bank 3,$100.00,"$1,007,084.20"
PayPal Fees,09/22/2023,Deposit,21277431SL5587828,04 PAYPAL GENERAL UNRESTR,PayPal fees,OFFICE/GENERAL ADMINISTRATIVE EXPENSES:PayPal Fees,PayPal Bank 3,$4.88,"$1,007,089.08"
PayPal Bank 3,09/22/2023,Deposit,9FN19697RH501904R,04 PAYPAL GENERAL UNRESTR,"Subject: GeneralPage
Transaction ID: 9FN19697RH501904R
https://www.paypal.com/activity/payment/9FN19697RH501904R",PayPal Bank 3,--,$196.91,"$1,007,285.99"
Donations directed by individuals,09/22/2023,Deposit,9FN19697RH501904R,04 PAYPAL GENERAL UNRESTR,Support Ukraine - Support Ukraine,Contributed income:Donations directed by individuals,PayPal Bank 3,$206.46,"$1,007,492.45"
PayPal Fees,09/22/2023,Deposit,9FN19697RH501904R,04 PAYPAL GENERAL UNRESTR,PayPal fees,OFFICE/GENERAL ADMINISTRATIVE EXPENSES:PayPal Fees,PayPal Bank 3,$9.55,"$1,007,502.00"
PayPal Bank 3,09/22/2023,Deposit,0L62167711864244F,04 PAYPAL GENERAL UNRESTR,"Subject: GeneralPage
Transaction ID: 0L62167711864244F
https://www.paypal.com/activity/payment/0L62167711864244F",PayPal Bank 3,--,$50.00,"$1,007,552.00"
Donations directed by individuals,09/22/2023,Deposit,0L62167711864244F,04 PAYPAL GENERAL UNRESTR,Support Ukraine - Support Ukraine,Contributed income:Donations directed by individuals,PayPal Bank 3,$51.99,"$1,007,603.99"
PayPal Fees,09/22/2023,Deposit,0L62167711864244F,04 PAYPAL GENERAL UNRESTR,PayPal fees,OFFICE/GENERAL ADMINISTRATIVE EXPENSES:PayPal Fees,PayPal Bank 3,$1.99,"$1,007,605.98"
PayPal Bank 3,09/22/2023,Deposit,5J214848LY769590F,04 PAYPAL GENERAL UNRESTR,"Subject: GeneralPage
Transaction ID: 5J214848LY769590F
https://www.paypal.com/activity/payment/5J214848LY769590F",PayPal Bank 3,--,$5.00,"$1,007,610.98"
Donations directed by individuals,09/22/2023,Deposit,5J214848LY769590F,04 PAYPAL GENERAL UNRESTR,Support Ukraine - Support Ukraine,Contributed income:Donations directed by individuals,PayPal Bank 3,$5.65,"$1,007,616.63"
PayPal Fees,09/22/2023,Deposit,5J214848LY769590F,04 PAYPAL GENERAL UNRESTR,PayPal fees,OFFICE/GENERAL ADMINISTRATIVE EXPENSES:PayPal Fees,PayPal Bank 3,$0.65,"$1,007,617.28"
PayPal Bank 3,09/22/2023,Deposit,7M233862X7039973T,04 PAYPAL GENERAL UNRESTR,"Subject: GeneralPage
Transaction ID: 7M233862X7039973T
https://www.paypal.com/activity/payment/7M233862X7039973T",PayPal Bank 3,--,$49.22,"$1,007,666.50"
Donations directed by individuals,09/22/2023,Deposit,7M233862X7039973T,04 PAYPAL GENERAL UNRESTR,Support Ukraine - Support Ukraine,Contributed income:Donations directed by individuals,PayPal Bank 3,$51.99,"$1,007,718.49"
PayPal Fees,09/22/2023,Deposit,7M233862X7039973T,04 PAYPAL GENERAL UNRESTR,PayPal fees,OFFICE/GENERAL ADMINISTRATIVE EXPENSES:PayPal Fees,PayPal Bank 3,$2.77,"$1,007,721.26"
PayPal Bank 3,09/22/2023,Deposit,6H562266HN050331J,04 PAYPAL GENERAL UNRESTR,"Subject: Support Ukraine
Transaction ID: 6H562266HN050331J
https://www.paypal.com/activity/payment/6H562266HN050331J",PayPal Bank 3,--,$50.00,"$1,007,771.26"
Donations directed by individuals,09/22/2023,Deposit,6H562266HN050331J,04 PAYPAL GENERAL UNRESTR,Money in to PayPal,Contributed income:Donations directed by individuals,PayPal Bank 3,$51.99,"$1,007,823.25"
PayPal Fees,09/22/2023,Deposit,6H562266HN050331J,04 PAYPAL GENERAL UNRESTR,PayPal fees,OFFICE/GENERAL ADMINISTRATIVE EXPENSES:PayPal Fees,PayPal Bank 3,$1.99,"$1,007,825.24"
PayPal Bank 3,09/22/2023,Deposit,66H31562UM112750F,04 PAYPAL GENERAL UNRESTR,"Subject: GeneralPage
Transaction ID: 66H31562UM112750F
https://www.paypal.com/activity/payment/66H31562UM112750F",PayPal Bank 3,--,$48.06,"$1,007,873.30"
Donations directed by individuals,09/22/2023,Deposit,66H31562UM112750F,04 PAYPAL GENERAL UNRESTR,Support Ukraine - Support Ukraine,Contributed income:Donations directed by individuals,PayPal Bank 3,$50.00,"$1,007,923.30"
PayPal Fees,09/22/2023,Deposit,66H31562UM112750F,04 PAYPAL GENERAL UNRESTR,PayPal fees,OFFICE/GENERAL ADMINISTRATIVE EXPENSES:PayPal Fees,PayPal Bank 3,$1.94,"$1,007,925.24"
PayPal Bank 3,09/22/2023,Deposit,4E525025X5615140L,04 PAYPAL GENERAL UNRESTR,"Subject: GeneralPage
Transaction ID: 4E525025X5615140L
https://www.paypal.com/activity/payment/4E525025X5615140L",PayPal Bank 3,--,$193.73,"$1,008,118.97"
Donations directed by individuals,09/22/2023,Deposit,4E525025X5615140L,04 PAYPAL GENERAL UNRESTR,Support Ukraine - Support Ukraine,Contributed income:Donations directed by individuals,PayPal Bank 3,$200.00,"$1,008,318.97"
PayPal Fees,09/22/2023,Deposit,4E525025X5615140L,04 PAYPAL GENERAL UNRESTR,PayPal fees,OFFICE/GENERAL ADMINISTRATIVE EXPENSES:PayPal Fees,PayPal Bank 3,$6.27,"$1,008,325.24"
PayPal Bank 3,09/22/2023,Deposit,1AB82628AB082022B,04 PAYPAL GENERAL UNRESTR,"Subject: GeneralPage
Transaction ID: 1AB82628AB082022B
https://www.paypal.com/activity/payment/1AB82628AB082022B",PayPal Bank 3,--,$30.00,"$1,008,355.24"
Donations directed by individuals,09/22/2023,Deposit,1AB82628AB082022B,04 PAYPAL GENERAL UNRESTR,Support Ukraine - Support Ukraine,Contributed income:Donations directed by individuals,PayPal Bank 3,$31.40,"$1,008,386.64"
PayPal Fees,09/22/2023,Deposit,1AB82628AB082022B,04 PAYPAL GENERAL UNRESTR,PayPal fees,OFFICE/GENERAL ADMINISTRATIVE EXPENSES:PayPal Fees,PayPal Bank 3,$1.40,"$1,008,388.04"
PayPal Bank 3,09/22/2023,Deposit,7XE23069JM211505J,04 PAYPAL GENERAL UNRESTR,"Subject: GeneralPage
Transaction ID: 7XE23069JM211505J
https://www.paypal.com/activity/payment/7XE23069JM211505J",PayPal Bank 3,--,$200.00,"$1,008,588.04"
Donations directed by individuals,09/22/2023,Deposit,7XE23069JM211505J,04 PAYPAL GENERAL UNRESTR,Support Ukraine - Support Ukraine,Contributed income:Donations directed by individuals,PayPal Bank 3,$206.46,"$1,008,794.50"
PayPal Fees,09/22/2023,Deposit,7XE23069JM211505J,04 PAYPAL GENERAL UNRESTR,PayPal fees,OFFICE/GENERAL ADMINISTRATIVE EXPENSES:PayPal Fees,PayPal Bank 3,$6.46,"$1,008,800.96"
PayPal Bank 3,09/22/2023,Deposit,14J35462YK434063W,04 PAYPAL GENERAL UNRESTR,"Subject: GeneralPage
Note: Vitaliy
Transaction ID: 14J35462YK434063W
https://www.paypal.com/activity/payment/14J35462YK434063W",PayPal Bank 3,--,$100.00,"$1,008,900.96"
Donations directed by individuals,09/22/2023,Deposit,14J35462YK434063W,04 PAYPAL GENERAL UNRESTR,Support Ukraine - Support Ukraine,Contributed income:Donations directed by individuals,PayPal Bank 3,$103.48,"$1,009,004.44"
PayPal Fees,09/22/2023,Deposit,14J35462YK434063W,04 PAYPAL GENERAL UNRESTR,PayPal fees,OFFICE/GENERAL ADMINISTRATIVE EXPENSES:PayPal Fees,PayPal Bank 3,$3.48,"$1,009,007.92"
PayPal Bank 3,09/22/2023,Deposit,50Y61405WN8906705,07 1000 DRONES RESTR,"Subject: 1000DRONES
Transaction ID: 50Y61405WN8906705
https://www.paypal.com/activity/payment/50Y61405WN8906705",PayPal Bank 3,--,$100.00,"$1,009,107.92"
Donations directed by individuals,09/22/2023,Deposit,50Y61405WN8906705,07 1000 DRONES RESTR,1000 DRONES FOR UKRAINE - 1000 DRONES FOR UKRAINE,Contributed income:Donations directed by individuals,PayPal Bank 3,$103.48,"$1,009,211.40"
PayPal Fees,09/22/2023,Deposit,50Y61405WN8906705,07 1000 DRONES RESTR,PayPal fees,OFFICE/GENERAL ADMINISTRATIVE EXPENSES:PayPal Fees,PayPal Bank 3,$3.48,"$1,009,214.88"
PayPal Bank 3,09/22/2023,Deposit,98H38823LS3705240,07 1000 DRONES RESTR,"Subject: 1000DRONES
Transaction ID: 98H38823LS3705240
https://www.paypal.com/activity/payment/98H38823LS3705240",PayPal Bank 3,--,$100.00,"$1,009,314.88"
Donations directed by individuals,09/22/2023,Deposit,98H38823LS3705240,07 1000 DRONES RESTR,1000 DRONES FOR UKRAINE - 1000 DRONES FOR UKRAINE,Contributed income:Donations directed by individuals,PayPal Bank 3,$103.48,"$1,009,418.36"
PayPal Fees,09/22/2023,Deposit,98H38823LS3705240,07 1000 DRONES RESTR,PayPal fees,OFFICE/GENERAL ADMINISTRATIVE EXPENSES:PayPal Fees,PayPal Bank 3,$3.48,"$1,009,421.84"
PayPal Bank 3,09/22/2023,Deposit,8E205330FP784305N,04 PAYPAL GENERAL UNRESTR,"Subject: GeneralPage
Transaction ID: 8E205330FP784305N
https://www.paypal.com/activity/payment/8E205330FP784305N",PayPal Bank 3,--,$95.12,"$1,009,516.96"
Donations directed by individuals,09/22/2023,Deposit,8E205330FP784305N,04 PAYPAL GENERAL UNRESTR,Support Ukraine - Support Ukraine,Contributed income:Donations directed by individuals,PayPal Bank 3,$100.00,"$1,009,616.96"
PayPal Fees,09/22/2023,Deposit,8E205330FP784305N,04 PAYPAL GENERAL UNRESTR,PayPal fees,OFFICE/GENERAL ADMINISTRATIVE EXPENSES:PayPal Fees,PayPal Bank 3,$4.88,"$1,009,621.84"
PayPal Bank 3,09/22/2023,Deposit,3LG961275Y791741P,04 PAYPAL GENERAL UNRESTR,"Subject: GeneralPage
Note: Смерть москалям!!!!
Transaction ID: 3LG961275Y791741P
https://www.paypal.com/activity/payment/3LG961275Y791741P",PayPal Bank 3,--,$295.36,"$1,009,917.20"
Donations directed by individuals,09/22/2023,Deposit,3LG961275Y791741P,04 PAYPAL GENERAL UNRESTR,Support Ukraine - Support Ukraine,Contributed income:Donations directed by individuals,PayPal Bank 3,$309.43,"$1,010,226.63"
PayPal Fees,09/22/2023,Deposit,3LG961275Y791741P,04 PAYPAL GENERAL UNRESTR,PayPal fees,OFFICE/GENERAL ADMINISTRATIVE EXPENSES:PayPal Fees,PayPal Bank 3,$14.07,"$1,010,240.70"
PayPal Bank 3,09/22/2023,Deposit,9SG78993R64490944,04 PAYPAL GENERAL UNRESTR,"Subject: GeneralPage
Transaction ID: 9SG78993R64490944
https://www.paypal.com/activity/payment/9SG78993R64490944",PayPal Bank 3,--,$49.22,"$1,010,289.92"
Donations directed by individuals,09/22/2023,Deposit,9SG78993R64490944,04 PAYPAL GENERAL UNRESTR,Support Ukraine - Support Ukraine,Contributed income:Donations directed by individuals,PayPal Bank 3,$51.99,"$1,010,341.91"
PayPal Fees,09/22/2023,Deposit,9SG78993R64490944,04 PAYPAL GENERAL UNRESTR,PayPal fees,OFFICE/GENERAL ADMINISTRATIVE EXPENSES:PayPal Fees,PayPal Bank 3,$2.77,"$1,010,344.68"
PayPal Bank 3,09/22/2023,Deposit,1GA5606334348872N,04 PAYPAL GENERAL UNRESTR,"Subject: Support Ukraine
Transaction ID: 1GA5606334348872N
https://www.paypal.com/activity/payment/1GA5606334348872N",PayPal Bank 3,--,$4.91,"$1,010,349.59"
Donations directed by individuals,09/22/2023,Deposit,1GA5606334348872N,04 PAYPAL GENERAL UNRESTR,Money in to PayPal,Contributed income:Donations directed by individuals,PayPal Bank 3,$5.65,"$1,010,355.24"
PayPal Fees,09/22/2023,Deposit,1GA5606334348872N,04 PAYPAL GENERAL UNRESTR,PayPal fees,OFFICE/GENERAL ADMINISTRATIVE EXPENSES:PayPal Fees,PayPal Bank 3,$0.74,"$1,010,355.98"
PayPal Bank 3,09/22/2023,Deposit,9L340536SN9971332,04 PAYPAL GENERAL UNRESTR,"Subject: Support Ukraine
Transaction ID: 9L340536SN9971332
https://www.paypal.com/activity/payment/9L340536SN9971332",PayPal Bank 3,--,$9.84,"$1,010,365.82"
Donations directed by individuals,09/22/2023,Deposit,9L340536SN9971332,04 PAYPAL GENERAL UNRESTR,Money in to PayPal,Contributed income:Donations directed by individuals,PayPal Bank 3,$10.80,"$1,010,376.62"
PayPal Fees,09/22/2023,Deposit,9L340536SN9971332,04 PAYPAL GENERAL UNRESTR,PayPal fees,OFFICE/GENERAL ADMINISTRATIVE EXPENSES:PayPal Fees,PayPal Bank 3,$0.96,"$1,010,377.58"
PayPal Bank 3,09/22/2023,Deposit,8C2769025A9199146,04 PAYPAL GENERAL UNRESTR,"Subject: Support Ukraine
Transaction ID: 8C2769025A9199146
https://www.paypal.com/activity/payment/8C2769025A9199146",PayPal Bank 3,--,$24.61,"$1,010,402.19"
Donations directed by individuals,09/22/2023,Deposit,8C2769025A9199146,04 PAYPAL GENERAL UNRESTR,Money in to PayPal,Contributed income:Donations directed by individuals,PayPal Bank 3,$26.25,"$1,010,428.44"
PayPal Fees,09/22/2023,Deposit,8C2769025A9199146,04 PAYPAL GENERAL UNRESTR,PayPal fees,OFFICE/GENERAL ADMINISTRATIVE EXPENSES:PayPal Fees,PayPal Bank 3,$1.64,"$1,010,430.08"
PayPal Bank 3,09/22/2023,Deposit,4PJ094060Y084452W,08 VICTORY DRONES RESTR,"Subject: GeneralPage
Note: for Victory Drones
Transaction ID: 4PJ094060Y084452W
https://www.paypal.com/activity/payment/4PJ094060Y084452W",PayPal Bank 3,--,$98.45,"$1,010,528.53"
Donations directed by individuals,09/22/2023,Deposit,4PJ094060Y084452W,08 VICTORY DRONES RESTR,Support Ukraine - Support Ukraine,Contributed income:Donations directed by individuals,PayPal Bank 3,$103.48,"$1,010,632.01"
PayPal Fees,09/22/2023,Deposit,4PJ094060Y084452W,08 VICTORY DRONES RESTR,PayPal fees,OFFICE/GENERAL ADMINISTRATIVE EXPENSES:PayPal Fees,PayPal Bank 3,$5.03,"$1,010,637.04"
PayPal Bank 3,09/22/2023,Deposit,5CE82164C4881571H,04 PAYPAL GENERAL UNRESTR,"Subject: GeneralPage
Transaction ID: 5CE82164C4881571H
https://www.paypal.com/activity/payment/5CE82164C4881571H",PayPal Bank 3,--,$30.00,"$1,010,667.04"
Donations directed by individuals,09/22/2023,Deposit,5CE82164C4881571H,04 PAYPAL GENERAL UNRESTR,Support Ukraine - Support Ukraine,Contributed income:Donations directed by individuals,PayPal Bank 3,$31.40,"$1,010,698.44"
PayPal Fees,09/22/2023,Deposit,5CE82164C4881571H,04 PAYPAL GENERAL UNRESTR,PayPal fees,OFFICE/GENERAL ADMINISTRATIVE EXPENSES:PayPal Fees,PayPal Bank 3,$1.40,"$1,010,699.84"
PayPal Bank 3,09/22/2023,Deposit,30R686793E5331422,04 PAYPAL GENERAL UNRESTR,"Subject: GeneralPage
Transaction ID: 30R686793E5331422
https://www.paypal.com/activity/payment/30R686793E5331422",PayPal Bank 3,--,$50.00,"$1,010,749.84"
Donations directed by individuals,09/22/2023,Deposit,30R686793E5331422,04 PAYPAL GENERAL UNRESTR,Support Ukraine - Support Ukraine,Contributed income:Donations directed by individuals,PayPal Bank 3,$51.99,"$1,010,801.83"
PayPal Fees,09/22/2023,Deposit,30R686793E5331422,04 PAYPAL GENERAL UNRESTR,PayPal fees,OFFICE/GENERAL ADMINISTRATIVE EXPENSES:PayPal Fees,PayPal Bank 3,$1.99,"$1,010,803.82"
PayPal Bank 3,09/22/2023,Deposit,23968221CG564425G,04 PAYPAL GENERAL UNRESTR,"Subject: GeneralPage
Transaction ID: 23968221CG564425G
https://www.paypal.com/activity/payment/23968221CG564425G",PayPal Bank 3,--,$98.45,"$1,010,902.27"
Donations directed by individuals,09/22/2023,Deposit,23968221CG564425G,04 PAYPAL GENERAL UNRESTR,Support Ukraine - Support Ukraine,Contributed income:Donations directed by individuals,PayPal Bank 3,$103.48,"$1,011,005.75"
PayPal Fees,09/22/2023,Deposit,23968221CG564425G,04 PAYPAL GENERAL UNRESTR,PayPal fees,OFFICE/GENERAL ADMINISTRATIVE EXPENSES:PayPal Fees,PayPal Bank 3,$5.03,"$1,011,010.78"
PayPal Bank 3,09/22/2023,Deposit,0FG37798XE521013L,04 PAYPAL GENERAL UNRESTR,"Subject: GeneralPage
Transaction ID: 0FG37798XE521013L
https://www.paypal.com/activity/payment/0FG37798XE521013L",PayPal Bank 3,--,$29.53,"$1,011,040.31"
Donations directed by individuals,09/22/2023,Deposit,0FG37798XE521013L,04 PAYPAL GENERAL UNRESTR,Support Ukraine - Support Ukraine,Contributed income:Donations directed by individuals,PayPal Bank 3,$31.40,"$1,011,071.71"
PayPal Fees,09/22/2023,Deposit,0FG37798XE521013L,04 PAYPAL GENERAL UNRESTR,PayPal fees,OFFICE/GENERAL ADMINISTRATIVE EXPENSES:PayPal Fees,PayPal Bank 3,$1.87,"$1,011,073.58"
PayPal Bank 3,09/22/2023,Deposit,17503417UU580431Y,04 PAYPAL GENERAL UNRESTR,"Subject: GeneralPage
Transaction ID: 17503417UU580431Y
https://www.paypal.com/activity/payment/17503417UU580431Y",PayPal Bank 3,--,$10.00,"$1,011,083.58"
Donations directed by individuals,09/22/2023,Deposit,17503417UU580431Y,04 PAYPAL GENERAL UNRESTR,Support Ukraine - Support Ukraine,Contributed income:Donations directed by individuals,PayPal Bank 3,$10.80,"$1,011,094.38"
PayPal Fees,09/22/2023,Deposit,17503417UU580431Y,04 PAYPAL GENERAL UNRESTR,PayPal fees,OFFICE/GENERAL ADMINISTRATIVE EXPENSES:PayPal Fees,PayPal Bank 3,$0.80,"$1,011,095.18"
PayPal Bank 3,09/22/2023,Deposit,1BA64015D04591041,08 VICTORY DRONES RESTR,"Subject: VictoryDrones
Transaction ID: 1BA64015D04591041
https://www.paypal.com/activity/payment/1BA64015D04591041",PayPal Bank 3,--,$9.84,"$1,011,105.02"
Donations directed by individuals,09/22/2023,Deposit,1BA64015D04591041,08 VICTORY DRONES RESTR,VICTORY DRONES - VICTORY DRONES,Contributed income:Donations directed by individuals,PayPal Bank 3,$10.80,"$1,011,115.82"
PayPal Fees,09/22/2023,Deposit,1BA64015D04591041,08 VICTORY DRONES RESTR,PayPal fees,OFFICE/GENERAL ADMINISTRATIVE EXPENSES:PayPal Fees,PayPal Bank 3,$0.96,"$1,011,116.78"
PayPal Bank 3,09/22/2023,Deposit,3H9365522C553842C,04 PAYPAL GENERAL UNRESTR,"Subject: GeneralPage
Transaction ID: 3H9365522C553842C
https://www.paypal.com/activity/payment/3H9365522C553842C",PayPal Bank 3,--,$98.45,"$1,011,215.23"
Donations directed by individuals,09/22/2023,Deposit,3H9365522C553842C,04 PAYPAL GENERAL UNRESTR,Support Ukraine - Support Ukraine,Contributed income:Donations directed by individuals,PayPal Bank 3,$103.48,"$1,011,318.71"
PayPal Fees,09/22/2023,Deposit,3H9365522C553842C,04 PAYPAL GENERAL UNRESTR,PayPal fees,OFFICE/GENERAL ADMINISTRATIVE EXPENSES:PayPal Fees,PayPal Bank 3,$5.03,"$1,011,323.74"
PayPal Bank 3,09/22/2023,Deposit,2SC24493GE657405E,04 PAYPAL GENERAL UNRESTR,"Subject: GeneralPage
Transaction ID: 2SC24493GE657405E
https://www.paypal.com/activity/payment/2SC24493GE657405E",PayPal Bank 3,--,$100.00,"$1,011,423.74"
Donations directed by individuals,09/22/2023,Deposit,2SC24493GE657405E,04 PAYPAL GENERAL UNRESTR,Support Ukraine - Support Ukraine,Contributed income:Donations directed by individuals,PayPal Bank 3,$103.48,"$1,011,527.22"
PayPal Fees,09/22/2023,Deposit,2SC24493GE657405E,04 PAYPAL GENERAL UNRESTR,PayPal fees,OFFICE/GENERAL ADMINISTRATIVE EXPENSES:PayPal Fees,PayPal Bank 3,$3.48,"$1,011,530.70"
PayPal Bank 3,09/22/2023,Deposit,7JM22124K5066620P,04 PAYPAL GENERAL UNRESTR,"Subject: GeneralPage
Transaction ID: 7JM22124K5066620P
https://www.paypal.com/activity/payment/7JM22124K5066620P",PayPal Bank 3,--,$286.34,"$1,011,817.04"
Donations directed by individuals,09/22/2023,Deposit,7JM22124K5066620P,04 PAYPAL GENERAL UNRESTR,Support Ukraine - Support Ukraine,Contributed income:Donations directed by individuals,PayPal Bank 3,$300.00,"$1,012,117.04"
PayPal Fees,09/22/2023,Deposit,7JM22124K5066620P,04 PAYPAL GENERAL UNRESTR,PayPal fees,OFFICE/GENERAL ADMINISTRATIVE EXPENSES:PayPal Fees,PayPal Bank 3,$13.66,"$1,012,130.70"
PayPal Bank 3,09/22/2023,Deposit,6T7428284U7260609,04 PAYPAL GENERAL UNRESTR,"Subject: GeneralPage
Transaction ID: 6T7428284U7260609
https://www.paypal.com/activity/payment/6T7428284U7260609",PayPal Bank 3,--,$142.92,"$1,012,273.62"
Donations directed by individuals,09/22/2023,Deposit,6T7428284U7260609,04 PAYPAL GENERAL UNRESTR,Support Ukraine - Support Ukraine,Contributed income:Donations directed by individuals,PayPal Bank 3,$150.00,"$1,012,423.62"
PayPal Fees,09/22/2023,Deposit,6T7428284U7260609,04 PAYPAL GENERAL UNRESTR,PayPal fees,OFFICE/GENERAL ADMINISTRATIVE EXPENSES:PayPal Fees,PayPal Bank 3,$7.08,"$1,012,430.70"
PayPal Bank 3,09/22/2023,Deposit,78F988039V923024L,04 PAYPAL GENERAL UNRESTR,"Subject: Support Ukraine
Transaction ID: 78F988039V923024L
https://www.paypal.com/activity/payment/78F988039V923024L",PayPal Bank 3,--,$98.45,"$1,012,529.15"
Donations directed by individuals,09/22/2023,Deposit,78F988039V923024L,04 PAYPAL GENERAL UNRESTR,Money in to PayPal,Contributed income:Donations directed by individuals,PayPal Bank 3,$103.48,"$1,012,632.63"
PayPal Fees,09/22/2023,Deposit,78F988039V923024L,04 PAYPAL GENERAL UNRESTR,PayPal fees,OFFICE/GENERAL ADMINISTRATIVE EXPENSES:PayPal Fees,PayPal Bank 3,$5.03,"$1,012,637.66"
PayPal Bank 3,09/22/2023,Deposit,5AK1297008993505N,04 PAYPAL GENERAL UNRESTR,"Subject: GeneralPage
Transaction ID: 5AK1297008993505N
https://www.paypal.com/activity/payment/5AK1297008993505N",PayPal Bank 3,--,$9.84,"$1,012,647.50"
Donations directed by individuals,09/22/2023,Deposit,5AK1297008993505N,04 PAYPAL GENERAL UNRESTR,Support Ukraine - Support Ukraine,Contributed income:Donations directed by individuals,PayPal Bank 3,$10.80,"$1,012,658.30"
PayPal Fees,09/22/2023,Deposit,5AK1297008993505N,04 PAYPAL GENERAL UNRESTR,PayPal fees,OFFICE/GENERAL ADMINISTRATIVE EXPENSES:PayPal Fees,PayPal Bank 3,$0.96,"$1,012,659.26"
PayPal Bank 3,09/22/2023,Deposit,1B109205UM345364X,08 VICTORY DRONES RESTR,"Subject: VictoryDrones
Transaction ID: 1B109205UM345364X
https://www.paypal.com/activity/payment/1B109205UM345364X",PayPal Bank 3,--,$56.88,"$1,012,716.14"
Donations directed by individuals,09/22/2023,Deposit,1B109205UM345364X,08 VICTORY DRONES RESTR,VICTORY DRONES - VICTORY DRONES,Contributed income:Donations directed by individuals,PayPal Bank 3,$60.00,"$1,012,776.14"
PayPal Fees,09/22/2023,Deposit,1B109205UM345364X,08 VICTORY DRONES RESTR,PayPal fees,OFFICE/GENERAL ADMINISTRATIVE EXPENSES:PayPal Fees,PayPal Bank 3,$3.12,"$1,012,779.26"
PayPal Bank 3,09/22/2023,Deposit,7AL13861MY527053A,04 PAYPAL GENERAL UNRESTR,"Subject: GeneralPage
Transaction ID: 7AL13861MY527053A
https://www.paypal.com/activity/payment/7AL13861MY527053A",PayPal Bank 3,--,$96.62,"$1,012,875.88"
Donations directed by individuals,09/22/2023,Deposit,7AL13861MY527053A,04 PAYPAL GENERAL UNRESTR,Support Ukraine - Support Ukraine,Contributed income:Donations directed by individuals,PayPal Bank 3,$100.00,"$1,012,975.88"
PayPal Fees,09/22/2023,Deposit,7AL13861MY527053A,04 PAYPAL GENERAL UNRESTR,PayPal fees,OFFICE/GENERAL ADMINISTRATIVE EXPENSES:PayPal Fees,PayPal Bank 3,$3.38,"$1,012,979.26"
PayPal Bank 3,09/22/2023,Deposit,2SG73606LG8917353,04 PAYPAL GENERAL UNRESTR,"Subject: GeneralPage
Transaction ID: 2SG73606LG8917353
https://www.paypal.com/activity/payment/2SG73606LG8917353",PayPal Bank 3,--,$290.84,"$1,013,270.10"
Donations directed by individuals,09/22/2023,Deposit,2SG73606LG8917353,04 PAYPAL GENERAL UNRESTR,Support Ukraine - Support Ukraine,Contributed income:Donations directed by individuals,PayPal Bank 3,$300.00,"$1,013,570.10"
PayPal Fees,09/22/2023,Deposit,2SG73606LG8917353,04 PAYPAL GENERAL UNRESTR,PayPal fees,OFFICE/GENERAL ADMINISTRATIVE EXPENSES:PayPal Fees,PayPal Bank 3,$9.16,"$1,013,579.26"
PayPal Bank 3,09/22/2023,Deposit,3N7059264J4720016,08 VICTORY DRONES RESTR,"Subject: VictoryDrones
Transaction ID: 3N7059264J4720016
https://www.paypal.com/activity/payment/3N7059264J4720016",PayPal Bank 3,--,$9.84,"$1,013,589.10"
Donations directed by individuals,09/22/2023,Deposit,3N7059264J4720016,08 VICTORY DRONES RESTR,VICTORY DRONES - VICTORY DRONES,Contributed income:Donations directed by individuals,PayPal Bank 3,$10.80,"$1,013,599.90"
PayPal Fees,09/22/2023,Deposit,3N7059264J4720016,08 VICTORY DRONES RESTR,PayPal fees,OFFICE/GENERAL ADMINISTRATIVE EXPENSES:PayPal Fees,PayPal Bank 3,$0.96,"$1,013,600.86"
PayPal Bank 3,09/22/2023,Deposit,8T328532E6848610T,08 VICTORY DRONES RESTR,"Subject: VictoryDrones
Transaction ID: 8T328532E6848610T
https://www.paypal.com/activity/payment/8T328532E6848610T",PayPal Bank 3,--,$59.07,"$1,013,659.93"
Donations directed by individuals,09/22/2023,Deposit,8T328532E6848610T,08 VICTORY DRONES RESTR,VICTORY DRONES - VICTORY DRONES,Contributed income:Donations directed by individuals,PayPal Bank 3,$62.29,"$1,013,722.22"
PayPal Fees,09/22/2023,Deposit,8T328532E6848610T,08 VICTORY DRONES RESTR,PayPal fees,OFFICE/GENERAL ADMINISTRATIVE EXPENSES:PayPal Fees,PayPal Bank 3,$3.22,"$1,013,725.44"
PayPal Bank 3,09/22/2023,Deposit,84740723FP593710A,09 MSU RESTR,"Subject: MobileShowers
Transaction ID: 84740723FP593710A
https://www.paypal.com/activity/payment/84740723FP593710A",PayPal Bank 3,--,$28.19,"$1,013,753.63"
Donations directed by individuals,09/22/2023,Deposit,84740723FP593710A,09 MSU RESTR,Mobile Shower/Laundry Units - Mobile Shower/Laundry Units,Contributed income:Donations directed by individuals,PayPal Bank 3,$30.00,"$1,013,783.63"
PayPal Fees,09/22/2023,Deposit,84740723FP593710A,09 MSU RESTR,PayPal fees,OFFICE/GENERAL ADMINISTRATIVE EXPENSES:PayPal Fees,PayPal Bank 3,$1.81,"$1,013,785.44"
PayPal Bank 3,09/22/2023,Deposit,3EC6082698323264L,09 MSU RESTR,"Subject: MobileShowers
Transaction ID: 3EC6082698323264L
https://www.paypal.com/activity/payment/3EC6082698323264L",PayPal Bank 3,--,$295.36,"$1,014,080.80"
Donations directed by individuals,09/22/2023,Deposit,3EC6082698323264L,09 MSU RESTR,Mobile Shower/Laundry Units - Mobile Shower/Laundry Units,Contributed income:Donations directed by individuals,PayPal Bank 3,$309.43,"$1,014,390.23"
PayPal Fees,09/22/2023,Deposit,3EC6082698323264L,09 MSU RESTR,PayPal fees,OFFICE/GENERAL ADMINISTRATIVE EXPENSES:PayPal Fees,PayPal Bank 3,$14.07,"$1,014,404.30"
PayPal Bank 3,09/22/2023,Deposit,5128540375715382H,04 PAYPAL GENERAL UNRESTR,"Subject: GeneralPage
Transaction ID: 5128540375715382H
https://www.paypal.com/activity/payment/5128540375715382H",PayPal Bank 3,--,$49.22,"$1,014,453.52"
Donations directed by individuals,09/22/2023,Deposit,5128540375715382H,04 PAYPAL GENERAL UNRESTR,Support Ukraine - Support Ukraine,Contributed income:Donations directed by individuals,PayPal Bank 3,$51.99,"$1,014,505.51"
PayPal Fees,09/22/2023,Deposit,5128540375715382H,04 PAYPAL GENERAL UNRESTR,PayPal fees,OFFICE/GENERAL ADMINISTRATIVE EXPENSES:PayPal Fees,PayPal Bank 3,$2.77,"$1,014,508.28"
PayPal Bank 3,09/22/2023,Deposit,3HK125449Y377050N,04 PAYPAL GENERAL UNRESTR,"Subject: GeneralPage
Note: Spaghetti Kozak told me about you!
Transaction ID: 3HK125449Y377050N
https://www.paypal.com/activity/payment/3HK125449Y377050N",PayPal Bank 3,--,$96.62,"$1,014,604.90"
Donations directed by individuals,09/22/2023,Deposit,3HK125449Y377050N,04 PAYPAL GENERAL UNRESTR,Support Ukraine - Support Ukraine,Contributed income:Donations directed by individuals,PayPal Bank 3,$100.00,"$1,014,704.90"
PayPal Fees,09/22/2023,Deposit,3HK125449Y377050N,04 PAYPAL GENERAL UNRESTR,PayPal fees,OFFICE/GENERAL ADMINISTRATIVE EXPENSES:PayPal Fees,PayPal Bank 3,$3.38,"$1,014,708.28"
PayPal Bank 3,09/22/2023,Deposit,8BN79570002139722,04 PAYPAL GENERAL UNRESTR,"Subject: GeneralPage
Transaction ID: 8BN79570002139722
https://www.paypal.com/activity/payment/8BN79570002139722",PayPal Bank 3,--,$196.91,"$1,014,905.19"
Donations directed by individuals,09/22/2023,Deposit,8BN79570002139722,04 PAYPAL GENERAL UNRESTR,Support Ukraine - Support Ukraine,Contributed income:Donations directed by individuals,PayPal Bank 3,$206.46,"$1,015,111.65"
PayPal Fees,09/22/2023,Deposit,8BN79570002139722,04 PAYPAL GENERAL UNRESTR,PayPal fees,OFFICE/GENERAL ADMINISTRATIVE EXPENSES:PayPal Fees,PayPal Bank 3,$9.55,"$1,015,121.20"
PayPal Bank 3,09/22/2023,Deposit,2XJ95803HB276273U,04 PAYPAL GENERAL UNRESTR,"Subject: GeneralPage
Transaction ID: 2XJ95803HB276273U
https://www.paypal.com/activity/payment/2XJ95803HB276273U",PayPal Bank 3,--,$5.90,"$1,015,127.10"
Donations directed by individuals,09/22/2023,Deposit,2XJ95803HB276273U,04 PAYPAL GENERAL UNRESTR,Support Ukraine - Support Ukraine,Contributed income:Donations directed by individuals,PayPal Bank 3,$6.68,"$1,015,133.78"
PayPal Fees,09/22/2023,Deposit,2XJ95803HB276273U,04 PAYPAL GENERAL UNRESTR,PayPal fees,OFFICE/GENERAL ADMINISTRATIVE EXPENSES:PayPal Fees,PayPal Bank 3,$0.78,"$1,015,134.56"
PayPal Bank 3,09/22/2023,Deposit,04E26444G5952162J,04 PAYPAL GENERAL UNRESTR,"Subject: GeneralPage
Transaction ID: 04E26444G5952162J
https://www.paypal.com/activity/payment/04E26444G5952162J",PayPal Bank 3,--,$196.91,"$1,015,331.47"
Donations directed by individuals,09/22/2023,Deposit,04E26444G5952162J,04 PAYPAL GENERAL UNRESTR,Support Ukraine - Support Ukraine,Contributed income:Donations directed by individuals,PayPal Bank 3,$206.46,"$1,015,537.93"
PayPal Fees,09/22/2023,Deposit,04E26444G5952162J,04 PAYPAL GENERAL UNRESTR,PayPal fees,OFFICE/GENERAL ADMINISTRATIVE EXPENSES:PayPal Fees,PayPal Bank 3,$9.55,"$1,015,547.48"
PayPal Bank 3,09/22/2023,Deposit,9HB22139CS009020D,04 PAYPAL GENERAL UNRESTR,"Subject: GeneralPage
Transaction ID: 9HB22139CS009020D
https://www.paypal.com/activity/payment/9HB22139CS009020D",PayPal Bank 3,--,$48.06,"$1,015,595.54"
Donations directed by individuals,09/22/2023,Deposit,9HB22139CS009020D,04 PAYPAL GENERAL UNRESTR,Support Ukraine - Support Ukraine,Contributed income:Donations directed by individuals,PayPal Bank 3,$50.00,"$1,015,645.54"
PayPal Fees,09/22/2023,Deposit,9HB22139CS009020D,04 PAYPAL GENERAL UNRESTR,PayPal fees,OFFICE/GENERAL ADMINISTRATIVE EXPENSES:PayPal Fees,PayPal Bank 3,$1.94,"$1,015,647.48"
PayPal Bank 3,09/22/2023,Deposit,6MN03903DJ120811V,04 PAYPAL GENERAL UNRESTR,"Subject: GeneralPage
Transaction ID: 6MN03903DJ120811V
https://www.paypal.com/activity/payment/6MN03903DJ120811V",PayPal Bank 3,--,$98.45,"$1,015,745.93"
Donations directed by individuals,09/22/2023,Deposit,6MN03903DJ120811V,04 PAYPAL GENERAL UNRESTR,Support Ukraine - Support Ukraine,Contributed income:Donations directed by individuals,PayPal Bank 3,$103.48,"$1,015,849.41"
PayPal Fees,09/22/2023,Deposit,6MN03903DJ120811V,04 PAYPAL GENERAL UNRESTR,PayPal fees,OFFICE/GENERAL ADMINISTRATIVE EXPENSES:PayPal Fees,PayPal Bank 3,$5.03,"$1,015,854.44"
PayPal Bank 3,09/22/2023,Deposit,7UH579967F907653C,07 1000 DRONES RESTR,"Subject: 1000 DRONES FOR UKRAINE
Transaction ID: 7UH579967F907653C
https://www.paypal.com/activity/payment/7UH579967F907653C",PayPal Bank 3,--,$24.61,"$1,015,879.05"
Donations directed by individuals,09/22/2023,Deposit,7UH579967F907653C,07 1000 DRONES RESTR,Money in to PayPal,Contributed income:Donations directed by individuals,PayPal Bank 3,$26.25,"$1,015,905.30"
PayPal Fees,09/22/2023,Deposit,7UH579967F907653C,07 1000 DRONES RESTR,PayPal fees,OFFICE/GENERAL ADMINISTRATIVE EXPENSES:PayPal Fees,PayPal Bank 3,$1.64,"$1,015,906.94"
PayPal Bank 3,09/22/2023,Deposit,55B41665S7187545T,04 PAYPAL GENERAL UNRESTR,"Subject: GeneralPage
Transaction ID: 55B41665S7187545T
https://www.paypal.com/activity/payment/55B41665S7187545T",PayPal Bank 3,--,$42.53,"$1,015,949.47"
Donations directed by individuals,09/22/2023,Deposit,55B41665S7187545T,04 PAYPAL GENERAL UNRESTR,Support Ukraine - Support Ukraine,Contributed income:Donations directed by individuals,PayPal Bank 3,$45.00,"$1,015,994.47"
PayPal Fees,09/22/2023,Deposit,55B41665S7187545T,04 PAYPAL GENERAL UNRESTR,PayPal fees,OFFICE/GENERAL ADMINISTRATIVE EXPENSES:PayPal Fees,PayPal Bank 3,$2.47,"$1,015,996.94"
PayPal Bank 3,09/22/2023,Deposit,5BC82512X3461373D,07 1000 DRONES RESTR,"Subject: GeneralPage
Note: на лютих пташок
Transaction ID: 5BC82512X3461373D
https://www.paypal.com/activity/payment/5BC82512X3461373D",PayPal Bank 3,--,$98.45,"$1,016,095.39"
Donations directed by individuals,09/22/2023,Deposit,5BC82512X3461373D,07 1000 DRONES RESTR,Support Ukraine - Support Ukraine,Contributed income:Donations directed by individuals,PayPal Bank 3,$103.48,"$1,016,198.87"
PayPal Fees,09/22/2023,Deposit,5BC82512X3461373D,07 1000 DRONES RESTR,PayPal fees,OFFICE/GENERAL ADMINISTRATIVE EXPENSES:PayPal Fees,PayPal Bank 3,$5.03,"$1,016,203.90"
PayPal Bank 3,09/22/2023,Deposit,76H31803LA575464A,04 PAYPAL GENERAL UNRESTR,"Subject: GeneralPage
Transaction ID: 76H31803LA575464A
https://www.paypal.com/activity/payment/76H31803LA575464A",PayPal Bank 3,--,$9.07,"$1,016,212.97"
Donations directed by individuals,09/22/2023,Deposit,76H31803LA575464A,04 PAYPAL GENERAL UNRESTR,Support Ukraine - Support Ukraine,Contributed income:Donations directed by individuals,PayPal Bank 3,$10.00,"$1,016,222.97"
PayPal Fees,09/22/2023,Deposit,76H31803LA575464A,04 PAYPAL GENERAL UNRESTR,PayPal fees,OFFICE/GENERAL ADMINISTRATIVE EXPENSES:PayPal Fees,PayPal Bank 3,$0.93,"$1,016,223.90"
PayPal Bank 3,09/22/2023,Deposit,7UJ39686VG9878730,04 PAYPAL GENERAL UNRESTR,"Subject: GeneralPage
Transaction ID: 7UJ39686VG9878730
https://www.paypal.com/activity/payment/7UJ39686VG9878730",PayPal Bank 3,--,$970.61,"$1,017,194.51"
Donations directed by individuals,09/22/2023,Deposit,7UJ39686VG9878730,04 PAYPAL GENERAL UNRESTR,Support Ukraine - Support Ukraine,Contributed income:Donations directed by individuals,PayPal Bank 3,"$1,000.00","$1,018,194.51"
PayPal Fees,09/22/2023,Deposit,7UJ39686VG9878730,04 PAYPAL GENERAL UNRESTR,PayPal fees,OFFICE/GENERAL ADMINISTRATIVE EXPENSES:PayPal Fees,PayPal Bank 3,$29.39,"$1,018,223.90"
PayPal Bank 3,09/22/2023,Deposit,1RL78043SB3304007,04 PAYPAL GENERAL UNRESTR,"Subject: GeneralPage
Transaction ID: 1RL78043SB3304007
https://www.paypal.com/activity/payment/1RL78043SB3304007",PayPal Bank 3,--,$984.54,"$1,019,208.44"
Donations directed by individuals,09/22/2023,Deposit,1RL78043SB3304007,04 PAYPAL GENERAL UNRESTR,Support Ukraine - Support Ukraine,Contributed income:Donations directed by individuals,PayPal Bank 3,"$1,030.26","$1,020,238.70"
PayPal Fees,09/22/2023,Deposit,1RL78043SB3304007,04 PAYPAL GENERAL UNRESTR,PayPal fees,OFFICE/GENERAL ADMINISTRATIVE EXPENSES:PayPal Fees,PayPal Bank 3,$45.72,"$1,020,284.42"
CHASE ENDING IN 5315,09/22/2023,Deposit,--,02 GENERAL BANK URESTR,BOOK TRANSFER B/O: JPMC INTERNAL ACCOUNTS PROCESSING NEWARK DE XXXXX-XXXX US ORG:/WXXXXXXXX JUDY & PETER BLUM KOVLER FOUNDATION TRN: XXXXXX0265ES,CHASE ENDING IN 5315,Donations directed by individuals,"$12,000.00","$1,032,284.42"
Donations directed by individuals,09/22/2023,Deposit,--,02 GENERAL BANK URESTR,BOOK TRANSFER B/O: JPMC INTERNAL ACCOUNTS PROCESSING NEWARK DE XXXXX-XXXX US ORG:/WXXXXXXXX JUDY & PETER BLUM KOVLER FOUNDATION TRN: XXXXXX0265ES,Contributed income:Donations directed by individuals,CHASE ENDING IN 5315,"$12,000.00","$1,044,284.42"
CHASE ENDING IN 5315,09/22/2023,Deposit,--,02 GENERAL BANK URESTR,Zelle payment from IRENE AMRINE XXXXXXX1838,CHASE ENDING IN 5315,Donations directed by individuals,"$1,439.55","$1,045,723.97"
Donations directed by individuals,09/22/2023,Deposit,--,02 GENERAL BANK URESTR,Zelle payment from IRENE AMRINE XXXXXXX1838,Contributed income:Donations directed by individuals,CHASE ENDING IN 5315,"$1,439.55","$1,047,163.52"
CHASE ENDING IN 5315,09/21/2023,Deposit,--,02 GENERAL BANK URESTR,Zelle payment from IRINA ZAKHALYAVKO XXXXXXX1558,CHASE ENDING IN 5315,Donations directed by individuals,$30.00,"$1,047,193.52"
Donations directed by individuals,09/21/2023,Deposit,--,02 GENERAL BANK URESTR,Zelle payment from IRINA ZAKHALYAVKO XXXXXXX1558,Contributed income:Donations directed by individuals,CHASE ENDING IN 5315,$30.00,"$1,047,223.52"
CHASE ENDING IN 5315,09/20/2023,Deposit,--,02 GENERAL BANK URESTR,Zelle payment from IRINA ZAKHALYAVKO XXXXXXX1558,CHASE ENDING IN 5315,Donations directed by individuals,"$3,000.00","$1,050,223.52"
Donations directed by individuals,09/20/2023,Deposit,--,02 GENERAL BANK URESTR,Zelle payment from IRINA ZAKHALYAVKO XXXXXXX1558,Contributed income:Donations directed by individuals,CHASE ENDING IN 5315,"$3,000.00","$1,053,223.52"
CHASE ENDING IN 5315,09/17/2023,Deposit,--,02 GENERAL BANK URESTR,Zelle payment from MYKOLA GRYSHKO XXXXXXX7191,CHASE ENDING IN 5315,Donations directed by individuals,$140.00,"$1,053,363.52"
Donations directed by individuals,09/17/2023,Deposit,--,02 GENERAL BANK URESTR,Zelle payment from MYKOLA GRYSHKO XXXXXXX7191,Contributed income:Donations directed by individuals,CHASE ENDING IN 5315,$140.00,"$1,053,503.52"
CHASE ENDING IN 5315,09/16/2023,Deposit,--,02 GENERAL BANK URESTR,Zelle payment from MICHAL MALAROWSKI XXXXXXX3478,CHASE ENDING IN 5315,Donations directed by individuals,$25.00,"$1,053,528.52"
Donations directed by individuals,09/16/2023,Deposit,--,02 GENERAL BANK URESTR,Zelle payment from MICHAL MALAROWSKI XXXXXXX3478,Contributed income:Donations directed by individuals,CHASE ENDING IN 5315,$25.00,"$1,053,553.52"
CHASE ENDING IN 5315,09/14/2023,Deposit,--,05 VENMO UNRESTR,ORIG CO NAME:VENMO ORIG ID:XXXXXXXXXX DESC DATE:XXXXXX CO ENTRY DESCR:CASHOUT SEC:PPD TRACE#:XXXXXXXXXXXXXXX EED:XXXXX4 IND ID: IND NAME:OKSANA PATRINA TRN: 257 XXX7885TC,CHASE ENDING IN 5315,Donations directed by individuals,$739.96,"$1,054,293.48"
Donations directed by individuals,09/14/2023,Deposit,--,05 VENMO UNRESTR,ORIG CO NAME:VENMO ORIG ID:XXXXXXXXXX DESC DATE:XXXXXX CO ENTRY DESCR:CASHOUT SEC:PPD TRACE#:XXXXXXXXXXXXXXX EED:XXXXX4 IND ID: IND NAME:OKSANA PATRINA TRN: 257 XXX7885TC,Contributed income:Donations directed by individuals,CHASE ENDING IN 5315,$739.96,"$1,055,033.44"
TRANSFER-ADJUSTMENTS,09/14/2023,Journal Entry,16,--,--,Contributed income:TRANSFER-ADJUSTMENTS,--,-$739.96,"$1,054,293.48"
TRANSFER-ADJUSTMENTS,09/14/2023,Journal Entry,16,--,--,Contributed income:TRANSFER-ADJUSTMENTS,--,$739.96,"$1,055,033.44"
PayPal Bank 3,09/13/2023,Transfer,--,--,ORIG CO NAME:PAYPAL ORIG ID:PAYPALSDXX DESC DATE:XXXXXX CO ENTRY DESCR:TRANSFER SEC:PPD TRACE#:XXXXXXXXXXXXXXX EED:XX0913 IND ID: IND NAME:DIGNITAS UKRAINE TRN: XXXXXX4343TC,PayPal Bank 3,CHASE ENDING IN 5315,"-$20,000.00","$1,035,033.44"
CHASE ENDING IN 5315,09/13/2023,Transfer,--,--,ORIG CO NAME:PAYPAL ORIG ID:PAYPALSDXX DESC DATE:XXXXXX CO ENTRY DESCR:TRANSFER SEC:PPD TRACE#:XXXXXXXXXXXXXXX EED:XX0913 IND ID: IND NAME:DIGNITAS UKRAINE TRN: XXXXXX4343TC,CHASE ENDING IN 5315,PayPal Bank 3,"$20,000.00","$1,055,033.44"
CHASE ENDING IN 5315,09/13/2023,Expense,--,QuickBooks Payments,ORIG CO NAME:INTUIT * ORIG ID:XXXXXXXXXX DESC DATE:XXXXXX CO ENTRY DESCR:QBooks OnlSEC:CCD TRACE#:XXXXXXXXXXXXXXX EED:XXXXXX IND ID:XXX7857 IND NAME:DIGNITAS UK RAINE INC XXX-XXX-XXXX TRN: XXXXXX0952TC,CHASE ENDING IN 5315,Software & apps,-$85.00,"$1,054,948.44"
Software & apps,09/13/2023,Expense,--,QuickBooks Payments,ORIG CO NAME:INTUIT * ORIG ID:XXXXXXXXXX DESC DATE:XXXXXX CO ENTRY DESCR:QBooks OnlSEC:CCD TRACE#:XXXXXXXXXXXXXXX EED:XXXXXX IND ID:XXX7857 IND NAME:DIGNITAS UK RAINE INC XXX-XXX-XXXX TRN: XXXXXX0952TC,OFFICE/GENERAL ADMINISTRATIVE EXPENSES:Software & apps,CHASE ENDING IN 5315,$85.00,"$1,055,033.44"
CHASE ENDING IN 5315,09/13/2023,Expense,--,NGOPTICS,"ONLINE INTERNATIONAL WIRE TRANSFER A/C: FOREIGN CUR BUS ACCT BK X COLUMBUS NEWARK DE XXXXXXXXX US ORG: XXXXXXXXXXXXXXXXX DIGNITAS UKRAINE INC BEN:/PLXXXXXXX5681 XXXXXXXXXXXXXXX NGOPTICS SP Z O O REF: PROFORMA INVOICE NO PX/XX/XXXX PAYER DIGNITAS UKRAINE INC INVOICE PAYM ENT/OCMT/EURXXXXXX,XX/EXCH/X.XXXX/C NTR/XXXXXXXX/ACC/PROFORMA TRN: XXXXXXXXXXRE 09/13",CHASE ENDING IN 5315,DRONE PURCHASES,"-$169,502.30","$885,531.14"
DRONE PURCHASES,09/13/2023,Expense,--,NGOPTICS,"ONLINE INTERNATIONAL WIRE TRANSFER A/C: FOREIGN CUR BUS ACCT BK X COLUMBUS NEWARK DE XXXXXXXXX US ORG: XXXXXXXXXXXXXXXXX DIGNITAS UKRAINE INC BEN:/PLXXXXXXX5681 XXXXXXXXXXXXXXX NGOPTICS SP Z O O REF: PROFORMA INVOICE NO PX/XX/XXXX PAYER DIGNITAS UKRAINE INC INVOICE PAYM ENT/OCMT/EURXXXXXX,XX/EXCH/X.XXXX/C NTR/XXXXXXXX/ACC/PROFORMA TRN: XXXXXXXXXXRE 09/13",PROGRAM EXPENSES:DRONE PURCHASES,CHASE ENDING IN 5315,"$169,502.30","$1,055,033.44"
TRANSFERS DIRECTED BY BOARD,09/13/2023,Journal Entry,1,--,--,Contributed income:TRANSFERS DIRECTED BY BOARD,--,"-$169,502.30","$885,531.14"
TRANSFERS DIRECTED BY BOARD,09/13/2023,Journal Entry,1,--,--,Contributed income:TRANSFERS DIRECTED BY BOARD,--,"$169,502.30","$1,055,033.44"
CHASE ENDING IN 5315,09/10/2023,Deposit,--,02 GENERAL BANK URESTR,Zelle payment from MARYNA TKACHENKO XXXXXXX3842,CHASE ENDING IN 5315,Donations directed by individuals,$500.00,"$1,055,533.44"
Donations directed by individuals,09/10/2023,Deposit,--,02 GENERAL BANK URESTR,Zelle payment from MARYNA TKACHENKO XXXXXXX3842,Contributed income:Donations directed by individuals,CHASE ENDING IN 5315,$500.00,"$1,056,033.44"
CHASE ENDING IN 5315,09/10/2023,Deposit,--,02 GENERAL BANK URESTR,Zelle payment from NIKITA KORMSHCHIKOV BACmaxqw3f7g,CHASE ENDING IN 5315,Donations directed by individuals,"$1,000.00","$1,057,033.44"
Donations directed by individuals,09/10/2023,Deposit,--,02 GENERAL BANK URESTR,Zelle payment from NIKITA KORMSHCHIKOV BACmaxqw3f7g,Contributed income:Donations directed by individuals,CHASE ENDING IN 5315,"$1,000.00","$1,058,033.44"
CHASE ENDING IN 5315,09/10/2023,Deposit,--,02 GENERAL BANK URESTR,Zelle payment from YULIIA KOLODKINA XXXXXXX9064,CHASE ENDING IN 5315,Donations directed by individuals,$500.00,"$1,058,533.44"
Donations directed by individuals,09/10/2023,Deposit,--,02 GENERAL BANK URESTR,Zelle payment from YULIIA KOLODKINA XXXXXXX9064,Contributed income:Donations directed by individuals,CHASE ENDING IN 5315,$500.00,"$1,059,033.44"
TRANSFER-ADJUSTMENTS,09/10/2023,Journal Entry,15,--,--,Contributed income:TRANSFER-ADJUSTMENTS,--,-$500.00,"$1,058,533.44"
TRANSFER-ADJUSTMENTS,09/10/2023,Journal Entry,15,--,--,Contributed income:TRANSFER-ADJUSTMENTS,--,$500.00,"$1,059,033.44"
TRANSFER-ADJUSTMENTS,09/10/2023,Journal Entry,15,--,--,Contributed income:TRANSFER-ADJUSTMENTS,--,-$500.00,"$1,058,533.44"
TRANSFER-ADJUSTMENTS,09/10/2023,Journal Entry,15,--,--,Contributed income:TRANSFER-ADJUSTMENTS,--,$500.00,"$1,059,033.44"
TRANSFER-ADJUSTMENTS,09/10/2023,Journal Entry,15,--,--,Contributed income:TRANSFER-ADJUSTMENTS,--,"-$1,000.00","$1,058,033.44"
TRANSFER-ADJUSTMENTS,09/10/2023,Journal Entry,15,--,--,Contributed income:TRANSFER-ADJUSTMENTS,--,"$1,000.00","$1,059,033.44"
CHASE ENDING IN 5315,09/09/2023,Deposit,--,02 GENERAL BANK URESTR,Zelle payment from IRINA ZAKHALYAVKO XXXXXXX1558,CHASE ENDING IN 5315,Donations directed by individuals,$10.00,"$1,059,043.44"
Donations directed by individuals,09/09/2023,Deposit,--,02 GENERAL BANK URESTR,Zelle payment from IRINA ZAKHALYAVKO XXXXXXX1558,Contributed income:Donations directed by individuals,CHASE ENDING IN 5315,$10.00,"$1,059,053.44"
CHASE ENDING IN 5315,09/09/2023,Deposit,--,02 GENERAL BANK URESTR,Zelle payment from AZAMAT SHARIPOV TDP0HXW12S0G,CHASE ENDING IN 5315,Donations directed by individuals,$10.00,"$1,059,063.44"
Donations directed by individuals,09/09/2023,Deposit,--,02 GENERAL BANK URESTR,Zelle payment from AZAMAT SHARIPOV TDP0HXW12S0G,Contributed income:Donations directed by individuals,CHASE ENDING IN 5315,$10.00,"$1,059,073.44"
CHASE ENDING IN 5315,09/09/2023,Deposit,--,02 GENERAL BANK URESTR,Zelle payment from ELISSA LIPOVETSKIY XXXXXXX6536,CHASE ENDING IN 5315,Donations directed by individuals,$10.00,"$1,059,083.44"
Donations directed by individuals,09/09/2023,Deposit,--,02 GENERAL BANK URESTR,Zelle payment from ELISSA LIPOVETSKIY XXXXXXX6536,Contributed income:Donations directed by individuals,CHASE ENDING IN 5315,$10.00,"$1,059,093.44"
CHASE ENDING IN 5315,09/09/2023,Deposit,--,02 GENERAL BANK URESTR,Zelle payment from IANA DENYSENKO XXXXXXX4804,CHASE ENDING IN 5315,Donations directed by individuals,$40.00,"$1,059,133.44"
Donations directed by individuals,09/09/2023,Deposit,--,02 GENERAL BANK URESTR,Zelle payment from IANA DENYSENKO XXXXXXX4804,Contributed income:Donations directed by individuals,CHASE ENDING IN 5315,$40.00,"$1,059,173.44"
CHASE ENDING IN 5315,09/09/2023,Deposit,--,02 GENERAL BANK URESTR,Zelle payment from NATALIIA VASYLETS BACmn0ulalmu,CHASE ENDING IN 5315,Donations directed by individuals,$40.00,"$1,059,213.44"
Donations directed by individuals,09/09/2023,Deposit,--,02 GENERAL BANK URESTR,Zelle payment from NATALIIA VASYLETS BACmn0ulalmu,Contributed income:Donations directed by individuals,CHASE ENDING IN 5315,$40.00,"$1,059,253.44"
TRANSFER-ADJUSTMENTS,09/09/2023,Journal Entry,14,--,--,Contributed income:TRANSFER-ADJUSTMENTS,--,"$2,912.81","$1,062,166.25"
TRANSFER-ADJUSTMENTS,09/09/2023,Journal Entry,14,--,--,Contributed income:TRANSFER-ADJUSTMENTS,--,"-$2,912.81","$1,059,253.44"
PayPal Fees,09/09/2023,Journal Entry,14,--,--,OFFICE/GENERAL ADMINISTRATIVE EXPENSES:PayPal Fees,--,-$87.19,"$1,059,166.25"
PayPal Fees,09/09/2023,Journal Entry,14,--,--,OFFICE/GENERAL ADMINISTRATIVE EXPENSES:PayPal Fees,--,$87.19,"$1,059,253.44"
CHASE ENDING IN 5315,09/06/2023,Deposit,--,02 GENERAL BANK URESTR,Zelle payment from NATALIIA LOMAKINA BACdro9mysjt,CHASE ENDING IN 5315,Donations directed by individuals,$500.00,"$1,059,753.44"
Donations directed by individuals,09/06/2023,Deposit,--,02 GENERAL BANK URESTR,Zelle payment from NATALIIA LOMAKINA BACdro9mysjt,Contributed income:Donations directed by individuals,CHASE ENDING IN 5315,$500.00,"$1,060,253.44"
CHASE ENDING IN 5315,09/02/2023,Deposit,--,02 GENERAL BANK URESTR,Zelle payment from OLENA STADNYUK CTIsfnB3sawV,CHASE ENDING IN 5315,Donations directed by individuals,"$1,000.00","$1,061,253.44"
Donations directed by individuals,09/02/2023,Deposit,--,02 GENERAL BANK URESTR,Zelle payment from OLENA STADNYUK CTIsfnB3sawV,Contributed income:Donations directed by individuals,CHASE ENDING IN 5315,"$1,000.00","$1,062,253.44"
CHASE ENDING IN 5315,09/01/2023,Deposit,--,02 GENERAL BANK URESTR,Zelle payment from ELLEN BEDENKO WFCT0R7NXZ2Z,CHASE ENDING IN 5315,Donations directed by individuals,$10.00,"$1,062,263.44"
Donations directed by individuals,09/01/2023,Deposit,--,02 GENERAL BANK URESTR,Zelle payment from ELLEN BEDENKO WFCT0R7NXZ2Z,Contributed income:Donations directed by individuals,CHASE ENDING IN 5315,$10.00,"$1,062,273.44"
CHASE ENDING IN 5315,09/01/2023,Deposit,--,02 GENERAL BANK URESTR,Zelle payment from VYACHESLAV SHPIGEL BACd3fgrxrf9,CHASE ENDING IN 5315,Donations directed by individuals,$555.00,"$1,062,828.44"
Donations directed by individuals,09/01/2023,Deposit,--,02 GENERAL BANK URESTR,Zelle payment from VYACHESLAV SHPIGEL BACd3fgrxrf9,Contributed income:Donations directed by individuals,CHASE ENDING IN 5315,$555.00,"$1,063,383.44"
In-kind donations,08/31/2023,Journal Entry,9,--,A.BOYCHUK AMAZON WISH LIST,Contributed income:In-kind donations,--,$17.47,"$1,063,400.91"
IN-KIND DONATION DISTRIBUTIONS,08/31/2023,Journal Entry,9,--,A.BOYCHUK AMAZON WISH LIST,PROGRAM EXPENSES:IN-KIND DONATION DISTRIBUTIONS,--,$17.47,"$1,063,418.38"
In-kind donations,08/31/2023,Journal Entry,10,--,A.BOYCHUK AMAZON WISH LIST,Contributed income:In-kind donations,--,$711.20,"$1,064,129.58"
IN-KIND DONATION DISTRIBUTIONS,08/31/2023,Journal Entry,10,--,A.BOYCHUK AMAZON WISH LIST,PROGRAM EXPENSES:IN-KIND DONATION DISTRIBUTIONS,--,$711.20,"$1,064,840.78"
CHASE ENDING IN 5315,08/30/2023,Deposit,--,02 GENERAL BANK URESTR,"Zelle payment from KOTRA, INC BACmjnz48rsf",CHASE ENDING IN 5315,Donations directed by individuals,"$2,400.00","$1,067,240.78"
Donations directed by individuals,08/30/2023,Deposit,--,02 GENERAL BANK URESTR,"Zelle payment from KOTRA, INC BACmjnz48rsf",Contributed income:Donations directed by individuals,CHASE ENDING IN 5315,"$2,400.00","$1,069,640.78"
CHASE ENDING IN 5315,08/28/2023,Deposit,--,02 GENERAL BANK URESTR,Zelle payment from MARYANA YAREMKO BACb7b2alqu5,CHASE ENDING IN 5315,Donations directed by individuals,"$2,100.00","$1,071,740.78"
Donations directed by individuals,08/28/2023,Deposit,--,02 GENERAL BANK URESTR,Zelle payment from MARYANA YAREMKO BACb7b2alqu5,Contributed income:Donations directed by individuals,CHASE ENDING IN 5315,"$2,100.00","$1,073,840.78"
CHASE ENDING IN 5315,08/27/2023,Deposit,--,02 GENERAL BANK URESTR,Zelle payment from Motria Melnyk 2JM0HXJT5NOG,CHASE ENDING IN 5315,Donations directed by individuals,$200.00,"$1,074,040.78"
Donations directed by individuals,08/27/2023,Deposit,--,02 GENERAL BANK URESTR,Zelle payment from Motria Melnyk 2JM0HXJT5NOG,Contributed income:Donations directed by individuals,CHASE ENDING IN 5315,$200.00,"$1,074,240.78"
CHASE ENDING IN 5315,08/27/2023,Deposit,--,02 GENERAL BANK URESTR,Zelle payment from TETYANA SHAMARINA CTIndstdzxvj,CHASE ENDING IN 5315,Donations directed by individuals,$60.00,"$1,074,300.78"
Donations directed by individuals,08/27/2023,Deposit,--,02 GENERAL BANK URESTR,Zelle payment from TETYANA SHAMARINA CTIndstdzxvj,Contributed income:Donations directed by individuals,CHASE ENDING IN 5315,$60.00,"$1,074,360.78"
CHASE ENDING IN 5315,08/27/2023,Deposit,--,02 GENERAL BANK URESTR,Zelle payment from VIKTOR Y OCHKOVSKIY XXXXXXX5200,CHASE ENDING IN 5315,Donations directed by individuals,$750.00,"$1,075,110.78"
Donations directed by individuals,08/27/2023,Deposit,--,02 GENERAL BANK URESTR,Zelle payment from VIKTOR Y OCHKOVSKIY XXXXXXX5200,Contributed income:Donations directed by individuals,CHASE ENDING IN 5315,$750.00,"$1,075,860.78"
CHASE ENDING IN 5315,08/26/2023,Deposit,--,02 GENERAL BANK URESTR,Zelle payment from ALEXANDER BASHMAKOV BACbo0xxn97d,CHASE ENDING IN 5315,Donations directed by individuals,$60.00,"$1,075,920.78"
Donations directed by individuals,08/26/2023,Deposit,--,02 GENERAL BANK URESTR,Zelle payment from ALEXANDER BASHMAKOV BACbo0xxn97d,Contributed income:Donations directed by individuals,CHASE ENDING IN 5315,$60.00,"$1,075,980.78"
CHASE ENDING IN 5315,08/25/2023,Deposit,1,02 GENERAL BANK URESTR,REMOTE ONLINE DEPOSIT # 1,CHASE ENDING IN 5315,Donations directed by individuals,"$10,000.00","$1,085,980.78"
Donations directed by individuals,08/25/2023,Deposit,1,02 GENERAL BANK URESTR,REMOTE ONLINE DEPOSIT # 1,Contributed income:Donations directed by individuals,CHASE ENDING IN 5315,"$10,000.00","$1,095,980.78"
CHASE ENDING IN 5315,08/23/2023,Deposit,--,02 GENERAL BANK URESTR,Zelle payment from VIKTORIYA SUKMANOVA BAClia4gplcq,CHASE ENDING IN 5315,Donations directed by individuals,"$3,500.00","$1,099,480.78"
Donations directed by individuals,08/23/2023,Deposit,--,02 GENERAL BANK URESTR,Zelle payment from VIKTORIYA SUKMANOVA BAClia4gplcq,Contributed income:Donations directed by individuals,CHASE ENDING IN 5315,"$3,500.00","$1,102,980.78"
CHASE ENDING IN 5315,08/22/2023,Deposit,--,02 GENERAL BANK URESTR,DEPOSIT ID NUMBER XX7732,CHASE ENDING IN 5315,Donations directed by individuals,"$10,000.00","$1,112,980.78"
Donations directed by individuals,08/22/2023,Deposit,--,02 GENERAL BANK URESTR,DEPOSIT ID NUMBER XX7732,Contributed income:Donations directed by individuals,CHASE ENDING IN 5315,"$10,000.00","$1,122,980.78"
PayPal Bank 3,08/21/2023,Transfer,--,--,ORIG CO NAME:PAYPAL ORIG ID:PAYPALSDXX DESC DATE:XXXXXX CO ENTRY DESCR:TRANSFER SEC:PPD TRACE#:XXXXXXXXXXXXXXX EED:XX0821 IND ID: IND NAME:DIGNITAS UKRAINE TRN: XXXXXX5448TC,PayPal Bank 3,CHASE ENDING IN 5315,"-$6,000.00","$1,116,980.78"
CHASE ENDING IN 5315,08/21/2023,Transfer,--,--,ORIG CO NAME:PAYPAL ORIG ID:PAYPALSDXX DESC DATE:XXXXXX CO ENTRY DESCR:TRANSFER SEC:PPD TRACE#:XXXXXXXXXXXXXXX EED:XX0821 IND ID: IND NAME:DIGNITAS UKRAINE TRN: XXXXXX5448TC,CHASE ENDING IN 5315,PayPal Bank 3,"$6,000.00","$1,122,980.78"
CHASE ENDING IN 5315,08/21/2023,Deposit,--,02 GENERAL BANK URESTR,Zelle payment from Lesia Semenova ALB0HXCPSN8K,CHASE ENDING IN 5315,Donations directed by individuals,$300.00,"$1,123,280.78"
Donations directed by individuals,08/21/2023,Deposit,--,02 GENERAL BANK URESTR,Zelle payment from Lesia Semenova ALB0HXCPSN8K,Contributed income:Donations directed by individuals,CHASE ENDING IN 5315,$300.00,"$1,123,580.78"
CHASE ENDING IN 5315,08/19/2023,Deposit,--,02 GENERAL BANK URESTR,Zelle payment from ELLEN BEDENKO WFCT0RHHTYM8,CHASE ENDING IN 5315,Donations directed by individuals,$20.00,"$1,123,600.78"
Donations directed by individuals,08/19/2023,Deposit,--,02 GENERAL BANK URESTR,Zelle payment from ELLEN BEDENKO WFCT0RHHTYM8,Contributed income:Donations directed by individuals,CHASE ENDING IN 5315,$20.00,"$1,123,620.78"
CHASE ENDING IN 5315,08/19/2023,Deposit,--,02 GENERAL BANK URESTR,Zelle payment from OLEXANDR NESKIN BACppz6c7zq8,CHASE ENDING IN 5315,Donations directed by individuals,$100.00,"$1,123,720.78"
Donations directed by individuals,08/19/2023,Deposit,--,02 GENERAL BANK URESTR,Zelle payment from OLEXANDR NESKIN BACppz6c7zq8,Contributed income:Donations directed by individuals,CHASE ENDING IN 5315,$100.00,"$1,123,820.78"
CHASE ENDING IN 5315,08/15/2023,Deposit,--,02 GENERAL BANK URESTR,Zelle payment from Denys Dratsky COFEUI1PLRFM,CHASE ENDING IN 5315,Donations directed by individuals,$30.00,"$1,123,850.78"
Donations directed by individuals,08/15/2023,Deposit,--,02 GENERAL BANK URESTR,Zelle payment from Denys Dratsky COFEUI1PLRFM,Contributed income:Donations directed by individuals,CHASE ENDING IN 5315,$30.00,"$1,123,880.78"
CHASE ENDING IN 5315,08/15/2023,Expense,--,03 FUNDRASING EVENTS UNRESTR,Zelle payment to Dmitri Zakhalyavko XXXXXXX6142,CHASE ENDING IN 5315,--,-$885.00,"$1,122,995.78"
EVENTS PARTICIPATION EXPENSES,08/15/2023,Expense,--,03 FUNDRASING EVENTS UNRESTR,Zelle payment to Dmitri Zakhalyavko  Sousivka  table Fee XXXXXXX6142,FUNDRAISING EVENTS:EVENTS PARTICIPATION EXPENSES,CHASE ENDING IN 5315,$285.00,"$1,123,280.78"
Legal fees,08/15/2023,Expense,--,03 FUNDRASING EVENTS UNRESTR,non-profit allication,OFFICE/GENERAL ADMINISTRATIVE EXPENSES:Legal fees,CHASE ENDING IN 5315,$600.00,"$1,123,880.78"
CHASE ENDING IN 5315,08/14/2023,Deposit,--,02 GENERAL BANK URESTR,"FEDWIRE CREDIT VIA: FIRST REPUBLIC BANK/XXXXXXXXX B/O: LUM FOUNDATION ATTENTION ROBERT GRANEW YORK-NY-X0013 REF: CHASE NYC/CTR/BNF=DIGNITAS UKRAINE INC ROSELLE PARK NJ XXXXX-XXXX US/A C-XXXXXXXXXXXX RFB=O/B FST REP BK S OBI=REF: DONATION BBI=/CHGS/USDX,X X/ IMAD: XXXXMMQFMPRNXXXXXX TRN: XXXXXX0226FF",CHASE ENDING IN 5315,Donations directed by individuals,"$250,000.00","$1,373,880.78"
Donations directed by individuals,08/14/2023,Deposit,--,02 GENERAL BANK URESTR,"FEDWIRE CREDIT VIA: FIRST REPUBLIC BANK/XXXXXXXXX B/O: LUM FOUNDATION ATTENTION ROBERT GRANEW YORK-NY-X0013 REF: CHASE NYC/CTR/BNF=DIGNITAS UKRAINE INC ROSELLE PARK NJ XXXXX-XXXX US/A C-XXXXXXXXXXXX RFB=O/B FST REP BK S OBI=REF: DONATION BBI=/CHGS/USDX,X X/ IMAD: XXXXMMQFMPRNXXXXXX TRN: XXXXXX0226FF",Contributed income:Donations directed by individuals,CHASE ENDING IN 5315,"$250,000.00","$1,623,880.78"
CHASE ENDING IN 5315,08/14/2023,Check,--,CHASE BANK,DOMESTIC INCOMING WIRE FEE,CHASE ENDING IN 5315,Bank fees & service charges,-$15.00,"$1,623,865.78"
Bank fees & service charges,08/14/2023,Check,--,CHASE BANK,DOMESTIC INCOMING WIRE FEE,OFFICE/GENERAL ADMINISTRATIVE EXPENSES:Bank fees & service charges,CHASE ENDING IN 5315,$15.00,"$1,623,880.78"
CHASE ENDING IN 5315,08/14/2023,Expense,--,QuickBooks Payments,ORIG CO NAME:INTUIT * ORIG ID:XXXXXXXXXX DESC DATE:XXXXXX CO ENTRY DESCR:QBooks OnlSEC:CCD TRACE#:XXXXXXXXXXXXXXX EED:XXXXXX IND ID:XXX9390 IND NAME:DIGNITAS UK RAINE INC XXX-XXX-XXXX TRN: XXXXXX5943TC,CHASE ENDING IN 5315,Software & apps,-$42.50,"$1,623,838.28"
Software & apps,08/14/2023,Expense,--,QuickBooks Payments,ORIG CO NAME:INTUIT * ORIG ID:XXXXXXXXXX DESC DATE:XXXXXX CO ENTRY DESCR:QBooks OnlSEC:CCD TRACE#:XXXXXXXXXXXXXXX EED:XXXXXX IND ID:XXX9390 IND NAME:DIGNITAS UK RAINE INC XXX-XXX-XXXX TRN: XXXXXX5943TC,OFFICE/GENERAL ADMINISTRATIVE EXPENSES:Software & apps,CHASE ENDING IN 5315,$42.50,"$1,623,880.78"
CHASE ENDING IN 5315,08/11/2023,Deposit,--,02 GENERAL BANK URESTR,Zelle payment from DMITRY KOHMANYUK WFCT0RGWDFKH,CHASE ENDING IN 5315,Donations directed by individuals,$50.50,"$1,623,931.28"
Donations directed by individuals,08/11/2023,Deposit,--,02 GENERAL BANK URESTR,Zelle payment from DMITRY KOHMANYUK WFCT0RGWDFKH,Contributed income:Donations directed by individuals,CHASE ENDING IN 5315,$50.50,"$1,623,981.78"
PayPal Bank 3,08/10/2023,Transfer,--,--,ORIG CO NAME:PAYPAL ORIG ID:PAYPALSDXX DESC DATE:XXXXXX CO ENTRY DESCR:TRANSFER SEC:PPD TRACE#:XXXXXXXXXXXXXXX EED:XX0810 IND ID: IND NAME:DIGNITAS UKRAINE TRN: XXXXXX6011TC,PayPal Bank 3,CHASE ENDING IN 5315,"-$3,000.00","$1,620,981.78"
CHASE ENDING IN 5315,08/10/2023,Transfer,--,--,ORIG CO NAME:PAYPAL ORIG ID:PAYPALSDXX DESC DATE:XXXXXX CO ENTRY DESCR:TRANSFER SEC:PPD TRACE#:XXXXXXXXXXXXXXX EED:XX0810 IND ID: IND NAME:DIGNITAS UKRAINE TRN: XXXXXX6011TC,CHASE ENDING IN 5315,PayPal Bank 3,"$3,000.00","$1,623,981.78"
CHASE ENDING IN 5315,08/10/2023,Deposit,--,02 GENERAL BANK URESTR,Zelle payment from TETYANA SHAMARINA CTIRki6wt5G6,CHASE ENDING IN 5315,Donations directed by individuals,$100.00,"$1,624,081.78"
Donations directed by individuals,08/10/2023,Deposit,--,02 GENERAL BANK URESTR,Zelle payment from TETYANA SHAMARINA CTIRki6wt5G6,Contributed income:Donations directed by individuals,CHASE ENDING IN 5315,$100.00,"$1,624,181.78"
CHASE ENDING IN 5315,08/10/2023,Deposit,--,02 GENERAL BANK URESTR,"FEDWIRE CREDIT VIA: WELLS FARGO BANK, N.A./XXXXXXXXX B/O: SCHWAB CHARITABLE FUND SAN FRANCISCO CA X4105/US/REF: CHASE NYC/CTR/BNF=DIGNITAS UKRAINE INC ROSELLE P ARK NJ XXXXX-XXXX US/A C-XXXXXXXXXXXX RFB=XXXXXXXXXXXXX OB I=SCHWAB CHARITABLE FUND BBI=/CHGS/USDX,XX/CHGS/USDX,XX/OCMT/USDXXXXXX ,XX/ACC/SCHWAB C IMAD: XXXXIXBXXXXRXXXXXX TRN: XXXXXX0222FF",CHASE ENDING IN 5315,Donations directed by individuals,"$840,000.00","$2,464,181.78"
Donations directed by individuals,08/10/2023,Deposit,--,02 GENERAL BANK URESTR,"FEDWIRE CREDIT VIA: WELLS FARGO BANK, N.A./XXXXXXXXX B/O: SCHWAB CHARITABLE FUND SAN FRANCISCO CA X4105/US/REF: CHASE NYC/CTR/BNF=DIGNITAS UKRAINE INC ROSELLE P ARK NJ XXXXX-XXXX US/A C-XXXXXXXXXXXX RFB=XXXXXXXXXXXXX OB I=SCHWAB CHARITABLE FUND BBI=/CHGS/USDX,XX/CHGS/USDX,XX/OCMT/USDXXXXXX ,XX/ACC/SCHWAB C IMAD: XXXXIXBXXXXRXXXXXX TRN: XXXXXX0222FF",Contributed income:Donations directed by individuals,CHASE ENDING IN 5315,"$840,000.00","$3,304,181.78"
CHASE ENDING IN 5315,08/10/2023,Check,1007730,CHASE BANK,DOMESTIC INCOMING WIRE FEE,CHASE ENDING IN 5315,Bank fees & service charges,-$15.00,"$3,304,166.78"
Bank fees & service charges,08/10/2023,Check,1007730,CHASE BANK,DOMESTIC INCOMING WIRE FEE,OFFICE/GENERAL ADMINISTRATIVE EXPENSES:Bank fees & service charges,CHASE ENDING IN 5315,$15.00,"$3,304,181.78"
CHASE ENDING IN 5315,08/09/2023,Check,5161,COLLEGIATE PRODUCTIONS,CHECK # 5161,CHASE ENDING IN 5315,SUPPLIES AND MATERIALS,"-$1,650.60","$3,302,531.18"
SUPPLIES AND MATERIALS,08/09/2023,Check,5161,COLLEGIATE PRODUCTIONS,CHECK # 5161,FUNDRAISING EVENTS:SUPPLIES AND MATERIALS,CHASE ENDING IN 5315,"$1,650.60","$3,304,181.78"
PayPal Bank 3,08/08/2023,Transfer,--,--,ORIG CO NAME:PAYPAL ORIG ID:PAYPALSDXX DESC DATE:XXXXXX CO ENTRY DESCR:TRANSFER SEC:PPD TRACE#:XXXXXXXXXXXXXXX EED:XX0808 IND ID: IND NAME:DIGNITAS UKRAINE TRN: XXXXXX5564TC,PayPal Bank 3,CHASE ENDING IN 5315,"-$6,400.00","$3,297,781.78"
CHASE ENDING IN 5315,08/08/2023,Transfer,--,--,ORIG CO NAME:PAYPAL ORIG ID:PAYPALSDXX DESC DATE:XXXXXX CO ENTRY DESCR:TRANSFER SEC:PPD TRACE#:XXXXXXXXXXXXXXX EED:XX0808 IND ID: IND NAME:DIGNITAS UKRAINE TRN: XXXXXX5564TC,CHASE ENDING IN 5315,PayPal Bank 3,"$6,400.00","$3,304,181.78"
PayPal Bank 3,07/31/2023,Transfer,--,--,ORIG CO NAME:PAYPAL ORIG ID:PAYPALSDXX DESC DATE:XXXXXX CO ENTRY DESCR:TRANSFER SEC:PPD TRACE#:XXXXXXXXXXXXXXX EED:XX0731 IND ID: IND NAME:DIGNITAS UKRAINE TRN: XXXXXX6563TC,PayPal Bank 3,CHASE ENDING IN 5315,"-$9,600.00","$3,294,581.78"
CHASE ENDING IN 5315,07/31/2023,Transfer,--,--,ORIG CO NAME:PAYPAL ORIG ID:PAYPALSDXX DESC DATE:XXXXXX CO ENTRY DESCR:TRANSFER SEC:PPD TRACE#:XXXXXXXXXXXXXXX EED:XX0731 IND ID: IND NAME:DIGNITAS UKRAINE TRN: XXXXXX6563TC,CHASE ENDING IN 5315,PayPal Bank 3,"$9,600.00","$3,304,181.78"
In-kind donations,07/31/2023,Journal Entry,12,--,A.BOYCHUK AMAZON WISH LIST,Contributed income:In-kind donations,--,$434.98,"$3,304,616.76"
IN-KIND DONATION DISTRIBUTIONS,07/31/2023,Journal Entry,12,--,A.BOYCHUK AMAZON WISH LIST,PROGRAM EXPENSES:IN-KIND DONATION DISTRIBUTIONS,--,$434.98,"$3,305,051.74"
CHASE ENDING IN 5315,07/30/2023,Deposit,--,02 GENERAL BANK URESTR,Zelle payment from Denys Dratsky COF3MG2E3DZ3,CHASE ENDING IN 5315,Donations directed by individuals,$30.00,"$3,305,081.74"
Donations directed by individuals,07/30/2023,Deposit,--,02 GENERAL BANK URESTR,Zelle payment from Denys Dratsky COF3MG2E3DZ3,Contributed income:Donations directed by individuals,CHASE ENDING IN 5315,$30.00,"$3,305,111.74"
CHASE ENDING IN 5315,07/27/2023,Deposit,--,02 GENERAL BANK URESTR,Zelle payment from OLGA STOKOLOSA BACbpea12b9f,CHASE ENDING IN 5315,Donations directed by individuals,$505.00,"$3,305,616.74"
Donations directed by individuals,07/27/2023,Deposit,--,02 GENERAL BANK URESTR,Zelle payment from OLGA STOKOLOSA BACbpea12b9f,Contributed income:Donations directed by individuals,CHASE ENDING IN 5315,$505.00,"$3,306,121.74"
PayPal Bank 3,07/27/2023,Deposit,--,04 PAYPAL GENERAL UNRESTR,--,PayPal Bank 3,Donations directed by individuals,$128.13,"$3,306,249.87"
Donations directed by individuals,07/27/2023,Deposit,--,04 PAYPAL GENERAL UNRESTR,--,Contributed income:Donations directed by individuals,PayPal Bank 3,$128.13,"$3,306,378.00"
PayPal Bank 3,07/24/2023,Transfer,--,--,ORIG CO NAME:PAYPAL ORIG ID:PAYPALSDXX DESC DATE:XXXXXX CO ENTRY DESCR:TRANSFER SEC:PPD TRACE#:XXXXXXXXXXXXXXX EED:XX0724 IND ID: IND NAME:DIGNITAS UKRAINE TRN: XXXXXX9382TC,PayPal Bank 3,CHASE ENDING IN 5315,"-$5,000.00","$3,301,378.00"
CHASE ENDING IN 5315,07/24/2023,Transfer,--,--,ORIG CO NAME:PAYPAL ORIG ID:PAYPALSDXX DESC DATE:XXXXXX CO ENTRY DESCR:TRANSFER SEC:PPD TRACE#:XXXXXXXXXXXXXXX EED:XX0724 IND ID: IND NAME:DIGNITAS UKRAINE TRN: XXXXXX9382TC,CHASE ENDING IN 5315,PayPal Bank 3,"$5,000.00","$3,306,378.00"
CHASE ENDING IN 5315,07/24/2023,Deposit,--,02 GENERAL BANK URESTR,Zelle payment from ROMANIIA VOITYSHYN XXXXXXX6393,CHASE ENDING IN 5315,Donations directed by individuals,$20.00,"$3,306,398.00"
Donations directed by individuals,07/24/2023,Deposit,--,02 GENERAL BANK URESTR,Zelle payment from ROMANIIA VOITYSHYN XXXXXXX6393,Contributed income:Donations directed by individuals,CHASE ENDING IN 5315,$20.00,"$3,306,418.00"
CHASE ENDING IN 5315,07/24/2023,Deposit,--,02 GENERAL BANK URESTR,Zelle payment from YULIIA LAZORYSHYN XXXXXXX7752,CHASE ENDING IN 5315,Donations directed by individuals,$20.00,"$3,306,438.00"
Donations directed by individuals,07/24/2023,Deposit,--,02 GENERAL BANK URESTR,Zelle payment from YULIIA LAZORYSHYN XXXXXXX7752,Contributed income:Donations directed by individuals,CHASE ENDING IN 5315,$20.00,"$3,306,458.00"
CHASE ENDING IN 5315,07/22/2023,Deposit,--,05 VENMO UNRESTR,ORIG CO NAME:VENMO ORIG ID:XXXXXXXXXX DESC DATE:XXXXXX CO ENTRY DESCR:CASHOUT SEC:PPD TRACE#:XXXXXXXXXXXXXXX EED:XXXXX4 IND ID: IND NAME:OKSANA PATRINA TRN: 205 XXX0438TC,CHASE ENDING IN 5315,Donations directed by individuals,$146.95,"$3,306,604.95"
Donations directed by individuals,07/22/2023,Deposit,--,05 VENMO UNRESTR,ORIG CO NAME:VENMO ORIG ID:XXXXXXXXXX DESC DATE:XXXXXX CO ENTRY DESCR:CASHOUT SEC:PPD TRACE#:XXXXXXXXXXXXXXX EED:XXXXX4 IND ID: IND NAME:OKSANA PATRINA TRN: 205 XXX0438TC,Contributed income:Donations directed by individuals,CHASE ENDING IN 5315,$146.95,"$3,306,751.90"
PayPal Bank 3,07/18/2023,Transfer,--,--,ORIG CO NAME:PAYPAL ORIG ID:PAYPALSDXX DESC DATE:XXXXXX CO ENTRY DESCR:TRANSFER SEC:PPD TRACE#:XXXXXXXXXXXXXXX EED:XX0718 IND ID: IND NAME:DIGNITAS UKRAINE TRN: XXXXXX3375TC,PayPal Bank 3,CHASE ENDING IN 5315,"-$2,000.00","$3,304,751.90"
CHASE ENDING IN 5315,07/18/2023,Transfer,--,--,ORIG CO NAME:PAYPAL ORIG ID:PAYPALSDXX DESC DATE:XXXXXX CO ENTRY DESCR:TRANSFER SEC:PPD TRACE#:XXXXXXXXXXXXXXX EED:XX0718 IND ID: IND NAME:DIGNITAS UKRAINE TRN: XXXXXX3375TC,CHASE ENDING IN 5315,PayPal Bank 3,"$2,000.00","$3,306,751.90"
CHASE ENDING IN 5315,07/18/2023,Deposit,--,05 VENMO UNRESTR,ORIG CO NAME:VENMO ORIG ID:XXXXXXXXXX DESC DATE:XXXXXX CO ENTRY DESCR:CASHOUT SEC:PPD TRACE#:XXXXXXXXXXXXXXX EED:XXXXX8 IND ID: IND NAME:OKSANA PATRINA TRN: 199 XXX5739TC,CHASE ENDING IN 5315,Donations directed by individuals,$141.85,"$3,306,893.75"
Donations directed by individuals,07/18/2023,Deposit,--,05 VENMO UNRESTR,ORIG CO NAME:VENMO ORIG ID:XXXXXXXXXX DESC DATE:XXXXXX CO ENTRY DESCR:CASHOUT SEC:PPD TRACE#:XXXXXXXXXXXXXXX EED:XXXXX8 IND ID: IND NAME:OKSANA PATRINA TRN: 199 XXX5739TC,Contributed income:Donations directed by individuals,CHASE ENDING IN 5315,$141.85,"$3,307,035.60"
PayPal Bank 3,07/17/2023,Transfer,--,--,ORIG CO NAME:PAYPAL ORIG ID:PAYPALSDXX DESC DATE:XXXXXX CO ENTRY DESCR:TRANSFER SEC:PPD TRACE#:XXXXXXXXXXXXXXX EED:XX0717 IND ID: IND NAME:DIGNITAS UKRAINE TRN: XXXXXX5964TC,PayPal Bank 3,CHASE ENDING IN 5315,"-$6,000.00","$3,301,035.60"
CHASE ENDING IN 5315,07/17/2023,Transfer,--,--,ORIG CO NAME:PAYPAL ORIG ID:PAYPALSDXX DESC DATE:XXXXXX CO ENTRY DESCR:TRANSFER SEC:PPD TRACE#:XXXXXXXXXXXXXXX EED:XX0717 IND ID: IND NAME:DIGNITAS UKRAINE TRN: XXXXXX5964TC,CHASE ENDING IN 5315,PayPal Bank 3,"$6,000.00","$3,307,035.60"
CHASE ENDING IN 5315,07/15/2023,Deposit,--,02 GENERAL BANK URESTR,Zelle payment from ANDRII SHUMYLO BACc5qt3q28e,CHASE ENDING IN 5315,Donations directed by individuals,$20.00,"$3,307,055.60"
Donations directed by individuals,07/15/2023,Deposit,--,02 GENERAL BANK URESTR,Zelle payment from ANDRII SHUMYLO BACc5qt3q28e,Contributed income:Donations directed by individuals,CHASE ENDING IN 5315,$20.00,"$3,307,075.60"
CHASE ENDING IN 5315,07/15/2023,Deposit,--,02 GENERAL BANK URESTR,Zelle payment from MYKOLA KOLOMIICHUK JXYtX009Ou5v,CHASE ENDING IN 5315,Donations directed by individuals,$100.00,"$3,307,175.60"
Donations directed by individuals,07/15/2023,Deposit,--,02 GENERAL BANK URESTR,Zelle payment from MYKOLA KOLOMIICHUK JXYtX009Ou5v,Contributed income:Donations directed by individuals,CHASE ENDING IN 5315,$100.00,"$3,307,275.60"
CHASE ENDING IN 5315,07/15/2023,Deposit,--,02 GENERAL BANK URESTR,Zelle payment from OLHA ZARICHYNSKA XM10FBFC4Q7P,CHASE ENDING IN 5315,Donations directed by individuals,$10.00,"$3,307,285.60"
Donations directed by individuals,07/15/2023,Deposit,--,02 GENERAL BANK URESTR,Zelle payment from OLHA ZARICHYNSKA XM10FBFC4Q7P,Contributed income:Donations directed by individuals,CHASE ENDING IN 5315,$10.00,"$3,307,295.60"
CHASE ENDING IN 5315,07/08/2023,Deposit,--,02 GENERAL BANK URESTR,Zelle payment from VIKTOR Y OCHKOVSKIY XXXXXXX4383,CHASE ENDING IN 5315,Donations directed by individuals,$750.00,"$3,308,045.60"
Donations directed by individuals,07/08/2023,Deposit,--,02 GENERAL BANK URESTR,Zelle payment from VIKTOR Y OCHKOVSKIY XXXXXXX4383,Contributed income:Donations directed by individuals,CHASE ENDING IN 5315,$750.00,"$3,308,795.60"
PayPal Bank 3,07/05/2023,Transfer,--,--,ORIG CO NAME:PAYPAL ORIG ID:PAYPALSDXX DESC DATE:XXXXXX CO ENTRY DESCR:TRANSFER SEC:PPD TRACE#:XXXXXXXXXXXXXXX EED:XX0705 IND ID: IND NAME:DIGNITAS UKRAINE TRN: XXXXXX5882TC,PayPal Bank 3,CHASE ENDING IN 5315,"-$7,000.00","$3,301,795.60"
CHASE ENDING IN 5315,07/05/2023,Transfer,--,--,ORIG CO NAME:PAYPAL ORIG ID:PAYPALSDXX DESC DATE:XXXXXX CO ENTRY DESCR:TRANSFER SEC:PPD TRACE#:XXXXXXXXXXXXXXX EED:XX0705 IND ID: IND NAME:DIGNITAS UKRAINE TRN: XXXXXX5882TC,CHASE ENDING IN 5315,PayPal Bank 3,"$7,000.00","$3,308,795.60"
CHASE ENDING IN 5315,07/01/2023,Deposit,--,02 GENERAL BANK URESTR,Zelle payment from OLENA PAZDERSKA XXXXXXX9704,CHASE ENDING IN 5315,Donations directed by individuals,$20.00,"$3,308,815.60"
Donations directed by individuals,07/01/2023,Deposit,--,02 GENERAL BANK URESTR,Zelle payment from OLENA PAZDERSKA XXXXXXX9704,Contributed income:Donations directed by individuals,CHASE ENDING IN 5315,$20.00,"$3,308,835.60"
CHASE ENDING IN 5315,07/01/2023,Deposit,--,02 GENERAL BANK URESTR,Zelle payment from VITALIY VYKHOVANETS XXXXXXX8270,CHASE ENDING IN 5315,Donations directed by individuals,$20.00,"$3,308,855.60"
Donations directed by individuals,07/01/2023,Deposit,--,02 GENERAL BANK URESTR,Zelle payment from VITALIY VYKHOVANETS XXXXXXX8270,Contributed income:Donations directed by individuals,CHASE ENDING IN 5315,$20.00,"$3,308,875.60"
PayPal Bank 3,07/01/2023,Deposit,--,04 PAYPAL GENERAL UNRESTR,--,PayPal Bank 3,Donations directed by individuals,$77.20,"$3,308,952.80"
Donations directed by individuals,07/01/2023,Deposit,--,04 PAYPAL GENERAL UNRESTR,--,Contributed income:Donations directed by individuals,PayPal Bank 3,$77.20,"$3,309,030.00"
CHASE ENDING IN 5315,06/30/2023,Deposit,--,02 GENERAL BANK URESTR,Zelle payment from BOHDAN TKACHENKO BACqojfhof47,CHASE ENDING IN 5315,Donations directed by individuals,$60.00,"$3,309,090.00"
Donations directed by individuals,06/30/2023,Deposit,--,02 GENERAL BANK URESTR,Zelle payment from BOHDAN TKACHENKO BACqojfhof47,Contributed income:Donations directed by individuals,CHASE ENDING IN 5315,$60.00,"$3,309,150.00"
In-kind donations,06/30/2023,Journal Entry,8,--,A.BOYCHUK AMAZON WISH LIST,Contributed income:In-kind donations,--,$223.82,"$3,309,373.82"
IN-KIND DONATION DISTRIBUTIONS,06/30/2023,Journal Entry,8,--,A.BOYCHUK AMAZON WISH LIST,PROGRAM EXPENSES:IN-KIND DONATION DISTRIBUTIONS,--,$223.82,"$3,309,597.64"
CHASE ENDING IN 5315,06/29/2023,Expense,--,03 FUNDRASING EVENTS UNRESTR,Zelle payment to Maryna Akatova XXXXXXX8391,CHASE ENDING IN 5315,LODGING,-$754.77,"$3,308,842.87"
LODGING,06/29/2023,Expense,--,03 FUNDRASING EVENTS UNRESTR,Zelle payment to Maryna Akatova XXXXXXX8391,FUNDRAISING EVENTS:LODGING,CHASE ENDING IN 5315,$754.77,"$3,309,597.64"
PayPal Bank 3,06/28/2023,Transfer,--,--,ORIG CO NAME:PAYPAL ORIG ID:PAYPALSDXX DESC DATE:XXXXXX CO ENTRY DESCR:TRANSFER SEC:PPD TRACE#:XXXXXXXXXXXXXXX EED:XX0628 IND ID: IND NAME:DIGNITAS UKRAINE TRN: XXXXXX6831TC,PayPal Bank 3,CHASE ENDING IN 5315,"-$3,000.00","$3,306,597.64"
CHASE ENDING IN 5315,06/28/2023,Transfer,--,--,ORIG CO NAME:PAYPAL ORIG ID:PAYPALSDXX DESC DATE:XXXXXX CO ENTRY DESCR:TRANSFER SEC:PPD TRACE#:XXXXXXXXXXXXXXX EED:XX0628 IND ID: IND NAME:DIGNITAS UKRAINE TRN: XXXXXX6831TC,CHASE ENDING IN 5315,PayPal Bank 3,"$3,000.00","$3,309,597.64"
PayPal Bank 3,06/26/2023,Transfer,--,--,ORIG CO NAME:PAYPAL ORIG ID:PAYPALSDXX DESC DATE:XXXXXX CO ENTRY DESCR:TRANSFER SEC:PPD TRACE#:XXXXXXXXXXXXXXX EED:XX0626 IND ID: IND NAME:DIGNITAS UKRAINE TRN: XXXXXX9521TC,PayPal Bank 3,CHASE ENDING IN 5315,"-$3,000.00","$3,306,597.64"
CHASE ENDING IN 5315,06/26/2023,Transfer,--,--,ORIG CO NAME:PAYPAL ORIG ID:PAYPALSDXX DESC DATE:XXXXXX CO ENTRY DESCR:TRANSFER SEC:PPD TRACE#:XXXXXXXXXXXXXXX EED:XX0626 IND ID: IND NAME:DIGNITAS UKRAINE TRN: XXXXXX9521TC,CHASE ENDING IN 5315,PayPal Bank 3,"$3,000.00","$3,309,597.64"
PayPal Bank 3,06/26/2023,Deposit,--,04 PAYPAL GENERAL UNRESTR,--,PayPal Bank 3,Donations directed by individuals,$58.75,"$3,309,656.39"
Donations directed by individuals,06/26/2023,Deposit,--,04 PAYPAL GENERAL UNRESTR,--,Contributed income:Donations directed by individuals,PayPal Bank 3,$58.75,"$3,309,715.14"
CHASE ENDING IN 5315,06/24/2023,Deposit,--,02 GENERAL BANK URESTR,Zelle payment from LADA BIDIAK XXXXXXX0259,CHASE ENDING IN 5315,Donations directed by individuals,$40.00,"$3,309,755.14"
Donations directed by individuals,06/24/2023,Deposit,--,02 GENERAL BANK URESTR,Zelle payment from LADA BIDIAK XXXXXXX0259,Contributed income:Donations directed by individuals,CHASE ENDING IN 5315,$40.00,"$3,309,795.14"
CHASE ENDING IN 5315,06/24/2023,Deposit,--,02 GENERAL BANK URESTR,Zelle payment from VIKTOR Y OCHKOVSKIY XXXXXXX7752,CHASE ENDING IN 5315,Donations directed by individuals,$500.00,"$3,310,295.14"
Donations directed by individuals,06/24/2023,Deposit,--,02 GENERAL BANK URESTR,Zelle payment from VIKTOR Y OCHKOVSKIY XXXXXXX7752,Contributed income:Donations directed by individuals,CHASE ENDING IN 5315,$500.00,"$3,310,795.14"
CHASE ENDING IN 5315,06/23/2023,Deposit,--,02 GENERAL BANK URESTR,Zelle payment from LADA BIDIAK XXXXXXX6104,CHASE ENDING IN 5315,Donations directed by individuals,$80.00,"$3,310,875.14"
Donations directed by individuals,06/23/2023,Deposit,--,02 GENERAL BANK URESTR,Zelle payment from LADA BIDIAK XXXXXXX6104,Contributed income:Donations directed by individuals,CHASE ENDING IN 5315,$80.00,"$3,310,955.14"
CHASE ENDING IN 5315,06/23/2023,Expense,--,03 FUNDRASING EVENTS UNRESTR,Zelle payment to Mykola Omelchenko JPM999ycchw4,CHASE ENDING IN 5315,TRANSPORTATION AND PARKING,-$589.55,"$3,310,365.59"
TRANSPORTATION AND PARKING,06/23/2023,Expense,--,03 FUNDRASING EVENTS UNRESTR,Zelle payment to Mykola Omelchenko JPM999ycchw4,FUNDRAISING EVENTS:TRANSPORTATION AND PARKING,CHASE ENDING IN 5315,$589.55,"$3,310,955.14"
CHASE ENDING IN 5315,06/21/2023,Deposit,--,03 FUNDRASING EVENTS UNRESTR,DEPOSIT ID NUMBER XX1111,CHASE ENDING IN 5315,Donations directed by individuals,"$3,456.00","$3,314,411.14"
Donations directed by individuals,06/21/2023,Deposit,--,03 FUNDRASING EVENTS UNRESTR,DEPOSIT ID NUMBER XX1111,Contributed income:Donations directed by individuals,CHASE ENDING IN 5315,"$3,456.00","$3,317,867.14"
CHASE ENDING IN 5315,06/21/2023,Expense,--,CHASE BANK,ORIG CO NAME:CHECK OR SUPPLY ORIG ID:XXXXXXXXXX DESC DATE:XXXXXX CO ENTRY DESCR:ORDER SEC:PPD TRACE#:XXXXXXXXXXXXXXX EED:XX0621 IND ID: IND NAME:DIGNITAS UKRAIN E INC TRN: XXXXXX4793TC,CHASE ENDING IN 5315,Supplies & materials,-$20.00,"$3,317,847.14"
Supplies & materials,06/21/2023,Expense,--,CHASE BANK,ORIG CO NAME:CHECK OR SUPPLY ORIG ID:XXXXXXXXXX DESC DATE:XXXXXX CO ENTRY DESCR:ORDER SEC:PPD TRACE#:XXXXXXXXXXXXXXX EED:XX0621 IND ID: IND NAME:DIGNITAS UKRAIN E INC TRN: XXXXXX4793TC,OFFICE/GENERAL ADMINISTRATIVE EXPENSES:Supplies & materials,CHASE ENDING IN 5315,$20.00,"$3,317,867.14"
CHASE ENDING IN 5315,06/18/2023,Deposit,--,02 GENERAL BANK URESTR,Zelle payment from ANATOLIY LYTVYNIV XXXXXXX3468,CHASE ENDING IN 5315,Donations directed by individuals,$200.00,"$3,318,067.14"
Donations directed by individuals,06/18/2023,Deposit,--,02 GENERAL BANK URESTR,Zelle payment from ANATOLIY LYTVYNIV XXXXXXX3468,Contributed income:Donations directed by individuals,CHASE ENDING IN 5315,$200.00,"$3,318,267.14"
CHASE ENDING IN 5315,06/17/2023,Deposit,--,02 GENERAL BANK URESTR,Zelle payment from ANNA MASLOVA XXXXXXX0972,CHASE ENDING IN 5315,Donations directed by individuals,$5.00,"$3,318,272.14"
Donations directed by individuals,06/17/2023,Deposit,--,02 GENERAL BANK URESTR,Zelle payment from ANNA MASLOVA XXXXXXX0972,Contributed income:Donations directed by individuals,CHASE ENDING IN 5315,$5.00,"$3,318,277.14"
CHASE ENDING IN 5315,06/17/2023,Deposit,--,02 GENERAL BANK URESTR,Zelle payment from Mary Shmotolocha COF2W89OWJYB,CHASE ENDING IN 5315,Donations directed by individuals,$100.00,"$3,318,377.14"
Donations directed by individuals,06/17/2023,Deposit,--,02 GENERAL BANK URESTR,Zelle payment from Mary Shmotolocha COF2W89OWJYB,Contributed income:Donations directed by individuals,CHASE ENDING IN 5315,$100.00,"$3,318,477.14"
CHASE ENDING IN 5315,06/17/2023,Deposit,--,02 GENERAL BANK URESTR,Zelle payment from MYKOLA KOLOMIICHUK JXYDXX09b54a,CHASE ENDING IN 5315,Donations directed by individuals,$80.00,"$3,318,557.14"
Donations directed by individuals,06/17/2023,Deposit,--,02 GENERAL BANK URESTR,Zelle payment from MYKOLA KOLOMIICHUK JXYDXX09b54a,Contributed income:Donations directed by individuals,CHASE ENDING IN 5315,$80.00,"$3,318,637.14"
PayPal Bank 3,06/15/2023,Transfer,--,--,ORIG CO NAME:PAYPAL ORIG ID:PAYPALSDXX DESC DATE:XXXXXX CO ENTRY DESCR:TRANSFER SEC:PPD TRACE#:XXXXXXXXXXXXXXX EED:XX0615 IND ID: IND NAME:DIGNITAS UKRAINE TRN: XXXXXX1077TC,PayPal Bank 3,CHASE ENDING IN 5315,"-$5,000.00","$3,313,637.14"
CHASE ENDING IN 5315,06/15/2023,Transfer,--,--,ORIG CO NAME:PAYPAL ORIG ID:PAYPALSDXX DESC DATE:XXXXXX CO ENTRY DESCR:TRANSFER SEC:PPD TRACE#:XXXXXXXXXXXXXXX EED:XX0615 IND ID: IND NAME:DIGNITAS UKRAINE TRN: XXXXXX1077TC,CHASE ENDING IN 5315,PayPal Bank 3,"$5,000.00","$3,318,637.14"
CHASE ENDING IN 5315,06/14/2023,Check,5160,COLLEGIATE PRODUCTIONS,CHECK # XXXX 06/14,CHASE ENDING IN 5315,SUPPLIES AND MATERIALS,"-$2,288.80","$3,316,348.34"
SUPPLIES AND MATERIALS,06/14/2023,Check,5160,COLLEGIATE PRODUCTIONS,CHECK # XXXX 06/14,FUNDRAISING EVENTS:SUPPLIES AND MATERIALS,CHASE ENDING IN 5315,"$2,288.80","$3,318,637.14"
CHASE ENDING IN 5315,06/14/2023,Deposit,--,05 VENMO UNRESTR,ORIG CO NAME:VENMO ORIG ID:XXXXXXXXXX DESC DATE:XXXXXX CO ENTRY DESCR:CASHOUT SEC:PPD TRACE#:XXXXXXXXXXXXXXX EED:XXXXX4 IND ID: IND NAME:OKSANA PATRINA TRN: 165 XXX0408TC,CHASE ENDING IN 5315,Donations directed by individuals,$98.00,"$3,318,735.14"
Donations directed by individuals,06/14/2023,Deposit,--,05 VENMO UNRESTR,ORIG CO NAME:VENMO ORIG ID:XXXXXXXXXX DESC DATE:XXXXXX CO ENTRY DESCR:CASHOUT SEC:PPD TRACE#:XXXXXXXXXXXXXXX EED:XXXXX4 IND ID: IND NAME:OKSANA PATRINA TRN: 165 XXX0408TC,Contributed income:Donations directed by individuals,CHASE ENDING IN 5315,$98.00,"$3,318,833.14"
CHASE ENDING IN 5315,06/12/2023,Expense,--,03 FUNDRASING EVENTS UNRESTR,Zelle payment to Yuliya O'Connell XXXXXXX5387,CHASE ENDING IN 5315,--,"-$1,081.06","$3,317,752.08"
SUPPLIES AND MATERIALS,06/12/2023,Expense,--,03 FUNDRASING EVENTS UNRESTR,Zelle payment to Yuliya O'Connell XXXXXXX5387,FUNDRAISING EVENTS:SUPPLIES AND MATERIALS,CHASE ENDING IN 5315,$489.66,"$3,318,241.74"
TRANSPORTATION AND PARKING,06/12/2023,Expense,--,03 FUNDRASING EVENTS UNRESTR,Mykola Omelchenko St George plane tickets,FUNDRAISING EVENTS:TRANSPORTATION AND PARKING,CHASE ENDING IN 5315,$341.40,"$3,318,583.14"
EVENTS PARTICIPATION EXPENSES,06/12/2023,Expense,--,03 FUNDRASING EVENTS UNRESTR,St George table,FUNDRAISING EVENTS:EVENTS PARTICIPATION EXPENSES,CHASE ENDING IN 5315,$250.00,"$3,318,833.14"
CHASE ENDING IN 5315,06/10/2023,Deposit,--,02 GENERAL BANK URESTR,Zelle payment from MARIANNE EPSTEIN BACf075la3ac,CHASE ENDING IN 5315,Donations directed by individuals,$170.00,"$3,319,003.14"
Donations directed by individuals,06/10/2023,Deposit,--,02 GENERAL BANK URESTR,Zelle payment from MARIANNE EPSTEIN BACf075la3ac,Contributed income:Donations directed by individuals,CHASE ENDING IN 5315,$170.00,"$3,319,173.14"
PayPal Bank 3,06/09/2023,Transfer,--,--,ORIG CO NAME:PAYPAL ORIG ID:PAYPALSDXX DESC DATE:XXXXXX CO ENTRY DESCR:TRANSFER SEC:PPD TRACE#:XXXXXXXXXXXXXXX EED:XX0609 IND ID: IND NAME:DIGNITAS UKRAINE TRN: XXXXXX3859TC,PayPal Bank 3,CHASE ENDING IN 5315,"-$1,000.00","$3,318,173.14"
CHASE ENDING IN 5315,06/09/2023,Transfer,--,--,ORIG CO NAME:PAYPAL ORIG ID:PAYPALSDXX DESC DATE:XXXXXX CO ENTRY DESCR:TRANSFER SEC:PPD TRACE#:XXXXXXXXXXXXXXX EED:XX0609 IND ID: IND NAME:DIGNITAS UKRAINE TRN: XXXXXX3859TC,CHASE ENDING IN 5315,PayPal Bank 3,"$1,000.00","$3,319,173.14"
CHASE ENDING IN 5315,06/07/2023,Deposit,--,02 GENERAL BANK URESTR,Zelle payment from IRINA ZAKHALYAVKO XXXXXXX1558,CHASE ENDING IN 5315,Donations directed by individuals,$100.00,"$3,319,273.14"
Donations directed by individuals,06/07/2023,Deposit,--,02 GENERAL BANK URESTR,Zelle payment from IRINA ZAKHALYAVKO XXXXXXX1558,Contributed income:Donations directed by individuals,CHASE ENDING IN 5315,$100.00,"$3,319,373.14"
CHASE ENDING IN 5315,06/07/2023,Expense,--,03 FUNDRASING EVENTS UNRESTR,Zelle payment to Alexander Belokowsky JPMX99xnlt81,CHASE ENDING IN 5315,SUPPLIES AND MATERIALS,-$49.06,"$3,319,324.08"
SUPPLIES AND MATERIALS,06/07/2023,Expense,--,03 FUNDRASING EVENTS UNRESTR,Zelle payment to Alexander Belokowsky JPMX99xnlt81,FUNDRAISING EVENTS:SUPPLIES AND MATERIALS,CHASE ENDING IN 5315,$49.06,"$3,319,373.14"
PayPal Bank 3,06/06/2023,Transfer,--,--,ORIG CO NAME:PAYPAL ORIG ID:PAYPALSDXX DESC DATE:XXXXXX CO ENTRY DESCR:TRANSFER SEC:PPD TRACE#:XXXXXXXXXXXXXXX EED:XX0606 IND ID: IND NAME:DIGNITAS UKRAINE TRN: XXXXXX4004TC,PayPal Bank 3,CHASE ENDING IN 5315,"-$2,000.00","$3,317,373.14"
CHASE ENDING IN 5315,06/06/2023,Transfer,--,--,ORIG CO NAME:PAYPAL ORIG ID:PAYPALSDXX DESC DATE:XXXXXX CO ENTRY DESCR:TRANSFER SEC:PPD TRACE#:XXXXXXXXXXXXXXX EED:XX0606 IND ID: IND NAME:DIGNITAS UKRAINE TRN: XXXXXX4004TC,CHASE ENDING IN 5315,PayPal Bank 3,"$2,000.00","$3,319,373.14"
CHASE ENDING IN 5315,06/06/2023,Deposit,--,03 FUNDRASING EVENTS UNRESTR,DEPOSIT ID NUMBER XX1332,CHASE ENDING IN 5315,Donations directed by individuals,$637.00,"$3,320,010.14"
Donations directed by individuals,06/06/2023,Deposit,--,03 FUNDRASING EVENTS UNRESTR,DEPOSIT ID NUMBER XX1332,Contributed income:Donations directed by individuals,CHASE ENDING IN 5315,$637.00,"$3,320,647.14"
CHASE ENDING IN 5315,06/06/2023,Expense,--,03 FUNDRASING EVENTS UNRESTR,Zelle payment to Alexander Belokowsky JPM999xkswhs,CHASE ENDING IN 5315,SUPPLIES AND MATERIALS,"-$1,000.00","$3,319,647.14"
SUPPLIES AND MATERIALS,06/06/2023,Expense,--,03 FUNDRASING EVENTS UNRESTR,Zelle payment to Alexander Belokowsky JPM999xkswhs,FUNDRAISING EVENTS:SUPPLIES AND MATERIALS,CHASE ENDING IN 5315,"$1,000.00","$3,320,647.14"
CHASE ENDING IN 5315,06/05/2023,Expense,--,03 FUNDRASING EVENTS UNRESTR,Zelle payment to Maryna Akatova XXXXXXX6501,CHASE ENDING IN 5315,SUPPLIES AND MATERIALS,-$411.57,"$3,320,235.57"
SUPPLIES AND MATERIALS,06/05/2023,Expense,--,03 FUNDRASING EVENTS UNRESTR,Zelle payment to Maryna Akatova XXXXXXX6501,FUNDRAISING EVENTS:SUPPLIES AND MATERIALS,CHASE ENDING IN 5315,$411.57,"$3,320,647.14"
CHASE ENDING IN 5315,06/05/2023,Expense,--,03 FUNDRASING EVENTS UNRESTR,Zelle payment to Alexander Belokowsky JPM999xkphrv,CHASE ENDING IN 5315,SUPPLIES AND MATERIALS,-$999.00,"$3,319,648.14"
SUPPLIES AND MATERIALS,06/05/2023,Expense,--,03 FUNDRASING EVENTS UNRESTR,Zelle payment to Alexander Belokowsky JPM999xkphrv,FUNDRAISING EVENTS:SUPPLIES AND MATERIALS,CHASE ENDING IN 5315,$999.00,"$3,320,647.14"
CHASE ENDING IN 5315,06/05/2023,Deposit,--,06 SQUARE UNRESTR,ORIG CO NAME:Square Inc ORIG ID:XXXXXXXXXX DESC DATE:XXXXXX CO ENTRY DESCR:XXXXXXPX SEC:CCD TRACE#:XXXXXXXXXXXXXXX EED:XXXXXX IND ID:LXXXXX5450 IND NAME:Dignita s Ukraine Inc LXXXXX TRN: XXXXXX3064TC,CHASE ENDING IN 5315,Donations directed by individuals,$5.64,"$3,320,652.78"
Donations directed by individuals,06/05/2023,Deposit,--,06 SQUARE UNRESTR,ORIG CO NAME:Square Inc ORIG ID:XXXXXXXXXX DESC DATE:XXXXXX CO ENTRY DESCR:XXXXXXPX SEC:CCD TRACE#:XXXXXXXXXXXXXXX EED:XXXXXX IND ID:LXXXXX5450 IND NAME:Dignita s Ukraine Inc LXXXXX TRN: XXXXXX3064TC,Contributed income:Donations directed by individuals,CHASE ENDING IN 5315,$5.64,"$3,320,658.42"
CHASE ENDING IN 5315,06/04/2023,Expense,--,03 FUNDRASING EVENTS UNRESTR,Zelle payment to Mykola Omelchenko JPM999xj5zdj,CHASE ENDING IN 5315,TRANSPORTATION AND PARKING,-$60.00,"$3,320,598.42"
TRANSPORTATION AND PARKING,06/04/2023,Expense,--,03 FUNDRASING EVENTS UNRESTR,Zelle payment to Mykola Omelchenko JPM999xj5zdj,FUNDRAISING EVENTS:TRANSPORTATION AND PARKING,CHASE ENDING IN 5315,$60.00,"$3,320,658.42"
CHASE ENDING IN 5315,06/04/2023,Expense,--,03 FUNDRASING EVENTS UNRESTR,Zelle payment to Volodymyr Zatulyviter JPM999xj7wtp,CHASE ENDING IN 5315,TRANSPORTATION AND PARKING,-$91.54,"$3,320,566.88"
TRANSPORTATION AND PARKING,06/04/2023,Expense,--,03 FUNDRASING EVENTS UNRESTR,Zelle payment to Volodymyr Zatulyviter JPM999xj7wtp,FUNDRAISING EVENTS:TRANSPORTATION AND PARKING,CHASE ENDING IN 5315,$91.54,"$3,320,658.42"
CHASE ENDING IN 5315,06/04/2023,Expense,--,02 GENERAL BANK URESTR,Zelle payment to Alexander Belokowsky JPMXX9xj66x4,CHASE ENDING IN 5315,SUPPLIES AND MATERIALS,-$1.00,"$3,320,657.42"
SUPPLIES AND MATERIALS,06/04/2023,Expense,--,02 GENERAL BANK URESTR,Zelle payment to Alexander Belokowsky JPMXX9xj66x4,FUNDRAISING EVENTS:SUPPLIES AND MATERIALS,CHASE ENDING IN 5315,$1.00,"$3,320,658.42"
CHASE ENDING IN 5315,06/03/2023,Deposit,--,02 GENERAL BANK URESTR,Zelle payment from MAKSIM CHUGUNOV BACmi1wwjwv9,CHASE ENDING IN 5315,Donations directed by individuals,$40.00,"$3,320,698.42"
Donations directed by individuals,06/03/2023,Deposit,--,02 GENERAL BANK URESTR,Zelle payment from MAKSIM CHUGUNOV BACmi1wwjwv9,Contributed income:Donations directed by individuals,CHASE ENDING IN 5315,$40.00,"$3,320,738.42"
CHASE ENDING IN 5315,05/31/2023,Expense,--,CHASE BANK,MONTHLY SERVICE FEE,CHASE ENDING IN 5315,Bank fees & service charges,-$15.00,"$3,320,723.42"
Bank fees & service charges,05/31/2023,Expense,--,CHASE BANK,MONTHLY SERVICE FEE,OFFICE/GENERAL ADMINISTRATIVE EXPENSES:Bank fees & service charges,CHASE ENDING IN 5315,$15.00,"$3,320,738.42"
CHASE ENDING IN 5315,05/31/2023,Deposit,--,05 VENMO UNRESTR,ORIG CO NAME:VENMO ORIG ID:XXXXXXXXXX DESC DATE:XXXXXX CO ENTRY DESCR:CASHOUT SEC:PPD TRACE#:XXXXXXXXXXXXXXX EED:XXXXX1 IND ID: IND NAME:OKSANA PATRINA TRN: 151 XXX8775TC,CHASE ENDING IN 5315,Donations directed by individuals,$230.54,"$3,320,968.96"
Donations directed by individuals,05/31/2023,Deposit,--,05 VENMO UNRESTR,ORIG CO NAME:VENMO ORIG ID:XXXXXXXXXX DESC DATE:XXXXXX CO ENTRY DESCR:CASHOUT SEC:PPD TRACE#:XXXXXXXXXXXXXXX EED:XXXXX1 IND ID: IND NAME:OKSANA PATRINA TRN: 151 XXX8775TC,Contributed income:Donations directed by individuals,CHASE ENDING IN 5315,$230.54,"$3,321,199.50"
In-kind donations,05/31/2023,Journal Entry,7,--,A.BOYCHUK AMAZON WISH LIST,Contributed income:In-kind donations,--,$232.82,"$3,321,432.32"
IN-KIND DONATION DISTRIBUTIONS,05/31/2023,Journal Entry,7,--,A.BOYCHUK AMAZON WISH LIST,PROGRAM EXPENSES:IN-KIND DONATION DISTRIBUTIONS,--,$232.82,"$3,321,665.14"
CHASE ENDING IN 5315,05/30/2023,Deposit,--,05 VENMO UNRESTR,ORIG CO NAME:VENMO ORIG ID:XXXXXXXXXX DESC DATE:XXXXXX CO ENTRY DESCR:ACCTVERIFYSEC:PPD TRACE#:XXXXXXXXXXXXXXX EED:XXX530 IND ID: IND NAME:OKSANA PATRINA TRN: 1 XXXXX1939TC,CHASE ENDING IN 5315,Donations directed by individuals,$0.16,"$3,321,665.30"
Donations directed by individuals,05/30/2023,Deposit,--,05 VENMO UNRESTR,ORIG CO NAME:VENMO ORIG ID:XXXXXXXXXX DESC DATE:XXXXXX CO ENTRY DESCR:ACCTVERIFYSEC:PPD TRACE#:XXXXXXXXXXXXXXX EED:XXX530 IND ID: IND NAME:OKSANA PATRINA TRN: 1 XXXXX1939TC,Contributed income:Donations directed by individuals,CHASE ENDING IN 5315,$0.16,"$3,321,665.46"
CHASE ENDING IN 5315,05/30/2023,Deposit,--,05 VENMO UNRESTR,ORIG CO NAME:VENMO ORIG ID:XXXXXXXXXX DESC DATE:XXXXXX CO ENTRY DESCR:ACCTVERIFYSEC:PPD TRACE#:XXXXXXXXXXXXXXX EED:XXX530 IND ID: IND NAME:OKSANA PATRINA TRN: 1 XXXXX1940TC,CHASE ENDING IN 5315,Donations directed by individuals,$0.21,"$3,321,665.67"
Donations directed by individuals,05/30/2023,Deposit,--,05 VENMO UNRESTR,ORIG CO NAME:VENMO ORIG ID:XXXXXXXXXX DESC DATE:XXXXXX CO ENTRY DESCR:ACCTVERIFYSEC:PPD TRACE#:XXXXXXXXXXXXXXX EED:XXX530 IND ID: IND NAME:OKSANA PATRINA TRN: 1 XXXXX1940TC,Contributed income:Donations directed by individuals,CHASE ENDING IN 5315,$0.21,"$3,321,665.88"
CHASE ENDING IN 5315,05/30/2023,Expense,--,CHASE BANK,ORIG CO NAME:VENMO ORIG ID:XXXXXXXXXX DESC DATE:XXXXXX CO ENTRY DESCR:ACCTVERIFYSEC:WEB TRACE#:XXXXXXXXXXXXXXX EED:XXXXXX IND ID:XXXXXXXXX7632 IND NAME:OKSANA P ATRINA TRN: XXXXXX3008TC,CHASE ENDING IN 5315,Bank fees & service charges,-$0.21,"$3,321,665.67"
Bank fees & service charges,05/30/2023,Expense,--,CHASE BANK,ORIG CO NAME:VENMO ORIG ID:XXXXXXXXXX DESC DATE:XXXXXX CO ENTRY DESCR:ACCTVERIFYSEC:WEB TRACE#:XXXXXXXXXXXXXXX EED:XXXXXX IND ID:XXXXXXXXX7632 IND NAME:OKSANA P ATRINA TRN: XXXXXX3008TC,OFFICE/GENERAL ADMINISTRATIVE EXPENSES:Bank fees & service charges,CHASE ENDING IN 5315,$0.21,"$3,321,665.88"
CHASE ENDING IN 5315,05/30/2023,Expense,--,CHASE BANK,ORIG CO NAME:VENMO ORIG ID:XXXXXXXXXX DESC DATE:XXXXXX CO ENTRY DESCR:ACCTVERIFYSEC:WEB TRACE#:XXXXXXXXXXXXXXX EED:XXXXXX IND ID:XXXXXXXXX7513 IND NAME:OKSANA P ATRINA TRN: XXXXXX3007TC,CHASE ENDING IN 5315,Bank fees & service charges,-$0.16,"$3,321,665.72"
Bank fees & service charges,05/30/2023,Expense,--,CHASE BANK,ORIG CO NAME:VENMO ORIG ID:XXXXXXXXXX DESC DATE:XXXXXX CO ENTRY DESCR:ACCTVERIFYSEC:WEB TRACE#:XXXXXXXXXXXXXXX EED:XXXXXX IND ID:XXXXXXXXX7513 IND NAME:OKSANA P ATRINA TRN: XXXXXX3007TC,OFFICE/GENERAL ADMINISTRATIVE EXPENSES:Bank fees & service charges,CHASE ENDING IN 5315,$0.16,"$3,321,665.88"
CHASE ENDING IN 5315,05/30/2023,Expense,--,06 SQUARE UNRESTR,ORIG CO NAME:Square Inc ORIG ID:XXXXXXXXXX DESC DATE:XXXXXX CO ENTRY DESCR:ACCTVERIFYSEC:CCD TRACE#:XXXXXXXXXXXXXXX EED:XXXXXX IND ID:T3RCW8MRD5SMKB9 IND NAME:D ignitas Ukraine Inc TXXXXXXX TRN: XXXXXX1024TC,CHASE ENDING IN 5315,Bank fees & service charges,-$0.01,"$3,321,665.87"
Bank fees & service charges,05/30/2023,Expense,--,06 SQUARE UNRESTR,ORIG CO NAME:Square Inc ORIG ID:XXXXXXXXXX DESC DATE:XXXXXX CO ENTRY DESCR:ACCTVERIFYSEC:CCD TRACE#:XXXXXXXXXXXXXXX EED:XXXXXX IND ID:T3RCW8MRD5SMKB9 IND NAME:D ignitas Ukraine Inc TXXXXXXX TRN: XXXXXX1024TC,OFFICE/GENERAL ADMINISTRATIVE EXPENSES:Bank fees & service charges,CHASE ENDING IN 5315,$0.01,"$3,321,665.88"
CHASE ENDING IN 5315,05/30/2023,Deposit,--,01 ADMINISTRATIVE ACCOUNT,ORIG CO NAME:Square Inc ORIG ID:XXXXXXXXXX DESC DATE:XXXXXX CO ENTRY DESCR:ACCTVERIFYSEC:CCD TRACE#:XXXXXXXXXXXXXXX EED:XXXXX0 IND ID:T32CTMHPD9ACHCH IND NAME:D ignitas Ukraine Inc TXXXXXXX TRN: XXXXXX1015TC,CHASE ENDING IN 5315,Bank fees & service charges,$0.01,"$3,321,665.89"
Bank fees & service charges,05/30/2023,Deposit,--,01 ADMINISTRATIVE ACCOUNT,ORIG CO NAME:Square Inc ORIG ID:XXXXXXXXXX DESC DATE:XXXXXX CO ENTRY DESCR:ACCTVERIFYSEC:CCD TRACE#:XXXXXXXXXXXXXXX EED:XXXXX0 IND ID:T32CTMHPD9ACHCH IND NAME:D ignitas Ukraine Inc TXXXXXXX TRN: XXXXXX1015TC,OFFICE/GENERAL ADMINISTRATIVE EXPENSES:Bank fees & service charges,CHASE ENDING IN 5315,-$0.01,"$3,321,665.88"
PayPal Bank 3,05/29/2023,Deposit,8NF06978J69707036,04 PAYPAL GENERAL UNRESTR,"Transaction ID: 8NF06978J69707036
https://www.paypal.com/activity/payment/8NF06978J69707036",PayPal Bank 3,Donations directed by individuals,$0.97,"$3,321,666.85"
Donations directed by individuals,05/29/2023,Deposit,8NF06978J69707036,04 PAYPAL GENERAL UNRESTR,Money in to PayPal,Contributed income:Donations directed by individuals,PayPal Bank 3,$0.97,"$3,321,667.82"
CHASE ENDING IN 5315,05/27/2023,Deposit,--,02 GENERAL BANK URESTR,Zelle payment from ELLEN BEDENKO WFCT0R7NXZ2Z,CHASE ENDING IN 5315,Donations directed by individuals,$40.00,"$3,321,707.82"
Donations directed by individuals,05/27/2023,Deposit,--,02 GENERAL BANK URESTR,Zelle payment from ELLEN BEDENKO WFCT0R7NXZ2Z,Contributed income:Donations directed by individuals,CHASE ENDING IN 5315,$40.00,"$3,321,747.82"
CHASE ENDING IN 5315,05/27/2023,Deposit,--,02 GENERAL BANK URESTR,Zelle payment from OLEKSIY VARFOLOMIYEV BACbpfrtgzq8,CHASE ENDING IN 5315,Donations directed by individuals,$20.00,"$3,321,767.82"
Donations directed by individuals,05/27/2023,Deposit,--,02 GENERAL BANK URESTR,Zelle payment from OLEKSIY VARFOLOMIYEV BACbpfrtgzq8,Contributed income:Donations directed by individuals,CHASE ENDING IN 5315,$20.00,"$3,321,787.82"
CHASE ENDING IN 5315,05/27/2023,Deposit,--,02 GENERAL BANK URESTR,DEPOSIT ID NUMBER XX2213,CHASE ENDING IN 5315,Donations directed by individuals,$300.00,"$3,322,087.82"
Donations directed by individuals,05/27/2023,Deposit,--,02 GENERAL BANK URESTR,DEPOSIT ID NUMBER XX2213,Contributed income:Donations directed by individuals,CHASE ENDING IN 5315,$300.00,"$3,322,387.82"
PayPal Bank 3,05/24/2023,Transfer,--,--,ORIG CO NAME:PAYPAL ORIG ID:PAYPALSDXX DESC DATE:XXXXXX CO ENTRY DESCR:TRANSFER SEC:PPD TRACE#:XXXXXXXXXXXXXXX EED:XX0524 IND ID: IND NAME:DIGNITAS UKRAINE TRN: XXXXXX6560TC,PayPal Bank 3,CHASE ENDING IN 5315,"-$1,700.00","$3,320,687.82"
CHASE ENDING IN 5315,05/24/2023,Transfer,--,--,ORIG CO NAME:PAYPAL ORIG ID:PAYPALSDXX DESC DATE:XXXXXX CO ENTRY DESCR:TRANSFER SEC:PPD TRACE#:XXXXXXXXXXXXXXX EED:XX0524 IND ID: IND NAME:DIGNITAS UKRAINE TRN: XXXXXX6560TC,CHASE ENDING IN 5315,PayPal Bank 3,"$1,700.00","$3,322,387.82"
PayPal Bank 3,05/22/2023,Transfer,--,--,ORIG CO NAME:PAYPAL ORIG ID:PAYPALSDXX DESC DATE:XXXXXX CO ENTRY DESCR:TRANSFER SEC:PPD TRACE#:XXXXXXXXXXXXXXX EED:XX0522 IND ID: IND NAME:DIGNITAS UKRAINE TRN: XXXXXX0460TC,PayPal Bank 3,CHASE ENDING IN 5315,"-$2,300.00","$3,320,087.82"
CHASE ENDING IN 5315,05/22/2023,Transfer,--,--,ORIG CO NAME:PAYPAL ORIG ID:PAYPALSDXX DESC DATE:XXXXXX CO ENTRY DESCR:TRANSFER SEC:PPD TRACE#:XXXXXXXXXXXXXXX EED:XX0522 IND ID: IND NAME:DIGNITAS UKRAINE TRN: XXXXXX0460TC,CHASE ENDING IN 5315,PayPal Bank 3,"$2,300.00","$3,322,387.82"
CHASE ENDING IN 5315,05/22/2023,Deposit,--,03 FUNDRASING EVENTS UNRESTR,DEPOSIT ID NUMBER XX9896,CHASE ENDING IN 5315,Donations directed by individuals,"$3,673.00","$3,326,060.82"
Donations directed by individuals,05/22/2023,Deposit,--,03 FUNDRASING EVENTS UNRESTR,DEPOSIT ID NUMBER XX9896,Contributed income:Donations directed by individuals,CHASE ENDING IN 5315,"$3,673.00","$3,329,733.82"
CHASE ENDING IN 5315,05/22/2023,Deposit,--,03 FUNDRASING EVENTS UNRESTR,CASH DEPOSIT CREDIT ADJUSTMENT,CHASE ENDING IN 5315,Donations directed by individuals,$11.00,"$3,329,744.82"
Donations directed by individuals,05/22/2023,Deposit,--,03 FUNDRASING EVENTS UNRESTR,CASH DEPOSIT CREDIT ADJUSTMENT,Contributed income:Donations directed by individuals,CHASE ENDING IN 5315,$11.00,"$3,329,755.82"
CHASE ENDING IN 5315,05/22/2023,Deposit,--,02 GENERAL BANK URESTR,Zelle payment from XIAOHUI BI BACnru6x46qp,CHASE ENDING IN 5315,Donations directed by individuals,"$1,700.00","$3,331,455.82"
Donations directed by individuals,05/22/2023,Deposit,--,02 GENERAL BANK URESTR,Zelle payment from XIAOHUI BI BACnru6x46qp,Contributed income:Donations directed by individuals,CHASE ENDING IN 5315,"$1,700.00","$3,333,155.82"
CHASE ENDING IN 5315,05/21/2023,Deposit,--,02 GENERAL BANK URESTR,Zelle payment from GFLS SHYBENO LLC XXXXXXX6831,CHASE ENDING IN 5315,Donations directed by individuals,$15.00,"$3,333,170.82"
Donations directed by individuals,05/21/2023,Deposit,--,02 GENERAL BANK URESTR,Zelle payment from GFLS SHYBENO LLC XXXXXXX6831,Contributed income:Donations directed by individuals,CHASE ENDING IN 5315,$15.00,"$3,333,185.82"
CHASE ENDING IN 5315,05/21/2023,Deposit,--,02 GENERAL BANK URESTR,Zelle payment from OLENA PAZDERSKA XXXXXXX5215,CHASE ENDING IN 5315,Donations directed by individuals,$60.00,"$3,333,245.82"
Donations directed by individuals,05/21/2023,Deposit,--,02 GENERAL BANK URESTR,Zelle payment from OLENA PAZDERSKA XXXXXXX5215,Contributed income:Donations directed by individuals,CHASE ENDING IN 5315,$60.00,"$3,333,305.82"
CHASE ENDING IN 5315,05/21/2023,Deposit,--,02 GENERAL BANK URESTR,Zelle payment from PAVLO MILESHCHENKO XXXXXXX8405,CHASE ENDING IN 5315,Donations directed by individuals,$350.00,"$3,333,655.82"
Donations directed by individuals,05/21/2023,Deposit,--,02 GENERAL BANK URESTR,Zelle payment from PAVLO MILESHCHENKO XXXXXXX8405,Contributed income:Donations directed by individuals,CHASE ENDING IN 5315,$350.00,"$3,334,005.82"
CHASE ENDING IN 5315,05/20/2023,Deposit,--,02 GENERAL BANK URESTR,Zelle payment from INNA COLLINS WFCT0R8WDM76,CHASE ENDING IN 5315,Donations directed by individuals,$40.00,"$3,334,045.82"
Donations directed by individuals,05/20/2023,Deposit,--,02 GENERAL BANK URESTR,Zelle payment from INNA COLLINS WFCT0R8WDM76,Contributed income:Donations directed by individuals,CHASE ENDING IN 5315,$40.00,"$3,334,085.82"
CHASE ENDING IN 5315,05/20/2023,Deposit,--,02 GENERAL BANK URESTR,Zelle payment from OKSANA PATRINA XXXXXXX8796,CHASE ENDING IN 5315,Donations directed by individuals,$200.00,"$3,334,285.82"
Donations directed by individuals,05/20/2023,Deposit,--,02 GENERAL BANK URESTR,Zelle payment from OKSANA PATRINA XXXXXXX8796,Contributed income:Donations directed by individuals,CHASE ENDING IN 5315,$200.00,"$3,334,485.82"
CHASE ENDING IN 5315,05/20/2023,Deposit,--,02 GENERAL BANK URESTR,Zelle payment from PAUL CONROY USAOIHMAVJNR,CHASE ENDING IN 5315,Donations directed by individuals,$30.00,"$3,334,515.82"
Donations directed by individuals,05/20/2023,Deposit,--,02 GENERAL BANK URESTR,Zelle payment from PAUL CONROY USAOIHMAVJNR,Contributed income:Donations directed by individuals,CHASE ENDING IN 5315,$30.00,"$3,334,545.82"
CHASE ENDING IN 5315,05/18/2023,Deposit,--,02 GENERAL BANK URESTR,ORIG CO NAME:GOOGLE ORIG ID:XXXXXXXXXX DESC DATE: CO ENTRY DESCR:ACCTVERIFYSEC:CCD TRACE#:XXXXXXXXXXXXXXX EED:XXXXXX IND ID:US003ULP5Y IND NAME:Dignitas Ukraine Inc XXXXXXXXX CREDIT TRN: XXXXXX9222TC,CHASE ENDING IN 5315,Donations directed by individuals,$0.07,"$3,334,545.89"
Donations directed by individuals,05/18/2023,Deposit,--,02 GENERAL BANK URESTR,ORIG CO NAME:GOOGLE ORIG ID:XXXXXXXXXX DESC DATE: CO ENTRY DESCR:ACCTVERIFYSEC:CCD TRACE#:XXXXXXXXXXXXXXX EED:XXXXXX IND ID:US003ULP5Y IND NAME:Dignitas Ukraine Inc XXXXXXXXX CREDIT TRN: XXXXXX9222TC,Contributed income:Donations directed by individuals,CHASE ENDING IN 5315,$0.07,"$3,334,545.96"
CHASE ENDING IN 5315,05/10/2023,Deposit,--,02 GENERAL BANK URESTR,Zelle payment from IRINA ZAKHALYAVKO XXXXXXX1558,CHASE ENDING IN 5315,Donations directed by individuals,$4.00,"$3,334,549.96"
Donations directed by individuals,05/10/2023,Deposit,--,02 GENERAL BANK URESTR,Zelle payment from IRINA ZAKHALYAVKO XXXXXXX1558,Contributed income:Donations directed by individuals,CHASE ENDING IN 5315,$4.00,"$3,334,553.96"
PayPal Bank 3,05/09/2023,Expense,5FE81103FS5404438,PAY PALL UNRESTRICTED,"Transaction ID: 5FE81103FS5404438
https://www.paypal.com/activity/payment/5FE81103FS5404438",PayPal Bank 3,Donations directed by individuals,-$0.97,"$3,334,552.99"
Donations directed by individuals,05/09/2023,Expense,5FE81103FS5404438,PAY PALL UNRESTRICTED,Paid to Payment hold,Contributed income:Donations directed by individuals,PayPal Bank 3,-$0.97,"$3,334,552.02"
CHASE ENDING IN 5315,05/05/2023,Deposit,--,02 GENERAL BANK URESTR,Zelle payment from IRINA ZAKHALYAVKO XXXXXXX1558,CHASE ENDING IN 5315,Donations directed by individuals,$175.00,"$3,334,727.02"
Donations directed by individuals,05/05/2023,Deposit,--,02 GENERAL BANK URESTR,Zelle payment from IRINA ZAKHALYAVKO XXXXXXX1558,Contributed income:Donations directed by individuals,CHASE ENDING IN 5315,$175.00,"$3,334,902.02"
CHASE ENDING IN 5315,05/03/2023,Deposit,--,02 GENERAL BANK URESTR,Zelle payment from ELLEN BEDENKO WFCT0R7NXZ2Z,CHASE ENDING IN 5315,Donations directed by individuals,$2.00,"$3,334,904.02"
Donations directed by individuals,05/03/2023,Deposit,--,02 GENERAL BANK URESTR,Zelle payment from ELLEN BEDENKO WFCT0R7NXZ2Z,Contributed income:Donations directed by individuals,CHASE ENDING IN 5315,$2.00,"$3,334,906.02"
CHASE ENDING IN 5315,05/03/2023,Deposit,--,02 GENERAL BANK URESTR,Zelle payment from IRINA ZAKHALYAVKO XXXXXXX1558,CHASE ENDING IN 5315,Donations directed by individuals,$5.00,"$3,334,911.02"
Donations directed by individuals,05/03/2023,Deposit,--,02 GENERAL BANK URESTR,Zelle payment from IRINA ZAKHALYAVKO XXXXXXX1558,Contributed income:Donations directed by individuals,CHASE ENDING IN 5315,$5.00,"$3,334,916.02"
CHASE ENDING IN 5315,05/03/2023,Expense,--,02 GENERAL BANK URESTR,Zelle payment to Ellen Bedenko JPMX99w4p9tv,CHASE ENDING IN 5315,Donations directed by individuals,-$1.00,"$3,334,915.02"
Donations directed by individuals,05/03/2023,Expense,--,02 GENERAL BANK URESTR,Zelle payment to Ellen Bedenko JPMX99w4p9tv,Contributed income:Donations directed by individuals,CHASE ENDING IN 5315,-$1.00,"$3,334,914.02"
In-kind donations,04/30/2023,Journal Entry,6,--,A.BOYCHUK AMAZON WISH LIST,Contributed income:In-kind donations,--,$199.92,"$3,335,113.94"
IN-KIND DONATION DISTRIBUTIONS,04/30/2023,Journal Entry,6,--,A.BOYCHUK AMAZON WISH LIST,PROGRAM EXPENSES:IN-KIND DONATION DISTRIBUTIONS,--,$199.92,"$3,335,313.86"
CHASE ENDING IN 5315,04/20/2023,Deposit,--,--,Opening Balance from Bank,CHASE ENDING IN 5315,Opening balance equity,$0.00,"$3,335,313.86"
Opening balance equity,04/20/2023,Deposit,--,--,--,Opening balance equity,CHASE ENDING IN 5315,$0.00,"$3,335,313.86"
CHASE ENDING IN 5315,04/20/2023,Deposit,--,02 GENERAL BANK URESTR,DEPOSIT ID NUMBER XX8615 DIMA,CHASE ENDING IN 5315,Donations directed by individuals,$25.00,"$3,335,338.86"
Donations directed by individuals,04/20/2023,Deposit,--,02 GENERAL BANK URESTR,DEPOSIT ID NUMBER XX8615 DIMA,Contributed income:Donations directed by individuals,CHASE ENDING IN 5315,$25.00,"$3,335,363.86"
In-kind donations,03/31/2023,Journal Entry,5,--,A.BOYCHUK AMAZON WISH LIST,Contributed income:In-kind donations,--,$91.63,"$3,335,455.49"
IN-KIND DONATION DISTRIBUTIONS,03/31/2023,Journal Entry,5,--,A.BOYCHUK AMAZON WISH LIST,PROGRAM EXPENSES:IN-KIND DONATION DISTRIBUTIONS,--,$91.63,"$3,335,547.12"
In-kind donations,02/28/2023,Journal Entry,4,--,A.BOYCHUK AMAZON WISH LIST,Contributed income:In-kind donations,--,$231.33,"$3,335,778.45"
IN-KIND DONATION DISTRIBUTIONS,02/28/2023,Journal Entry,4,--,A.BOYCHUK AMAZON WISH LIST,PROGRAM EXPENSES:IN-KIND DONATION DISTRIBUTIONS,--,$231.33,"$3,336,009.78"
